ID_UFUS_NOMINAL,FECHA_INGRESO_UFU,UFU,CANTI_GENERO_F,CANTI_GENERO_M,CANTI_DOMI_CABA,CANTI_DOMI_NO_CABA,CANTI_DOMI_NO_APLICA,CANTI_PERSONAS_UFU,CANTI_CONSULTAS_COVID,CANTI_CONSULTAS_NO_COVID,CANTI_CONSULTAS_ATENDIDAS,CANTI_CONSULTAS_DESCARTADAS,RANGO_ETARIO_0_9,RANGO_ETARIO_10_19,RANGO_ETARIO_20_29,RANGO_ETARIO_30_39,RANGO_ETARIO_40_49,RANGO_ETARIO_50_59,RANGO_ETARIO_60_69,RANGO_ETARIO_70_MAS,RANGO_ETARIO_SIN_DATOS,CANTI_TEST_POSITIVOS,CANTI_TEST_NEGATIVOS,CANTI_TEST_PENDIENTES,CANTI_TEST_REALIZADOS
20200608,08JUN2020:00:00:00,UFU GUTIERREZ,23,9,12,20,0,32,30,2,30,2,9,8,2,8,5,0,0,0,0,1,16,13,30
20200608,08JUN2020:00:00:00,UFU MUÑIZ,18,16,18,14,2,34,24,10,24,10,2,1,3,8,3,12,3,2,0,9,9,6,24
20200608,08JUN2020:00:00:00,UFU PENNA,11,11,17,3,2,22,10,12,16,6,0,0,5,4,4,8,0,1,0,3,3,4,10
20200608,08JUN2020:00:00:00,UFU PIROVANO,13,23,18,18,0,36,32,4,34,2,0,2,7,6,5,12,1,3,0,10,9,12,32
20200608,08JUN2020:00:00:00,UFU PIÑERO,82,67,136,4,9,149,122,27,134,15,13,31,24,35,14,17,9,6,0,45,25,52,122
20200608,08JUN2020:00:00:00,UFU RAMOS MEJIA,29,33,43,17,2,62,50,12,54,8,0,0,16,17,17,3,7,2,0,12,17,21,50
20200608,08JUN2020:00:00:00,UFU RIVADAVIA,17,19,17,12,7,36,26,10,26,10,0,0,7,13,8,7,1,0,0,2,14,10,26
20200608,08JUN2020:00:00:00,UFU SANTOJANNI,28,10,27,10,1,38,20,18,24,14,8,1,5,11,9,2,0,2,0,6,13,1,20
20200608,08JUN2020:00:00:00,UFU TORNU,31,35,60,4,2,66,60,6,62,4,5,8,13,17,12,9,2,0,0,11,21,28,60
20200608,08JUN2020:00:00:00,UFU VELEZ SARSFIELD,18,11,22,7,0,29,19,10,23,6,4,1,8,2,4,10,0,0,0,4,7,8,19
20200608,08JUN2020:00:00:00,UFU ZUBIZARRETA,0,2,2,0,0,2,2,0,2,0,0,0,0,0,0,0,2,0,0,0,0,2,2
20200609,09JUN2020:00:00:00,UFU ALVAREZ,22,40,55,3,4,62,56,6,56,6,4,8,7,13,13,15,2,0,0,21,11,24,56
20200609,09JUN2020:00:00:00,UFU ARGERICH,44,40,56,24,4,84,40,44,46,38,0,1,29,19,10,11,7,7,0,10,11,19,40
20200609,09JUN2020:00:00:00,UFU BORDA-MOYANO,29,13,22,18,2,42,40,2,40,2,0,0,2,5,20,6,9,0,0,4,20,16,40
20200609,09JUN2020:00:00:00,UFU DURAND,25,14,31,8,0,39,33,6,39,0,0,1,7,11,9,8,3,0,0,10,10,13,33
20200609,09JUN2020:00:00:00,UFU ELIZALDE,8,25,16,15,2,33,25,8,29,4,23,8,0,2,0,0,0,0,0,0,15,10,25
20200609,09JUN2020:00:00:00,UFU FERNANDEZ,11,4,13,2,0,15,15,0,15,0,0,0,5,1,3,6,0,0,0,2,6,7,15
20200609,09JUN2020:00:00:00,UFU FERRER,14,4,10,8,0,18,8,10,8,10,0,0,6,2,10,0,0,0,0,2,2,4,8
20200609,09JUN2020:00:00:00,UFU GRIERSON,23,10,31,2,0,33,15,18,33,0,2,2,12,4,1,8,3,1,0,8,1,6,15
20200609,09JUN2020:00:00:00,UFU GUTIERREZ,25,9,14,19,1,34,30,4,34,0,12,6,0,12,2,1,1,0,0,0,17,10,30
20200609,09JUN2020:00:00:00,UFU MUÑIZ,29,22,35,15,1,51,45,6,45,6,4,2,7,7,17,5,2,7,0,14,10,21,45
20200609,09JUN2020:00:00:00,UFU PENNA,13,9,15,7,0,22,18,4,20,2,0,0,0,5,10,3,4,0,0,5,6,7,18
20200609,09JUN2020:00:00:00,UFU PIROVANO,29,20,42,7,0,49,45,4,45,4,4,9,6,10,10,6,0,4,0,8,12,25,45
20200609,09JUN2020:00:00:00,UFU PIÑERO,54,46,94,3,3,100,86,14,90,10,7,8,32,22,19,10,2,0,0,27,22,37,86
20200609,09JUN2020:00:00:00,UFU RAMOS MEJIA,32,38,64,6,0,70,58,12,68,2,0,1,7,19,14,17,8,4,0,19,13,26,58
20200609,09JUN2020:00:00:00,UFU RIVADAVIA,21,27,26,5,17,48,36,12,36,12,0,0,9,17,6,6,4,6,0,9,9,18,36
20200609,09JUN2020:00:00:00,UFU SANTOJANNI,10,13,13,10,0,23,15,8,21,2,3,0,3,2,4,7,3,1,0,4,11,0,15
20200609,09JUN2020:00:00:00,UFU TORNU,24,18,34,6,2,42,34,8,34,8,5,3,2,18,3,11,0,0,0,7,10,17,34
20200609,09JUN2020:00:00:00,UFU VELEZ SARSFIELD,9,8,12,5,0,17,11,6,11,6,0,0,0,4,4,5,4,0,0,1,5,5,11
20200609,09JUN2020:00:00:00,UFU ZUBIZARRETA,0,3,3,0,0,3,1,2,3,0,0,0,0,0,1,0,2,0,0,1,0,0,1
20200610,10JUN2020:00:00:00,UFU ALVAREZ,24,33,39,16,2,57,51,6,51,6,4,2,17,12,14,5,3,0,0,15,17,19,51
20200610,10JUN2020:00:00:00,UFU ARGERICH,71,51,106,16,0,122,74,48,78,44,7,16,34,28,20,9,6,2,0,24,11,39,74
20200610,10JUN2020:00:00:00,UFU BORDA-MOYANO,7,15,8,12,2,22,20,2,20,2,0,0,0,7,9,2,2,2,0,4,7,9,20
20200610,10JUN2020:00:00:00,UFU DURAND,60,35,83,10,2,95,63,32,85,10,8,16,10,28,13,16,2,2,0,21,16,26,63
20200610,10JUN2020:00:00:00,UFU ELIZALDE,13,9,9,12,1,22,14,8,16,6,15,7,0,0,0,0,0,0,0,0,6,8,14
20200610,10JUN2020:00:00:00,UFU FERNANDEZ,2,5,7,0,0,7,7,0,7,0,0,0,1,1,5,0,0,0,0,1,3,2,7
20200610,10JUN2020:00:00:00,UFU FERRER,18,14,12,18,2,32,28,4,28,4,0,0,0,8,10,8,6,0,0,0,5,23,28
20200610,10JUN2020:00:00:00,UFU GRIERSON,25,12,37,0,0,37,21,16,27,10,4,3,13,13,2,0,2,0,0,2,3,16,21
20200610,10JUN2020:00:00:00,UFU GUTIERREZ,28,6,11,19,4,34,28,6,28,6,10,7,6,6,2,2,1,0,0,1,14,11,28
20200610,10JUN2020:00:00:00,UFU MUÑIZ,45,29,56,14,4,74,68,6,72,2,0,5,13,26,18,4,6,2,0,15,24,29,68
20200610,10JUN2020:00:00:00,UFU PENNA,21,14,29,2,4,35,25,10,31,4,1,0,7,11,8,5,1,2,0,8,8,9,25
20200610,10JUN2020:00:00:00,UFU PIROVANO,14,3,9,8,0,17,13,4,17,0,0,0,2,2,10,1,2,0,0,2,4,7,13
20200610,10JUN2020:00:00:00,UFU PIÑERO,79,58,121,7,9,137,101,36,105,32,19,6,27,30,31,14,6,4,0,31,23,47,101
20200610,10JUN2020:00:00:00,UFU RAMOS MEJIA,45,48,83,8,2,93,59,34,63,30,0,0,30,31,13,17,0,2,0,14,15,30,59
20200610,10JUN2020:00:00:00,UFU RIVADAVIA,35,39,40,21,13,74,66,8,68,6,0,2,15,36,16,5,0,0,0,9,26,29,66
20200610,10JUN2020:00:00:00,UFU SANTOJANNI,14,11,22,3,0,25,17,8,21,4,2,2,6,3,3,8,1,0,0,10,3,4,17
20200610,10JUN2020:00:00:00,UFU TORNU,32,19,47,4,0,51,47,4,47,4,5,4,8,14,8,7,1,4,0,12,12,23,47
20200610,10JUN2020:00:00:00,UFU VELEZ SARSFIELD,13,40,46,7,0,53,17,36,17,36,0,6,17,6,11,8,5,0,0,4,5,8,17
20200610,10JUN2020:00:00:00,UFU ZUBIZARRETA,11,3,12,2,0,14,12,2,12,2,2,3,0,2,3,2,2,0,0,3,5,4,12
20200611,11JUN2020:00:00:00,UFU ALVAREZ,26,27,35,11,7,53,47,6,49,4,0,2,9,16,12,8,6,0,0,16,11,20,47
20200611,11JUN2020:00:00:00,UFU ARGERICH,68,58,89,31,6,126,54,72,62,64,3,1,19,42,27,21,9,4,0,7,21,26,54
20200611,11JUN2020:00:00:00,UFU BORDA-MOYANO,17,8,17,2,6,25,21,4,21,4,0,0,0,4,0,7,5,9,0,2,9,10,21
20200611,11JUN2020:00:00:00,UFU DURAND,44,29,67,6,0,73,49,24,67,6,7,7,16,20,14,6,3,0,0,14,16,19,49
20200611,11JUN2020:00:00:00,UFU ELIZALDE,27,12,23,15,1,39,31,8,35,4,27,9,0,3,0,0,0,0,0,2,16,13,31
20200611,11JUN2020:00:00:00,UFU FERNANDEZ,10,18,24,4,0,28,24,4,28,0,0,0,6,9,10,1,2,0,0,5,1,18,24
20200611,11JUN2020:00:00:00,UFU FERRER,16,18,19,15,0,34,22,12,22,12,0,0,8,9,12,4,0,1,0,4,8,10,22
20200611,11JUN2020:00:00:00,UFU GRIERSON,18,26,42,2,0,44,10,34,42,2,2,4,17,11,2,4,4,0,0,4,0,6,10
20200611,11JUN2020:00:00:00,UFU GUTIERREZ,16,2,11,6,1,18,18,0,18,0,4,3,3,2,1,3,2,0,0,0,12,6,18
20200611,11JUN2020:00:00:00,UFU MUÑIZ,41,31,56,14,2,72,62,10,64,8,14,3,6,15,19,7,2,6,0,23,12,27,62
20200611,11JUN2020:00:00:00,UFU PENNA,16,18,26,6,2,34,26,8,30,4,0,0,11,12,8,3,0,0,0,8,7,11,26
20200611,11JUN2020:00:00:00,UFU PIROVANO,18,3,19,2,0,21,19,2,21,0,1,2,3,3,6,6,0,0,0,7,5,7,19
20200611,11JUN2020:00:00:00,UFU PIÑERO,47,57,95,4,5,104,77,27,79,25,13,14,22,20,16,6,10,3,0,25,22,30,77
20200611,11JUN2020:00:00:00,UFU RAMOS MEJIA,38,34,50,19,3,72,56,16,66,6,0,0,13,30,14,9,4,2,0,7,22,27,56
20200611,11JUN2020:00:00:00,UFU RIVADAVIA,26,24,29,11,10,50,40,10,44,6,0,0,8,8,12,14,2,6,0,6,13,21,40
20200611,11JUN2020:00:00:00,UFU SANTOJANNI,8,11,6,11,2,19,13,6,15,4,2,1,1,5,5,3,1,1,0,5,8,0,13
20200611,11JUN2020:00:00:00,UFU TORNU,14,22,19,13,4,36,28,8,28,8,8,0,8,8,6,6,0,0,0,10,5,13,28
20200611,11JUN2020:00:00:00,UFU VELEZ SARSFIELD,10,8,14,4,0,18,14,4,14,4,0,0,4,4,4,2,4,0,0,5,1,8,14
20200611,11JUN2020:00:00:00,UFU ZUBIZARRETA,3,0,3,0,0,3,3,0,3,0,0,2,0,0,1,0,0,0,0,2,0,1,3
20200612,12JUN2020:00:00:00,UFU ALVAREZ,30,23,30,5,18,53,45,8,45,8,0,2,18,3,11,9,10,0,0,14,8,23,45
20200612,12JUN2020:00:00:00,UFU ARGERICH,63,48,89,18,4,111,57,54,57,54,3,9,31,27,16,12,7,6,0,3,8,46,57
20200422,22APR2020:00:00:00,UFU MUÑIZ,20,8,12,14,2,28,16,12,16,12,0,0,6,8,6,7,1,0,0,0,0,16,16
20200422,22APR2020:00:00:00,UFU PENNA,18,2,20,0,0,20,16,4,16,4,0,0,8,4,4,4,0,0,0,0,0,16,16
20200422,22APR2020:00:00:00,UFU PIROVANO,2,4,4,2,0,6,2,4,2,4,0,0,2,0,0,2,2,0,0,0,0,2,2
20200422,22APR2020:00:00:00,UFU PIÑERO,14,30,38,2,4,44,6,38,18,26,0,2,7,12,3,10,8,2,0,0,0,6,6
20200422,22APR2020:00:00:00,UFU RAMOS MEJIA,0,6,4,2,0,6,2,4,2,4,0,0,0,4,2,0,0,0,0,0,0,2,2
20200422,22APR2020:00:00:00,UFU RIVADAVIA,18,4,12,6,4,22,16,6,16,6,0,0,2,10,3,6,1,0,0,0,0,16,16
20200422,22APR2020:00:00:00,UFU SANTOJANNI,11,6,9,6,2,17,13,4,15,2,1,0,4,2,0,2,0,8,0,0,1,12,13
20200422,22APR2020:00:00:00,UFU TORNU,20,12,30,2,0,32,32,0,32,0,0,0,0,10,8,4,8,2,0,0,0,32,32
20200422,22APR2020:00:00:00,UFU VELEZ SARSFIELD,2,0,0,2,0,2,2,0,2,0,0,0,1,1,0,0,0,0,0,0,0,2,2
20200423,23APR2020:00:00:00,UFU ALVAREZ,8,10,16,0,2,18,14,4,18,0,0,0,3,9,2,4,0,0,0,0,0,14,14
20200423,23APR2020:00:00:00,UFU ARGERICH,20,16,24,8,4,36,10,26,22,14,0,2,6,6,6,8,6,2,0,0,0,10,10
20200423,23APR2020:00:00:00,UFU DURAND,16,24,36,4,0,40,34,6,34,6,4,6,7,15,2,4,0,2,0,0,0,34,34
20200423,23APR2020:00:00:00,UFU FERNANDEZ,6,10,12,4,0,16,4,12,12,4,0,0,0,4,0,2,8,2,0,0,0,4,4
20200423,23APR2020:00:00:00,UFU GUTIERREZ,2,6,4,2,2,8,6,2,6,2,4,4,0,0,0,0,0,0,0,0,0,6,6
20200423,23APR2020:00:00:00,UFU MUÑIZ,6,8,10,2,2,14,12,2,12,2,0,0,4,2,0,6,0,2,0,0,0,12,12
20200423,23APR2020:00:00:00,UFU PENNA,16,10,22,4,0,26,12,14,20,6,0,2,9,8,5,0,0,2,0,0,0,12,12
20200423,23APR2020:00:00:00,UFU PIROVANO,2,2,2,0,2,4,0,4,2,2,0,0,0,0,2,0,2,0,0,0,0,0,0
20200423,23APR2020:00:00:00,UFU PIÑERO,26,24,46,4,0,50,0,50,16,34,0,2,10,16,7,7,6,2,0,0,0,0,0
20200423,23APR2020:00:00:00,UFU RAMOS MEJIA,14,6,16,4,0,20,6,14,14,6,0,0,2,6,4,4,2,2,0,0,0,6,6
20200423,23APR2020:00:00:00,UFU RIVADAVIA,16,10,20,2,4,26,22,4,22,4,0,0,12,6,6,2,0,0,0,0,0,22,22
20200423,23APR2020:00:00:00,UFU SANTOJANNI,12,12,12,12,0,24,4,20,18,6,2,0,8,6,5,1,0,2,0,0,0,4,4
20200423,23APR2020:00:00:00,UFU TORNU,6,0,4,2,0,6,6,0,6,0,0,0,4,0,2,0,0,0,0,0,0,6,6
20200424,24APR2020:00:00:00,UFU ALVAREZ,4,8,12,0,0,12,12,0,12,0,0,0,4,4,2,2,0,0,0,0,0,12,12
20200424,24APR2020:00:00:00,UFU ARGERICH,6,6,4,2,6,12,6,6,6,6,0,0,3,3,2,2,2,0,0,0,0,6,6
20200424,24APR2020:00:00:00,UFU DURAND,6,4,6,2,2,10,6,4,10,0,0,0,2,6,2,0,0,0,0,0,0,6,6
20200424,24APR2020:00:00:00,UFU GRIERSON,0,6,6,0,0,6,6,0,6,0,0,2,0,0,2,2,0,0,0,0,0,6,6
20200424,24APR2020:00:00:00,UFU GUTIERREZ,4,6,4,6,0,10,8,2,8,2,6,3,1,0,0,0,0,0,0,0,0,8,8
20200424,24APR2020:00:00:00,UFU MUÑIZ,26,12,28,8,2,38,34,4,34,4,0,0,4,20,4,6,4,0,0,0,0,34,34
20200424,24APR2020:00:00:00,UFU PENNA,18,8,18,6,2,26,12,14,24,2,0,1,13,4,3,1,2,2,0,0,0,12,12
20200424,24APR2020:00:00:00,UFU PIROVANO,8,10,14,4,0,18,10,8,14,4,0,0,4,2,6,3,3,0,0,0,0,10,10
20200424,24APR2020:00:00:00,UFU PIÑERO,22,24,44,2,0,46,16,30,36,10,0,4,5,7,8,16,4,2,0,0,0,16,16
20200424,24APR2020:00:00:00,UFU RAMOS MEJIA,2,6,6,2,0,8,4,4,8,0,0,0,4,2,2,0,0,0,0,0,0,4,4
20200424,24APR2020:00:00:00,UFU RIVADAVIA,14,22,28,4,4,36,36,0,36,0,0,0,5,15,8,7,1,0,0,0,0,36,36
20200424,24APR2020:00:00:00,UFU SANTOJANNI,8,14,16,6,0,22,10,12,22,0,0,2,9,5,4,0,2,0,0,0,0,10,10
20200424,24APR2020:00:00:00,UFU TORNU,6,8,14,0,0,14,12,2,14,0,0,0,0,2,6,4,2,0,0,0,0,12,12
20200424,24APR2020:00:00:00,UFU VELEZ SARSFIELD,0,2,2,0,0,2,0,2,0,2,0,0,0,2,0,0,0,0,0,0,0,0,0
20200425,25APR2020:00:00:00,UFU ALVAREZ,6,2,8,0,0,8,6,2,6,2,0,0,0,0,4,2,2,0,0,0,0,6,6
20200425,25APR2020:00:00:00,UFU DURAND,10,4,6,0,8,14,10,4,12,2,0,0,6,2,0,2,2,2,0,0,0,10,10
20200425,25APR2020:00:00:00,UFU FERNANDEZ,2,0,2,0,0,2,0,2,0,2,0,0,2,0,0,0,0,0,0,0,0,0,0
20200425,25APR2020:00:00:00,UFU GUTIERREZ,6,4,6,4,0,10,6,4,6,4,8,2,0,0,0,0,0,0,0,0,0,6,6
20200425,25APR2020:00:00:00,UFU MUÑIZ,10,4,10,4,0,14,14,0,14,0,0,0,4,0,8,2,0,0,0,0,0,14,14
20200425,25APR2020:00:00:00,UFU PENNA,8,18,18,8,0,26,4,22,26,0,0,0,8,6,0,6,4,2,0,0,0,4,4
20200425,25APR2020:00:00:00,UFU PIROVANO,4,4,8,0,0,8,6,2,8,0,0,0,4,2,2,0,0,0,0,0,0,6,6
20200425,25APR2020:00:00:00,UFU PIÑERO,2,2,4,0,0,4,2,2,4,0,0,0,0,2,0,2,0,0,0,0,0,2,2
20200425,25APR2020:00:00:00,UFU RAMOS MEJIA,4,4,8,0,0,8,4,4,6,2,0,0,2,2,1,1,0,2,0,0,0,4,4
20200425,25APR2020:00:00:00,UFU RIVADAVIA,8,12,18,0,2,20,8,12,8,12,4,4,2,6,2,2,0,0,0,0,0,8,8
20200425,25APR2020:00:00:00,UFU SANTOJANNI,2,2,4,0,0,4,2,2,4,0,0,0,2,0,2,0,0,0,0,0,0,2,2
20200425,25APR2020:00:00:00,UFU TORNU,4,2,4,0,2,6,6,0,6,0,0,0,2,0,0,0,0,4,0,0,0,6,6
20200426,26APR2020:00:00:00,UFU ALVAREZ,0,4,4,0,0,4,0,4,0,4,0,0,0,2,0,2,0,0,0,0,0,0,0
20200426,26APR2020:00:00:00,UFU ARGERICH,8,0,6,2,0,8,6,2,8,0,0,0,2,2,2,0,2,0,0,0,0,6,6
20200426,26APR2020:00:00:00,UFU DURAND,2,2,0,0,4,4,4,0,4,0,0,0,0,2,0,0,2,0,0,0,0,4,4
20200426,26APR2020:00:00:00,UFU GUTIERREZ,2,4,4,2,0,6,6,0,6,0,3,3,0,0,0,0,0,0,0,0,0,6,6
20200426,26APR2020:00:00:00,UFU MUÑIZ,0,8,4,4,0,8,6,2,6,2,2,0,0,2,4,0,0,0,0,0,0,6,6
20200426,26APR2020:00:00:00,UFU PENNA,12,12,18,6,0,24,10,14,14,10,0,0,6,8,6,2,0,2,0,0,0,10,10
20200426,26APR2020:00:00:00,UFU PIROVANO,4,4,8,0,0,8,4,4,6,2,0,0,2,2,0,2,0,2,0,0,0,4,4
20200426,26APR2020:00:00:00,UFU PIÑERO,6,8,8,4,2,14,0,14,0,14,0,2,4,7,1,0,0,0,0,0,0,0,0
20200426,26APR2020:00:00:00,UFU RAMOS MEJIA,4,0,2,2,0,4,4,0,4,0,0,0,0,2,0,2,0,0,0,0,0,4,4
20200426,26APR2020:00:00:00,UFU RIVADAVIA,4,6,8,2,0,10,10,0,10,0,0,0,0,4,3,3,0,0,0,0,0,10,10
20200426,26APR2020:00:00:00,UFU SANTOJANNI,4,2,6,0,0,6,4,2,4,2,0,0,2,0,2,2,0,0,0,0,0,4,4
20200426,26APR2020:00:00:00,UFU TORNU,0,2,0,0,2,2,2,0,2,0,0,0,0,0,0,2,0,0,0,0,0,2,2
20200427,27APR2020:00:00:00,UFU ALVAREZ,10,2,12,0,0,12,8,4,10,2,0,0,4,2,2,2,2,0,0,0,0,8,8
20200427,27APR2020:00:00:00,UFU ARGERICH,6,2,4,2,2,8,4,4,6,2,0,0,1,5,0,0,0,2,0,0,0,4,4
20200427,27APR2020:00:00:00,UFU DURAND,6,6,12,0,0,12,8,4,8,4,0,0,2,2,4,1,3,0,0,0,0,8,8
20200427,27APR2020:00:00:00,UFU ELIZALDE,2,4,0,6,0,6,0,6,0,6,4,0,0,0,2,0,0,0,0,0,0,0,0
20200427,27APR2020:00:00:00,UFU FERNANDEZ,6,2,6,2,0,8,8,0,8,0,0,0,2,2,0,2,2,0,0,0,0,8,8
20200427,27APR2020:00:00:00,UFU GUTIERREZ,6,6,10,2,0,12,12,0,12,0,8,2,0,2,0,0,0,0,0,0,0,12,12
20200427,27APR2020:00:00:00,UFU MUÑIZ,6,16,8,12,2,22,20,2,20,2,0,0,2,6,9,3,2,0,0,0,0,20,20
20200427,27APR2020:00:00:00,UFU PENNA,6,4,8,2,0,10,4,6,10,0,0,0,1,1,4,2,2,0,0,0,0,4,4
20200427,27APR2020:00:00:00,UFU PIROVANO,4,4,4,2,2,8,6,2,8,0,0,0,2,0,4,2,0,0,0,0,0,6,6
20200427,27APR2020:00:00:00,UFU PIÑERO,30,24,38,4,12,54,6,48,36,18,0,0,10,23,9,6,4,2,0,0,0,6,6
20200427,27APR2020:00:00:00,UFU RAMOS MEJIA,4,2,2,4,0,6,4,2,6,0,0,0,4,0,2,0,0,0,0,0,0,4,4
20200427,27APR2020:00:00:00,UFU RIVADAVIA,22,20,26,6,10,42,36,6,36,6,0,0,10,10,12,10,0,0,0,0,0,36,36
20200427,27APR2020:00:00:00,UFU SANTOJANNI,9,8,13,2,2,17,7,10,15,2,1,2,6,2,2,2,2,0,0,0,1,6,7
20200427,27APR2020:00:00:00,UFU VELEZ SARSFIELD,0,2,0,2,0,2,2,0,2,0,0,0,0,0,2,0,0,0,0,0,0,2,2
20200428,28APR2020:00:00:00,UFU ALVAREZ,4,4,8,0,0,8,6,2,8,0,0,0,0,4,0,4,0,0,0,0,0,6,6
20200428,28APR2020:00:00:00,UFU ARGERICH,6,6,2,6,4,12,6,6,10,2,0,0,6,4,2,0,0,0,0,0,0,6,6
20200428,28APR2020:00:00:00,UFU DURAND,6,6,10,2,0,12,10,2,12,0,0,0,2,8,2,0,0,0,0,0,0,10,10
20200428,28APR2020:00:00:00,UFU FERNANDEZ,4,4,8,0,0,8,4,4,6,2,0,0,0,2,2,4,0,0,0,0,0,4,4
20200428,28APR2020:00:00:00,UFU GRIERSON,0,2,2,0,0,2,0,2,2,0,0,0,2,0,0,0,0,0,0,0,0,0,0
20200428,28APR2020:00:00:00,UFU GUTIERREZ,0,6,4,2,0,6,2,4,4,2,6,0,0,0,0,0,0,0,0,0,0,2,2
20200428,28APR2020:00:00:00,UFU MUÑIZ,6,6,10,2,0,12,12,0,12,0,0,0,0,4,6,2,0,0,0,0,0,12,12
20200428,28APR2020:00:00:00,UFU PENNA,10,10,14,0,6,20,6,14,16,4,0,4,6,4,2,2,2,0,0,0,0,6,6
20200428,28APR2020:00:00:00,UFU PIROVANO,4,6,10,0,0,10,8,2,10,0,0,2,4,4,0,0,0,0,0,0,0,8,8
20200428,28APR2020:00:00:00,UFU RAMOS MEJIA,4,6,6,2,2,10,6,4,6,4,0,0,0,10,0,0,0,0,0,0,0,6,6
20200428,28APR2020:00:00:00,UFU RIVADAVIA,14,6,16,0,4,20,16,4,18,2,0,2,4,2,8,4,0,0,0,0,0,16,16
20200428,28APR2020:00:00:00,UFU SANTOJANNI,6,11,13,0,4,17,7,10,17,0,1,3,5,4,4,0,0,0,0,0,3,4,7
20200428,28APR2020:00:00:00,UFU TORNU,2,2,2,2,0,4,4,0,4,0,0,0,0,2,0,2,0,0,0,0,0,4,4
20200428,28APR2020:00:00:00,UFU VELEZ SARSFIELD,0,4,2,2,0,4,2,2,2,2,0,0,0,2,0,2,0,0,0,0,0,2,2
20200428,28APR2020:00:00:00,UFU ZUBIZARRETA,2,6,4,4,0,8,2,6,4,4,0,0,2,0,6,0,0,0,0,0,0,2,2
20200429,29APR2020:00:00:00,UFU ALVAREZ,0,3,2,1,0,3,1,2,3,0,0,0,2,0,0,1,0,0,0,0,1,0,1
20200429,29APR2020:00:00:00,UFU ARGERICH,8,12,12,8,0,20,10,10,18,2,0,0,2,6,0,8,2,2,0,0,0,10,10
20200429,29APR2020:00:00:00,UFU DURAND,10,6,6,10,0,16,16,0,16,0,0,0,4,4,4,4,0,0,0,0,0,16,16
20200429,29APR2020:00:00:00,UFU ELIZALDE,4,4,4,4,0,8,6,2,6,2,2,2,0,2,0,2,0,0,0,0,0,6,6
20200429,29APR2020:00:00:00,UFU FERNANDEZ,8,2,8,2,0,10,10,0,10,0,0,0,2,4,2,0,2,0,0,0,0,10,10
20200429,29APR2020:00:00:00,UFU GRIERSON,0,6,6,0,0,6,2,4,6,0,2,0,4,0,0,0,0,0,0,0,0,2,2
20200429,29APR2020:00:00:00,UFU GUTIERREZ,4,2,2,4,0,6,2,4,4,2,6,0,0,0,0,0,0,0,0,0,0,2,2
20200429,29APR2020:00:00:00,UFU MUÑIZ,20,12,22,10,0,32,28,4,30,2,0,0,3,14,9,2,4,0,0,0,0,28,28
20200429,29APR2020:00:00:00,UFU PENNA,14,24,24,8,6,38,26,12,34,4,0,4,4,4,13,5,6,2,0,0,0,26,26
20200429,29APR2020:00:00:00,UFU PIROVANO,8,8,10,2,4,16,12,4,14,2,0,0,6,2,2,2,4,0,0,0,0,12,12
20200429,29APR2020:00:00:00,UFU PIÑERO,22,26,44,2,2,48,6,42,36,12,2,6,13,11,8,6,0,2,0,0,0,6,6
20200429,29APR2020:00:00:00,UFU RAMOS MEJIA,8,10,16,2,0,18,14,4,18,0,0,0,8,6,4,0,0,0,0,0,0,14,14
20200429,29APR2020:00:00:00,UFU RIVADAVIA,6,12,14,4,0,18,18,0,18,0,0,0,3,5,6,0,4,0,0,0,0,18,18
20200429,29APR2020:00:00:00,UFU SANTOJANNI,8,8,12,4,0,16,6,10,16,0,0,1,4,5,2,2,2,0,0,0,0,6,6
20200429,29APR2020:00:00:00,UFU TORNU,4,4,2,2,4,8,8,0,8,0,0,0,4,2,2,0,0,0,0,0,0,8,8
20200429,29APR2020:00:00:00,UFU VELEZ SARSFIELD,2,0,2,0,0,2,2,0,2,0,0,0,0,0,2,0,0,0,0,0,0,2,2
20200429,29APR2020:00:00:00,UFU ZUBIZARRETA,2,0,2,0,0,2,2,0,2,0,0,0,2,0,0,0,0,0,0,0,0,2,2
20200430,30APR2020:00:00:00,UFU ALVAREZ,4,6,10,0,0,10,10,0,10,0,0,0,4,4,0,2,0,0,0,0,3,7,10
20200430,30APR2020:00:00:00,UFU ARGERICH,10,8,14,4,0,18,12,6,14,4,0,0,4,4,8,1,1,0,0,0,0,12,12
20200430,30APR2020:00:00:00,UFU DURAND,10,10,16,4,0,20,12,8,20,0,0,0,4,6,1,3,4,2,0,0,0,12,12
20200430,30APR2020:00:00:00,UFU ELIZALDE,6,6,6,6,0,12,6,6,12,0,6,4,2,0,0,0,0,0,0,0,0,6,6
20200430,30APR2020:00:00:00,UFU FERNANDEZ,12,6,10,6,2,18,18,0,18,0,0,0,8,4,5,1,0,0,0,0,0,18,18
20200430,30APR2020:00:00:00,UFU GRIERSON,2,4,4,2,0,6,6,0,6,0,2,2,0,0,0,0,2,0,0,0,0,6,6
20200430,30APR2020:00:00:00,UFU GUTIERREZ,6,0,4,2,0,6,2,4,6,0,6,0,0,0,0,0,0,0,0,0,0,2,2
20200430,30APR2020:00:00:00,UFU MUÑIZ,10,10,10,10,0,20,18,2,18,2,0,0,5,3,8,4,0,0,0,0,0,18,18
20200430,30APR2020:00:00:00,UFU PENNA,20,14,24,4,6,34,18,16,28,6,0,3,8,11,6,4,2,0,0,0,0,18,18
20200430,30APR2020:00:00:00,UFU PIROVANO,4,4,4,4,0,8,2,6,8,0,0,0,5,1,0,2,0,0,0,0,0,2,2
20200430,30APR2020:00:00:00,UFU PIÑERO,16,12,24,2,2,28,14,14,22,6,0,0,8,12,4,2,2,0,0,0,0,14,14
20200430,30APR2020:00:00:00,UFU RAMOS MEJIA,10,12,16,6,0,22,14,8,18,4,0,2,4,8,0,0,6,2,0,0,0,14,14
20200430,30APR2020:00:00:00,UFU RIVADAVIA,20,20,34,2,4,40,32,8,32,8,0,1,5,18,10,6,0,0,0,0,0,32,32
20200430,30APR2020:00:00:00,UFU SANTOJANNI,14,6,12,8,0,20,10,10,20,0,0,1,6,5,4,4,0,0,0,0,0,10,10
20200430,30APR2020:00:00:00,UFU TORNU,6,0,4,2,0,6,6,0,6,0,0,0,0,2,4,0,0,0,0,0,0,6,6
20200430,30APR2020:00:00:00,UFU VELEZ SARSFIELD,2,2,4,0,0,4,4,0,4,0,0,0,0,0,2,0,0,2,0,0,0,4,4
20200430,30APR2020:00:00:00,UFU ZUBIZARRETA,0,2,0,2,0,2,0,2,2,0,0,2,0,0,0,0,0,0,0,0,0,0,0
20200501,01MAY2020:00:00:00,UFU ALVAREZ,2,3,2,1,2,5,3,2,3,2,0,0,2,2,0,1,0,0,0,0,2,1,3
20200501,01MAY2020:00:00:00,UFU ARGERICH,4,6,4,6,0,10,4,6,6,4,0,2,0,4,4,0,0,0,0,0,0,4,4
20200501,01MAY2020:00:00:00,UFU DURAND,8,6,12,2,0,14,14,0,14,0,0,0,4,4,2,2,2,0,0,0,0,14,14
20200501,01MAY2020:00:00:00,UFU ELIZALDE,4,8,0,10,2,12,12,0,12,0,8,2,0,2,0,0,0,0,0,0,0,12,12
20200501,01MAY2020:00:00:00,UFU FERNANDEZ,12,6,16,2,0,18,18,0,18,0,0,0,6,7,2,1,2,0,0,3,6,9,18
20200501,01MAY2020:00:00:00,UFU GRIERSON,5,2,7,0,0,7,7,0,7,0,1,2,0,2,2,0,0,0,0,0,1,6,7
20200501,01MAY2020:00:00:00,UFU GUTIERREZ,5,0,5,0,0,5,5,0,5,0,3,2,0,0,0,0,0,0,0,0,4,1,5
20200501,01MAY2020:00:00:00,UFU MUÑIZ,8,12,10,10,0,20,18,2,18,2,0,0,5,6,5,2,2,0,0,0,0,18,18
20200501,01MAY2020:00:00:00,UFU PENNA,36,16,42,2,8,52,36,16,50,2,0,1,10,23,16,2,0,0,0,0,1,35,36
20200501,01MAY2020:00:00:00,UFU PIROVANO,3,5,8,0,0,8,4,4,4,4,0,0,0,3,5,0,0,0,0,0,3,1,4
20200501,01MAY2020:00:00:00,UFU PIÑERO,28,22,46,2,2,50,2,48,4,46,0,5,14,13,16,2,0,0,0,0,0,2,2
20200501,01MAY2020:00:00:00,UFU RAMOS MEJIA,2,4,6,0,0,6,2,4,6,0,0,0,2,4,0,0,0,0,0,0,0,2,2
20200501,01MAY2020:00:00:00,UFU RIVADAVIA,16,19,33,0,2,35,29,6,29,6,0,0,6,5,12,10,2,0,0,9,2,18,29
20200501,01MAY2020:00:00:00,UFU SANTOJANNI,9,4,9,4,0,13,9,4,13,0,1,2,8,0,0,0,2,0,0,0,1,8,9
20200501,01MAY2020:00:00:00,UFU TORNU,2,0,2,0,0,2,0,2,2,0,0,0,0,0,2,0,0,0,0,0,0,0,0
20200502,02MAY2020:00:00:00,UFU ALVAREZ,9,2,9,0,2,11,3,8,7,4,0,0,2,4,0,5,0,0,0,1,1,1,3
20200502,02MAY2020:00:00:00,UFU ARGERICH,12,10,16,6,0,22,4,18,18,4,0,1,7,4,8,2,0,0,0,0,0,4,4
20200502,02MAY2020:00:00:00,UFU DURAND,4,10,8,0,6,14,6,8,12,2,0,2,6,2,3,1,0,0,0,0,0,6,6
20200502,02MAY2020:00:00:00,UFU ELIZALDE,4,0,4,0,0,4,0,4,4,0,2,2,0,0,0,0,0,0,0,0,0,0,0
20200502,02MAY2020:00:00:00,UFU FERNANDEZ,7,4,11,0,0,11,5,6,11,0,0,1,4,2,4,0,0,0,0,0,1,4,5
20200502,02MAY2020:00:00:00,UFU GUTIERREZ,4,4,6,2,0,8,8,0,8,0,6,2,0,0,0,0,0,0,0,0,4,4,8
20200502,02MAY2020:00:00:00,UFU MUÑIZ,4,0,2,2,0,4,4,0,4,0,0,0,2,2,0,0,0,0,0,0,0,4,4
20200502,02MAY2020:00:00:00,UFU PENNA,16,22,38,0,0,38,4,34,38,0,0,0,8,12,12,0,4,2,0,0,1,3,4
20200502,02MAY2020:00:00:00,UFU PIROVANO,2,3,4,1,0,5,3,2,5,0,0,2,0,1,2,0,0,0,0,1,1,1,3
20200502,02MAY2020:00:00:00,UFU PIÑERO,6,4,10,0,0,10,10,0,10,0,0,0,2,6,0,2,0,0,0,0,0,10,10
20200502,02MAY2020:00:00:00,UFU RAMOS MEJIA,2,2,2,0,2,4,4,0,4,0,0,0,2,0,2,0,0,0,0,0,0,4,4
20200502,02MAY2020:00:00:00,UFU RIVADAVIA,20,12,26,6,0,32,26,6,26,6,0,1,7,15,4,1,4,0,0,8,4,14,26
20200502,02MAY2020:00:00:00,UFU SANTOJANNI,2,6,0,8,0,8,4,4,8,0,0,1,3,0,2,2,0,0,0,0,0,4,4
20200502,02MAY2020:00:00:00,UFU TORNU,4,2,2,0,4,6,6,0,6,0,0,0,2,0,0,4,0,0,0,0,0,6,6
20200503,03MAY2020:00:00:00,UFU ALVAREZ,6,4,8,2,0,10,8,2,10,0,0,0,0,4,2,2,2,0,0,3,0,5,8
20200503,03MAY2020:00:00:00,UFU ARGERICH,4,8,12,0,0,12,6,6,8,4,0,2,4,0,4,0,0,2,0,0,0,6,6
20200503,03MAY2020:00:00:00,UFU DURAND,10,4,12,0,2,14,8,6,12,2,0,0,7,3,0,2,2,0,0,0,0,8,8
20200503,03MAY2020:00:00:00,UFU ELIZALDE,2,2,2,0,2,4,2,2,2,2,0,2,0,2,0,0,0,0,0,0,0,2,2
20200503,03MAY2020:00:00:00,UFU FERNANDEZ,6,4,10,0,0,10,10,0,10,0,0,0,2,4,4,0,0,0,0,4,0,6,10
20200503,03MAY2020:00:00:00,UFU GUTIERREZ,1,0,1,0,0,1,1,0,1,0,1,0,0,0,0,0,0,0,0,0,1,0,1
20200503,03MAY2020:00:00:00,UFU MUÑIZ,4,6,10,0,0,10,10,0,10,0,0,0,4,2,1,1,2,0,0,0,0,10,10
20200503,03MAY2020:00:00:00,UFU PENNA,14,2,12,4,0,16,12,4,16,0,0,1,1,8,4,0,2,0,0,0,0,12,12
20200503,03MAY2020:00:00:00,UFU PIROVANO,1,2,1,2,0,3,1,2,3,0,0,0,2,0,1,0,0,0,0,0,1,0,1
20200503,03MAY2020:00:00:00,UFU PIÑERO,10,20,30,0,0,30,14,16,22,8,0,6,10,4,8,0,2,0,0,0,0,14,14
20200503,03MAY2020:00:00:00,UFU RAMOS MEJIA,0,4,4,0,0,4,2,2,2,2,0,0,0,0,2,2,0,0,0,0,0,2,2
20200503,03MAY2020:00:00:00,UFU RIVADAVIA,16,6,22,0,0,22,22,0,22,0,0,0,8,13,0,1,0,0,0,8,4,10,22
20200503,03MAY2020:00:00:00,UFU SANTOJANNI,8,2,4,6,0,10,4,6,10,0,0,2,4,2,2,0,0,0,0,0,0,4,4
20200503,03MAY2020:00:00:00,UFU TORNU,2,4,4,0,2,6,4,2,4,2,0,0,4,0,2,0,0,0,0,0,0,4,4
20200504,04MAY2020:00:00:00,UFU ALVAREZ,14,4,13,5,0,18,6,12,12,6,0,0,4,7,2,3,2,0,0,1,3,2,6
20200504,04MAY2020:00:00:00,UFU ARGERICH,8,20,22,4,2,28,22,6,22,6,0,0,10,8,2,2,2,4,0,0,0,22,22
20200504,04MAY2020:00:00:00,UFU DURAND,4,0,2,2,0,4,2,2,2,2,0,0,0,2,2,0,0,0,0,0,0,2,2
20200504,04MAY2020:00:00:00,UFU ELIZALDE,14,2,10,6,0,16,14,2,16,0,6,2,0,4,4,0,0,0,0,0,0,14,14
20200504,04MAY2020:00:00:00,UFU FERNANDEZ,8,21,27,2,0,29,23,6,29,0,0,4,6,7,6,2,4,0,0,8,3,12,23
20200504,04MAY2020:00:00:00,UFU GRIERSON,4,0,4,0,0,4,4,0,4,0,0,2,2,0,0,0,0,0,0,0,1,3,4
20200504,04MAY2020:00:00:00,UFU GUTIERREZ,8,1,7,2,0,9,7,2,7,2,2,5,0,0,0,2,0,0,0,1,3,3,7
20200504,04MAY2020:00:00:00,UFU MUÑIZ,2,6,4,4,0,8,8,0,8,0,0,0,0,4,4,0,0,0,0,0,0,8,8
20200504,04MAY2020:00:00:00,UFU PENNA,22,24,28,14,4,46,26,20,34,12,4,4,8,10,6,7,7,0,0,0,0,26,26
20200504,04MAY2020:00:00:00,UFU PIROVANO,4,2,4,2,0,6,2,4,6,0,0,0,0,2,2,0,2,0,0,0,1,1,2
20200504,04MAY2020:00:00:00,UFU PIÑERO,22,26,26,2,20,48,12,36,18,30,0,0,6,14,10,14,2,2,0,0,0,12,12
20200504,04MAY2020:00:00:00,UFU RAMOS MEJIA,6,8,8,6,0,14,10,4,12,2,0,0,4,6,4,0,0,0,0,0,0,10,10
20200504,04MAY2020:00:00:00,UFU RIVADAVIA,25,12,26,6,5,37,33,4,33,4,0,2,13,15,3,2,2,0,0,6,5,22,33
20200504,04MAY2020:00:00:00,UFU SANTOJANNI,7,10,12,5,0,17,5,12,17,0,3,2,0,6,6,0,0,0,0,0,1,4,5
20200504,04MAY2020:00:00:00,UFU TORNU,8,2,10,0,0,10,10,0,10,0,0,0,2,6,0,2,0,0,0,0,0,10,10
20200504,04MAY2020:00:00:00,UFU VELEZ SARSFIELD,0,2,2,0,0,2,0,2,0,2,0,0,0,2,0,0,0,0,0,0,0,0,0
20200504,04MAY2020:00:00:00,UFU ZUBIZARRETA,2,3,4,1,0,5,3,2,3,2,0,0,2,1,0,2,0,0,0,0,2,1,3
20200505,05MAY2020:00:00:00,UFU ALVAREZ,5,9,14,0,0,14,12,2,12,2,0,4,2,3,5,0,0,0,0,3,4,5,12
20200505,05MAY2020:00:00:00,UFU ARGERICH,6,10,10,2,4,16,4,12,14,2,4,4,0,6,0,2,0,0,0,0,0,4,4
20200505,05MAY2020:00:00:00,UFU DURAND,4,0,2,2,0,4,4,0,4,0,0,0,0,0,2,0,2,0,0,0,0,4,4
20200505,05MAY2020:00:00:00,UFU ELIZALDE,6,4,6,4,0,10,4,6,10,0,8,0,0,0,0,2,0,0,0,0,0,4,4
20200505,05MAY2020:00:00:00,UFU FERNANDEZ,41,19,60,0,0,60,34,26,52,8,4,7,16,20,8,2,3,0,0,7,1,26,34
20200505,05MAY2020:00:00:00,UFU GRIERSON,2,2,4,0,0,4,2,2,4,0,0,0,0,1,3,0,0,0,0,0,0,2,2
20200505,05MAY2020:00:00:00,UFU GUTIERREZ,6,5,2,9,0,11,9,2,11,0,5,4,0,0,0,2,0,0,0,0,5,4,9
20200505,05MAY2020:00:00:00,UFU MUÑIZ,4,4,0,8,0,8,8,0,8,0,0,0,2,0,0,6,0,0,0,0,0,8,8
20200505,05MAY2020:00:00:00,UFU PENNA,12,14,18,8,0,26,10,16,20,6,0,0,6,4,12,2,2,0,0,0,0,10,10
20200505,05MAY2020:00:00:00,UFU PIROVANO,2,6,2,4,2,8,2,6,2,6,0,0,0,4,2,0,2,0,0,0,1,1,2
20200505,05MAY2020:00:00:00,UFU PIÑERO,22,34,38,0,18,56,36,20,54,2,0,4,4,26,10,6,6,0,0,0,0,36,36
20200505,05MAY2020:00:00:00,UFU RAMOS MEJIA,8,4,10,2,0,12,6,6,6,6,0,0,2,2,4,2,2,0,0,0,0,6,6
20200505,05MAY2020:00:00:00,UFU RIVADAVIA,14,20,23,6,5,34,32,2,32,2,0,0,7,15,8,4,0,0,0,9,7,16,32
20200505,05MAY2020:00:00:00,UFU SANTOJANNI,10,11,20,1,0,21,15,6,21,0,2,1,8,0,4,2,4,0,0,0,3,12,15
20200505,05MAY2020:00:00:00,UFU TORNU,2,0,2,0,0,2,2,0,2,0,0,0,0,0,2,0,0,0,0,0,0,2,2
20200505,05MAY2020:00:00:00,UFU VELEZ SARSFIELD,0,2,2,0,0,2,2,0,2,0,0,0,2,0,0,0,0,0,0,0,0,2,2
20200505,05MAY2020:00:00:00,UFU ZUBIZARRETA,0,7,7,0,0,7,3,4,5,2,2,0,1,0,4,0,0,0,0,0,2,1,3
20200506,06MAY2020:00:00:00,UFU ALVAREZ,10,10,18,2,0,20,14,6,16,4,0,3,8,5,0,2,2,0,0,1,6,7,14
20200506,06MAY2020:00:00:00,UFU ARGERICH,12,14,12,8,6,26,8,18,16,10,0,0,5,11,6,4,0,0,0,0,0,8,8
20200506,06MAY2020:00:00:00,UFU DURAND,10,12,16,6,0,22,16,6,16,6,0,0,6,7,9,0,0,0,0,0,0,16,16
20200506,06MAY2020:00:00:00,UFU ELIZALDE,10,2,6,6,0,12,4,8,12,0,10,2,0,0,0,0,0,0,0,0,0,4,4
20200506,06MAY2020:00:00:00,UFU FERNANDEZ,16,21,31,6,0,37,21,16,35,2,0,0,8,12,11,5,1,0,0,8,2,11,21
20200506,06MAY2020:00:00:00,UFU GRIERSON,2,0,2,0,0,2,2,0,2,0,0,0,0,2,0,0,0,0,0,0,0,2,2
20200506,06MAY2020:00:00:00,UFU GUTIERREZ,4,0,4,0,0,4,4,0,4,0,0,0,0,2,2,0,0,0,0,0,2,2,4
20200506,06MAY2020:00:00:00,UFU MUÑIZ,2,10,2,10,0,12,10,2,10,2,0,0,4,2,6,0,0,0,0,0,0,10,10
20200506,06MAY2020:00:00:00,UFU PENNA,8,16,18,2,4,24,14,10,24,0,0,2,2,8,6,0,2,4,0,0,0,14,14
20200506,06MAY2020:00:00:00,UFU PIROVANO,4,6,4,5,1,10,10,0,10,0,0,0,2,3,2,2,0,1,0,0,7,3,10
20200506,06MAY2020:00:00:00,UFU PIÑERO,18,8,20,0,6,26,18,8,24,2,0,0,7,8,9,0,2,0,0,0,0,18,18
20200506,06MAY2020:00:00:00,UFU RAMOS MEJIA,6,10,16,0,0,16,16,0,16,0,0,0,0,4,5,5,0,2,0,0,0,16,16
20200506,06MAY2020:00:00:00,UFU RIVADAVIA,5,5,6,0,4,10,10,0,10,0,0,0,2,7,0,1,0,0,0,4,1,5,10
20200506,06MAY2020:00:00:00,UFU SANTOJANNI,6,14,14,6,0,20,6,14,18,2,0,4,0,6,2,1,7,0,0,0,0,6,6
20200506,06MAY2020:00:00:00,UFU TORNU,2,6,6,2,0,8,6,2,6,2,0,0,4,0,2,2,0,0,0,0,0,6,6
20200506,06MAY2020:00:00:00,UFU VELEZ SARSFIELD,2,0,2,0,0,2,2,0,2,0,0,0,0,0,2,0,0,0,0,0,0,2,2
20200506,06MAY2020:00:00:00,UFU ZUBIZARRETA,2,2,4,0,0,4,4,0,4,0,0,0,1,3,0,0,0,0,0,0,0,4,4
20200507,07MAY2020:00:00:00,UFU ALVAREZ,29,4,20,11,2,33,23,10,25,8,0,0,4,10,12,4,3,0,0,1,10,12,23
20200507,07MAY2020:00:00:00,UFU ARGERICH,18,12,22,4,4,30,20,10,20,10,0,1,3,8,0,4,2,12,0,0,0,20,20
20200507,07MAY2020:00:00:00,UFU DURAND,28,16,44,0,0,44,40,4,40,4,7,9,5,7,12,2,0,2,0,0,0,40,40
20200507,07MAY2020:00:00:00,UFU ELIZALDE,6,2,4,4,0,8,8,0,8,0,4,4,0,0,0,0,0,0,0,0,0,8,8
20200507,07MAY2020:00:00:00,UFU FERNANDEZ,10,24,32,2,0,34,26,8,30,4,0,0,10,12,8,4,0,0,0,8,2,16,26
20200507,07MAY2020:00:00:00,UFU GRIERSON,6,4,8,0,2,10,4,6,8,2,0,0,2,6,0,2,0,0,0,0,0,4,4
20200507,07MAY2020:00:00:00,UFU GUTIERREZ,4,5,2,7,0,9,9,0,9,0,2,4,3,0,0,0,0,0,0,0,5,4,9
20200507,07MAY2020:00:00:00,UFU MUÑIZ,24,28,46,4,2,52,32,20,32,20,6,11,7,11,10,5,2,0,0,0,0,32,32
20200507,07MAY2020:00:00:00,UFU PENNA,22,8,22,8,0,30,20,10,24,6,0,0,2,8,8,4,4,4,0,0,0,20,20
20200507,07MAY2020:00:00:00,UFU PIROVANO,13,10,23,0,0,23,20,3,20,3,4,0,10,5,4,0,0,0,0,2,1,17,20
20200507,07MAY2020:00:00:00,UFU PIÑERO,22,24,36,2,8,46,36,10,40,6,2,4,4,14,14,2,4,2,0,0,0,36,36
20200507,07MAY2020:00:00:00,UFU RAMOS MEJIA,18,16,32,2,0,34,26,8,34,0,0,0,4,6,5,7,0,12,0,0,0,26,26
20200507,07MAY2020:00:00:00,UFU RIVADAVIA,25,16,31,6,4,41,37,4,37,4,0,0,18,5,9,5,4,0,0,9,4,24,37
20200507,07MAY2020:00:00:00,UFU SANTOJANNI,9,2,4,5,2,11,5,6,9,2,0,3,0,2,0,4,2,0,0,0,1,4,5
20200507,07MAY2020:00:00:00,UFU TORNU,12,4,14,0,2,16,16,0,16,0,0,4,2,7,1,0,2,0,0,0,0,16,16
20200507,07MAY2020:00:00:00,UFU VELEZ SARSFIELD,4,12,12,4,0,16,16,0,16,0,0,0,6,4,2,4,0,0,0,0,0,16,16
20200507,07MAY2020:00:00:00,UFU ZUBIZARRETA,2,4,2,4,0,6,4,2,6,0,0,0,0,2,0,2,0,2,0,0,1,3,4
20200508,08MAY2020:00:00:00,UFU ALVAREZ,19,2,21,0,0,21,19,2,19,2,0,0,6,9,2,4,0,0,0,5,4,10,19
20200508,08MAY2020:00:00:00,UFU ARGERICH,4,14,10,6,2,18,6,12,10,8,0,0,2,4,10,0,2,0,0,0,0,6,6
20200508,08MAY2020:00:00:00,UFU DURAND,6,12,14,4,0,18,14,4,16,2,2,0,8,4,2,2,0,0,0,0,0,14,14
20200508,08MAY2020:00:00:00,UFU ELIZALDE,16,0,6,10,0,16,12,4,12,4,14,2,0,0,0,0,0,0,0,0,0,12,12
20200508,08MAY2020:00:00:00,UFU FERNANDEZ,30,18,39,7,2,48,34,14,48,0,0,6,11,13,8,2,6,2,0,15,4,15,34
20200508,08MAY2020:00:00:00,UFU GRIERSON,4,6,6,4,0,10,8,2,10,0,2,0,2,0,2,4,0,0,0,0,0,8,8
20200508,08MAY2020:00:00:00,UFU GUTIERREZ,3,6,8,1,0,9,9,0,9,0,5,2,0,2,0,0,0,0,0,1,4,4,9
20200508,08MAY2020:00:00:00,UFU MUÑIZ,48,30,52,20,6,78,54,24,56,22,14,4,20,17,9,7,7,0,0,0,0,54,54
20200508,08MAY2020:00:00:00,UFU PENNA,10,24,22,2,10,34,14,20,30,4,0,0,6,10,9,3,6,0,0,0,0,14,14
20200508,08MAY2020:00:00:00,UFU PIROVANO,4,11,7,4,4,15,9,6,9,6,0,0,5,2,8,0,0,0,0,1,3,5,9
20200508,08MAY2020:00:00:00,UFU PIÑERO,24,24,40,0,8,48,30,18,44,4,0,8,10,12,10,6,0,2,0,0,0,30,30
20200508,08MAY2020:00:00:00,UFU RAMOS MEJIA,12,12,20,2,2,24,22,2,22,2,0,2,6,4,8,2,2,0,0,0,0,22,22
20200508,08MAY2020:00:00:00,UFU RIVADAVIA,17,24,32,2,7,41,41,0,41,0,0,2,13,4,11,2,9,0,0,17,4,20,41
20200508,08MAY2020:00:00:00,UFU SANTOJANNI,6,15,11,10,0,21,13,8,21,0,0,1,8,4,6,0,2,0,0,0,1,12,13
20200508,08MAY2020:00:00:00,UFU TORNU,16,6,18,4,0,22,18,4,18,4,4,2,3,5,6,2,0,0,0,0,0,18,18
20200508,08MAY2020:00:00:00,UFU ZUBIZARRETA,4,9,11,2,0,13,9,4,9,4,0,1,5,5,0,0,0,2,0,0,3,6,9
20200509,09MAY2020:00:00:00,UFU ALVAREZ,1,0,1,0,0,1,1,0,1,0,0,0,1,0,0,0,0,0,0,1,0,0,1
20200509,09MAY2020:00:00:00,UFU ARGERICH,2,4,6,0,0,6,2,4,2,4,0,0,4,0,0,2,0,0,0,0,0,2,2
20200509,09MAY2020:00:00:00,UFU DURAND,2,6,4,2,2,8,8,0,8,0,0,0,2,2,0,2,2,0,0,0,0,8,8
20200509,09MAY2020:00:00:00,UFU ELIZALDE,0,6,4,2,0,6,6,0,6,0,6,0,0,0,0,0,0,0,0,0,0,6,6
20200509,09MAY2020:00:00:00,UFU FERNANDEZ,9,10,15,4,0,19,17,2,17,2,0,0,4,5,5,5,0,0,0,6,4,7,17
20200509,09MAY2020:00:00:00,UFU GUTIERREZ,0,2,2,0,0,2,2,0,2,0,2,0,0,0,0,0,0,0,0,0,1,1,2
20200509,09MAY2020:00:00:00,UFU MUÑIZ,20,23,43,0,0,43,21,22,21,22,6,10,5,12,0,8,0,2,0,0,2,19,21
20200509,09MAY2020:00:00:00,UFU PENNA,10,18,16,8,4,28,12,16,26,2,0,0,8,6,6,3,3,2,0,0,0,12,12
20200509,09MAY2020:00:00:00,UFU PIROVANO,0,7,2,5,0,7,7,0,7,0,0,0,0,7,0,0,0,0,0,1,3,3,7
20200509,09MAY2020:00:00:00,UFU PIÑERO,10,8,18,0,0,18,8,10,18,0,4,4,6,1,3,0,0,0,0,0,0,8,8
20200509,09MAY2020:00:00:00,UFU RAMOS MEJIA,18,6,18,4,2,24,18,6,18,6,0,0,2,6,10,6,0,0,0,0,0,18,18
20200509,09MAY2020:00:00:00,UFU RIVADAVIA,11,20,25,6,0,31,29,2,29,2,0,0,8,14,7,0,2,0,0,8,3,18,29
20200509,09MAY2020:00:00:00,UFU SANTOJANNI,6,10,10,6,0,16,12,4,16,0,0,0,8,2,0,2,4,0,0,0,0,12,12
20200509,09MAY2020:00:00:00,UFU TORNU,21,27,28,4,16,48,38,10,38,10,3,2,10,9,10,8,4,2,0,11,2,25,38
20200510,10MAY2020:00:00:00,UFU ALVAREZ,0,10,8,2,0,10,8,2,8,2,0,0,4,4,0,0,2,0,0,2,2,4,8
20200510,10MAY2020:00:00:00,UFU ARGERICH,0,12,12,0,0,12,6,6,12,0,0,0,6,4,0,0,2,0,0,0,0,6,6
20200510,10MAY2020:00:00:00,UFU DURAND,10,6,12,0,4,16,14,2,14,2,0,2,10,2,2,0,0,0,0,0,0,14,14
20200510,10MAY2020:00:00:00,UFU ELIZALDE,2,4,0,6,0,6,6,0,6,0,4,0,0,0,2,0,0,0,0,0,0,6,6
20200510,10MAY2020:00:00:00,UFU FERNANDEZ,4,9,13,0,0,13,11,2,13,0,0,0,1,2,2,4,2,2,0,2,1,8,11
20200510,10MAY2020:00:00:00,UFU MUÑIZ,30,48,66,8,4,78,76,2,76,2,5,10,3,19,22,10,9,0,0,3,0,73,76
20200510,10MAY2020:00:00:00,UFU PENNA,10,16,22,4,0,26,12,14,24,2,0,2,2,10,4,8,0,0,0,0,0,12,12
20200510,10MAY2020:00:00:00,UFU PIROVANO,12,10,17,5,0,22,14,8,16,6,2,0,6,3,2,2,7,0,0,0,8,6,14
20200510,10MAY2020:00:00:00,UFU PIÑERO,17,10,27,0,0,27,23,4,27,0,0,2,5,6,4,2,8,0,0,0,1,22,23
20200510,10MAY2020:00:00:00,UFU RAMOS MEJIA,4,2,6,0,0,6,6,0,6,0,0,1,3,0,2,0,0,0,0,0,0,6,6
20200510,10MAY2020:00:00:00,UFU RIVADAVIA,9,14,22,1,0,23,23,0,23,0,0,0,11,10,2,0,0,0,0,8,5,10,23
20200510,10MAY2020:00:00:00,UFU SANTOJANNI,4,8,6,6,0,12,4,8,6,6,0,2,0,2,8,0,0,0,0,0,0,4,4
20200510,10MAY2020:00:00:00,UFU TORNU,12,30,25,5,12,42,38,4,38,4,0,0,8,7,21,6,0,0,0,18,0,20,38
20200511,11MAY2020:00:00:00,UFU ALVAREZ,30,16,46,0,0,46,44,2,44,2,2,3,7,14,9,8,1,2,0,12,7,25,44
20200511,11MAY2020:00:00:00,UFU ARGERICH,16,14,22,6,2,30,20,10,22,8,4,4,4,13,1,2,2,0,0,0,0,20,20
20200511,11MAY2020:00:00:00,UFU DURAND,12,4,10,4,2,16,16,0,16,0,0,0,6,4,2,4,0,0,0,0,0,16,16
20200511,11MAY2020:00:00:00,UFU ELIZALDE,2,6,0,8,0,8,6,2,8,0,2,6,0,0,0,0,0,0,0,0,0,6,6
20200511,11MAY2020:00:00:00,UFU FERNANDEZ,23,18,37,4,0,41,27,14,39,2,0,0,9,10,14,5,3,0,0,12,6,9,27
20200511,11MAY2020:00:00:00,UFU FERRER,2,2,0,0,4,4,2,2,2,2,0,0,1,3,0,0,0,0,0,0,0,2,2
20200511,11MAY2020:00:00:00,UFU GRIERSON,2,2,4,0,0,4,2,2,4,0,2,2,0,0,0,0,0,0,0,0,0,2,2
20200511,11MAY2020:00:00:00,UFU GUTIERREZ,2,1,3,0,0,3,3,0,3,0,0,1,0,0,0,0,2,0,0,0,2,1,3
20200511,11MAY2020:00:00:00,UFU MUÑIZ,28,50,50,12,16,78,76,2,76,2,10,12,13,15,19,7,1,1,0,0,0,76,76
20200511,11MAY2020:00:00:00,UFU PENNA,20,10,22,4,4,30,14,16,24,6,0,3,9,10,4,2,0,2,0,0,0,14,14
20200511,11MAY2020:00:00:00,UFU PIROVANO,7,6,9,4,0,13,5,8,9,4,0,0,4,3,4,2,0,0,0,1,0,4,5
20200511,11MAY2020:00:00:00,UFU PIÑERO,30,64,58,12,24,94,72,22,82,12,2,0,12,26,20,27,5,2,0,0,0,72,72
20200511,11MAY2020:00:00:00,UFU RAMOS MEJIA,14,2,10,4,2,16,14,2,16,0,0,0,4,10,0,0,0,2,0,0,0,14,14
20200511,11MAY2020:00:00:00,UFU RIVADAVIA,22,19,30,0,11,41,41,0,41,0,0,0,5,14,5,13,2,2,0,13,10,18,41
20200511,11MAY2020:00:00:00,UFU SANTOJANNI,13,6,19,0,0,19,15,4,19,0,3,0,4,8,2,2,0,0,0,0,1,14,15
20200511,11MAY2020:00:00:00,UFU TORNU,10,4,10,4,0,14,10,4,12,2,0,0,2,6,4,0,0,2,0,0,0,10,10
20200511,11MAY2020:00:00:00,UFU VELEZ SARSFIELD,8,4,8,4,0,12,10,2,10,2,0,0,6,2,3,1,0,0,0,0,0,10,10
20200511,11MAY2020:00:00:00,UFU ZUBIZARRETA,1,1,1,1,0,2,2,0,2,0,0,0,0,0,1,1,0,0,0,0,2,0,2
20200411,11APR2020:00:00:00,UFU RIVADAVIA,2,0,2,0,0,2,0,2,2,0,0,0,0,0,0,1,1,0,0,0,0,0,0
20200412,12APR2020:00:00:00,UFU RIVADAVIA,0,2,2,0,0,2,0,2,2,0,0,0,0,2,0,0,0,0,0,0,0,0,0
20200413,13APR2020:00:00:00,UFU DURAND,2,4,6,0,0,6,0,6,6,0,0,0,0,0,0,6,0,0,0,0,0,0,0
20200413,13APR2020:00:00:00,UFU PENNA,0,2,2,0,0,2,0,2,0,2,0,0,0,0,2,0,0,0,0,0,0,0,0
20200413,13APR2020:00:00:00,UFU RIVADAVIA,14,6,16,4,0,20,0,20,6,14,1,1,6,9,3,0,0,0,0,0,0,0,0
20200414,14APR2020:00:00:00,UFU DURAND,10,11,21,0,0,21,0,21,15,6,0,0,7,9,5,0,0,0,0,0,0,0,0
20200414,14APR2020:00:00:00,UFU PENNA,0,2,2,0,0,2,0,2,0,2,0,0,0,0,2,0,0,0,0,0,0,0,0
20200414,14APR2020:00:00:00,UFU RIVADAVIA,4,14,18,0,0,18,0,18,16,2,0,0,4,5,2,4,3,0,0,0,0,0,0
20200415,15APR2020:00:00:00,UFU DURAND,2,10,12,0,0,12,8,4,8,4,0,0,6,2,2,2,0,0,0,0,0,8,8
20200415,15APR2020:00:00:00,UFU PENNA,14,6,14,2,4,20,4,16,18,2,0,0,4,6,2,4,4,0,0,0,0,4,4
20200415,15APR2020:00:00:00,UFU PIÑERO,18,20,36,2,0,38,0,38,32,6,2,8,8,6,9,3,2,0,0,0,0,0,0
20200415,15APR2020:00:00:00,UFU RIVADAVIA,4,4,8,0,0,8,6,2,6,2,0,0,5,1,2,0,0,0,0,0,0,6,6
20200415,15APR2020:00:00:00,UFU SANTOJANNI,10,5,13,2,0,15,5,10,11,4,1,0,4,2,4,0,4,0,0,0,1,4,5
20200416,16APR2020:00:00:00,UFU DURAND,6,4,4,6,0,10,8,2,8,2,0,0,0,4,4,2,0,0,0,0,0,8,8
20200416,16APR2020:00:00:00,UFU PENNA,18,16,22,6,6,34,12,22,32,2,0,0,6,7,11,8,2,0,0,0,0,12,12
20200416,16APR2020:00:00:00,UFU PIÑERO,20,18,34,0,4,38,2,36,34,4,0,2,8,6,10,8,2,2,0,0,0,2,2
20200416,16APR2020:00:00:00,UFU RIVADAVIA,8,8,14,2,0,16,12,4,12,4,0,0,5,3,2,4,0,2,0,0,0,12,12
20200416,16APR2020:00:00:00,UFU SANTOJANNI,6,4,6,2,2,10,0,10,8,2,0,2,0,2,0,2,4,0,0,0,0,0,0
20200417,17APR2020:00:00:00,UFU ARGERICH,0,2,2,0,0,2,0,2,0,2,0,0,0,2,0,0,0,0,0,0,0,0,0
20200417,17APR2020:00:00:00,UFU DURAND,36,18,40,10,4,54,46,8,46,8,0,0,6,16,23,6,3,0,0,0,0,46,46
20200417,17APR2020:00:00:00,UFU MUÑIZ,4,4,8,0,0,8,0,8,0,8,0,0,0,6,2,0,0,0,0,0,0,0,0
20200417,17APR2020:00:00:00,UFU PENNA,20,20,32,4,4,40,12,28,38,2,0,0,8,2,10,10,8,2,0,0,0,12,12
20200417,17APR2020:00:00:00,UFU PIÑERO,36,18,50,2,2,54,18,36,52,2,0,2,13,19,14,4,2,0,0,0,0,18,18
20200417,17APR2020:00:00:00,UFU RAMOS MEJIA,14,6,20,0,0,20,8,12,20,0,0,0,0,5,7,6,0,2,0,0,0,8,8
20200417,17APR2020:00:00:00,UFU RIVADAVIA,12,0,12,0,0,12,12,0,12,0,0,0,0,8,2,2,0,0,0,0,0,12,12
20200417,17APR2020:00:00:00,UFU SANTOJANNI,14,7,17,4,0,21,11,10,19,2,1,2,7,5,4,0,2,0,0,0,1,10,11
20200417,17APR2020:00:00:00,UFU TORNU,2,2,4,0,0,4,4,0,4,0,0,0,2,2,0,0,0,0,0,0,0,4,4
20200418,18APR2020:00:00:00,UFU ARGERICH,2,0,2,0,0,2,0,2,0,2,0,0,0,2,0,0,0,0,0,0,0,0,0
20200418,18APR2020:00:00:00,UFU DURAND,4,4,8,0,0,8,6,2,6,2,0,0,0,2,4,2,0,0,0,0,0,6,6
20200418,18APR2020:00:00:00,UFU MUÑIZ,6,4,6,4,0,10,0,10,0,10,0,0,0,4,6,0,0,0,0,0,0,0,0
20200418,18APR2020:00:00:00,UFU PENNA,20,14,20,12,2,34,6,28,32,2,0,2,7,8,5,7,3,2,0,0,0,6,6
20200418,18APR2020:00:00:00,UFU PIÑERO,2,10,8,4,0,12,4,8,6,6,0,0,6,0,2,0,4,0,0,0,0,4,4
20200418,18APR2020:00:00:00,UFU RAMOS MEJIA,20,6,12,12,2,26,4,22,4,22,0,0,6,7,5,4,4,0,0,0,0,4,4
20200418,18APR2020:00:00:00,UFU RIVADAVIA,10,2,12,0,0,12,10,2,10,2,0,0,4,4,4,0,0,0,0,0,0,10,10
20200418,18APR2020:00:00:00,UFU SANTOJANNI,4,2,4,2,0,6,0,6,6,0,0,0,0,0,0,2,4,0,0,0,0,0,0
20200418,18APR2020:00:00:00,UFU TORNU,8,8,8,8,0,16,10,6,12,4,0,0,4,4,7,1,0,0,0,0,0,10,10
20200419,19APR2020:00:00:00,UFU ARGERICH,8,12,12,8,0,20,12,8,14,6,0,0,6,4,6,0,2,2,0,0,0,12,12
20200419,19APR2020:00:00:00,UFU DURAND,6,8,6,6,2,14,6,8,6,8,0,0,0,2,3,3,6,0,0,0,0,6,6
20200419,19APR2020:00:00:00,UFU MUÑIZ,2,0,0,2,0,2,0,2,0,2,0,0,0,0,2,0,0,0,0,0,0,0,0
20200419,19APR2020:00:00:00,UFU PENNA,10,10,10,8,2,20,6,14,14,6,0,2,8,4,4,0,2,0,0,0,0,6,6
20200419,19APR2020:00:00:00,UFU PIÑERO,4,12,12,2,2,16,0,16,4,12,0,4,6,2,4,0,0,0,0,0,0,0,0
20200419,19APR2020:00:00:00,UFU RAMOS MEJIA,8,4,8,4,0,12,6,6,6,6,0,0,0,8,2,0,0,2,0,0,0,6,6
20200419,19APR2020:00:00:00,UFU RIVADAVIA,0,2,2,0,0,2,2,0,2,0,0,0,0,0,2,0,0,0,0,0,0,2,2
20200419,19APR2020:00:00:00,UFU SANTOJANNI,8,6,12,2,0,14,2,12,12,2,0,0,2,4,6,0,0,2,0,0,0,2,2
20200419,19APR2020:00:00:00,UFU TORNU,6,2,4,2,2,8,8,0,8,0,0,0,0,4,4,0,0,0,0,0,0,8,8
20200420,20APR2020:00:00:00,UFU ALVAREZ,8,12,18,2,0,20,18,2,18,2,0,3,6,3,5,3,0,0,0,0,0,18,18
20200420,20APR2020:00:00:00,UFU ARGERICH,16,10,10,6,10,26,14,12,14,12,0,1,5,8,2,8,2,0,0,0,0,14,14
20200420,20APR2020:00:00:00,UFU DURAND,0,8,8,0,0,8,8,0,8,0,0,0,0,6,0,0,2,0,0,0,0,8,8
20200420,20APR2020:00:00:00,UFU GRIERSON,2,0,0,2,0,2,0,2,0,2,0,0,0,0,0,2,0,0,0,0,0,0,0
20200420,20APR2020:00:00:00,UFU GUTIERREZ,2,2,0,4,0,4,4,0,4,0,0,4,0,0,0,0,0,0,0,0,0,4,4
20200420,20APR2020:00:00:00,UFU MUÑIZ,2,0,0,2,0,2,0,2,0,2,0,0,0,2,0,0,0,0,0,0,0,0,0
20200420,20APR2020:00:00:00,UFU PENNA,10,12,16,0,6,22,6,16,16,6,0,0,10,2,4,2,4,0,0,0,0,6,6
20200420,20APR2020:00:00:00,UFU PIÑERO,16,18,26,6,2,34,6,28,34,0,0,0,12,8,4,8,2,0,0,0,0,6,6
20200420,20APR2020:00:00:00,UFU RAMOS MEJIA,48,18,48,16,2,66,60,6,60,6,0,0,4,10,22,19,9,2,0,0,0,60,60
20200420,20APR2020:00:00:00,UFU RIVADAVIA,20,6,20,4,2,26,20,6,20,6,0,0,6,6,7,3,4,0,0,0,0,20,20
20200420,20APR2020:00:00:00,UFU SANTOJANNI,12,15,19,8,0,27,7,20,21,6,5,0,4,3,11,4,0,0,0,0,1,6,7
20200420,20APR2020:00:00:00,UFU TORNU,16,14,18,8,4,30,26,4,26,4,0,2,8,10,3,3,2,2,0,0,0,26,26
20200421,21APR2020:00:00:00,UFU ALVAREZ,4,2,6,0,0,6,2,4,6,0,0,0,0,0,4,2,0,0,0,0,0,2,2
20200421,21APR2020:00:00:00,UFU ARGERICH,14,10,16,2,6,24,16,8,20,4,0,0,4,6,4,5,1,4,0,0,0,16,16
20200421,21APR2020:00:00:00,UFU DURAND,2,6,6,0,2,8,6,2,6,2,0,0,0,6,2,0,0,0,0,0,0,6,6
20200421,21APR2020:00:00:00,UFU GRIERSON,8,0,6,2,0,8,0,8,0,8,0,0,2,0,2,4,0,0,0,0,0,0,0
20200421,21APR2020:00:00:00,UFU GUTIERREZ,2,4,4,2,0,6,6,0,6,0,2,4,0,0,0,0,0,0,0,0,0,6,6
20200421,21APR2020:00:00:00,UFU MUÑIZ,14,10,10,14,0,24,14,10,14,10,0,0,3,11,8,2,0,0,0,0,0,14,14
20200421,21APR2020:00:00:00,UFU PENNA,12,6,10,4,4,18,8,10,16,2,0,0,2,6,4,4,2,0,0,0,0,8,8
20200421,21APR2020:00:00:00,UFU PIROVANO,0,2,2,0,0,2,0,2,0,2,0,0,2,0,0,0,0,0,0,0,0,0,0
20200421,21APR2020:00:00:00,UFU PIÑERO,20,12,32,0,0,32,8,24,30,2,0,4,8,6,8,4,2,0,0,0,0,8,8
20200421,21APR2020:00:00:00,UFU RAMOS MEJIA,34,12,30,14,2,46,40,6,46,0,0,0,2,9,7,16,8,4,0,0,0,40,40
20200421,21APR2020:00:00:00,UFU RIVADAVIA,8,6,12,2,0,14,14,0,14,0,0,0,0,8,4,0,2,0,0,0,0,14,14
20200421,21APR2020:00:00:00,UFU SANTOJANNI,10,12,17,3,2,22,8,14,22,0,2,2,2,2,6,4,4,0,0,0,2,6,8
20200421,21APR2020:00:00:00,UFU TORNU,18,6,12,10,2,24,24,0,24,0,0,0,1,5,8,6,4,0,0,0,0,24,24
20200422,22APR2020:00:00:00,UFU ALVAREZ,2,4,6,0,0,6,6,0,6,0,0,0,2,2,2,0,0,0,0,0,0,6,6
20200422,22APR2020:00:00:00,UFU ARGERICH,6,10,14,2,0,16,10,6,12,4,0,0,2,4,6,2,2,0,0,0,0,10,10
20200422,22APR2020:00:00:00,UFU DURAND,6,8,10,4,0,14,10,4,12,2,0,0,6,2,2,4,0,0,0,0,0,10,10
20200422,22APR2020:00:00:00,UFU GRIERSON,2,2,4,0,0,4,2,2,2,2,0,0,0,0,2,2,0,0,0,0,0,2,2
20200422,22APR2020:00:00:00,UFU GUTIERREZ,4,0,2,2,0,4,4,0,4,0,0,0,0,0,1,3,0,0,0,0,0,4,4
20200512,12MAY2020:00:00:00,UFU ALVAREZ,24,13,35,2,0,37,29,8,35,2,0,4,10,11,6,3,1,2,0,8,6,15,29
20200512,12MAY2020:00:00:00,UFU ARGERICH,12,16,16,6,6,28,14,14,18,10,0,0,10,8,8,2,0,0,0,0,0,14,14
20200512,12MAY2020:00:00:00,UFU DURAND,34,18,50,2,0,52,40,12,42,10,12,2,14,12,4,6,2,0,0,0,0,40,40
20200512,12MAY2020:00:00:00,UFU ELIZALDE,4,2,2,4,0,6,4,2,6,0,6,0,0,0,0,0,0,0,0,0,0,4,4
20200512,12MAY2020:00:00:00,UFU FERNANDEZ,23,18,35,4,2,41,33,8,41,0,0,2,6,11,6,8,6,2,0,10,6,17,33
20200512,12MAY2020:00:00:00,UFU FERRER,0,4,2,2,0,4,4,0,4,0,0,0,0,0,2,2,0,0,0,0,0,4,4
20200512,12MAY2020:00:00:00,UFU GRIERSON,2,2,0,4,0,4,0,4,4,0,2,0,0,0,0,2,0,0,0,0,0,0,0
20200512,12MAY2020:00:00:00,UFU GUTIERREZ,14,1,13,2,0,15,13,2,15,0,4,6,0,5,0,0,0,0,0,1,7,5,13
20200512,12MAY2020:00:00:00,UFU MUÑIZ,45,46,69,4,18,91,89,2,89,2,12,14,25,27,8,5,0,0,0,18,0,71,89
20200512,12MAY2020:00:00:00,UFU PENNA,10,16,22,2,2,26,18,8,26,0,0,0,5,5,10,6,0,0,0,0,0,18,18
20200512,12MAY2020:00:00:00,UFU PIROVANO,4,8,12,0,0,12,10,2,10,2,0,2,4,2,4,0,0,0,0,0,0,10,10
20200512,12MAY2020:00:00:00,UFU PIÑERO,40,40,60,4,16,80,32,48,56,24,6,8,20,22,15,1,6,2,0,0,0,32,32
20200512,12MAY2020:00:00:00,UFU RAMOS MEJIA,32,26,54,4,0,58,32,26,34,24,4,10,10,15,11,0,6,2,0,0,0,32,32
20200512,12MAY2020:00:00:00,UFU RIVADAVIA,28,22,35,4,11,50,48,2,48,2,0,0,16,18,4,7,1,4,0,20,8,20,48
20200512,12MAY2020:00:00:00,UFU SANTOJANNI,9,13,20,0,2,22,18,4,20,2,4,2,2,6,6,2,0,0,0,1,3,14,18
20200512,12MAY2020:00:00:00,UFU TORNU,8,4,6,6,0,12,6,6,8,4,0,0,0,0,2,2,6,2,0,0,0,6,6
20200512,12MAY2020:00:00:00,UFU VELEZ SARSFIELD,0,2,2,0,0,2,2,0,2,0,0,0,0,0,0,0,2,0,0,0,0,2,2
20200512,12MAY2020:00:00:00,UFU ZUBIZARRETA,5,4,0,5,4,9,3,6,3,6,0,2,1,2,2,2,0,0,0,0,1,2,3
20200513,13MAY2020:00:00:00,UFU ALVAREZ,14,11,25,0,0,25,21,4,25,0,2,0,10,4,6,0,2,1,0,4,7,10,21
20200513,13MAY2020:00:00:00,UFU ARGERICH,12,16,22,6,0,28,18,10,26,2,0,0,10,6,6,4,2,0,0,0,0,18,18
20200513,13MAY2020:00:00:00,UFU DURAND,6,4,8,0,2,10,8,2,8,2,0,0,2,0,6,2,0,0,0,0,0,8,8
20200513,13MAY2020:00:00:00,UFU ELIZALDE,12,12,20,4,0,24,24,0,24,0,8,13,3,0,0,0,0,0,0,0,0,24,24
20200513,13MAY2020:00:00:00,UFU FERNANDEZ,25,10,32,3,0,35,33,2,35,0,0,0,12,12,5,3,2,1,0,11,7,15,33
20200513,13MAY2020:00:00:00,UFU FERRER,2,2,2,0,2,4,4,0,4,0,0,0,0,2,2,0,0,0,0,0,0,4,4
20200513,13MAY2020:00:00:00,UFU GRIERSON,2,2,2,2,0,4,4,0,4,0,0,0,2,2,0,0,0,0,0,0,0,4,4
20200513,13MAY2020:00:00:00,UFU GUTIERREZ,6,6,8,4,0,12,12,0,12,0,2,4,0,2,0,4,0,0,0,0,6,6,12
20200513,13MAY2020:00:00:00,UFU MUÑIZ,58,76,88,11,35,134,126,8,128,6,10,11,26,37,27,17,4,2,0,9,5,112,126
20200513,13MAY2020:00:00:00,UFU PENNA,22,10,20,10,2,32,10,22,32,0,0,0,10,9,6,5,2,0,0,0,0,10,10
20200513,13MAY2020:00:00:00,UFU PIROVANO,3,6,5,4,0,9,5,4,9,0,0,0,0,6,1,2,0,0,0,0,3,2,5
20200513,13MAY2020:00:00:00,UFU PIÑERO,32,30,54,0,8,62,28,34,52,10,0,7,14,15,10,7,7,2,0,0,0,28,28
20200513,13MAY2020:00:00:00,UFU RAMOS MEJIA,10,18,18,8,2,28,28,0,28,0,0,0,4,12,8,4,0,0,0,0,0,28,28
20200513,13MAY2020:00:00:00,UFU RIVADAVIA,37,15,33,13,6,52,48,4,48,4,0,0,7,18,13,11,3,0,0,11,10,27,48
20200513,13MAY2020:00:00:00,UFU SANTOJANNI,6,6,10,2,0,12,8,4,10,2,0,0,4,0,4,2,2,0,0,0,0,8,8
20200513,13MAY2020:00:00:00,UFU TORNU,28,16,40,4,0,44,30,14,32,12,2,0,16,8,8,4,6,0,0,0,0,30,30
20200513,13MAY2020:00:00:00,UFU VELEZ SARSFIELD,2,4,4,2,0,6,2,4,4,2,0,0,0,6,0,0,0,0,0,0,0,2,2
20200514,14MAY2020:00:00:00,UFU ALVAREZ,22,11,31,1,1,33,23,10,23,10,4,6,2,13,4,4,0,0,0,4,10,9,23
20200514,14MAY2020:00:00:00,UFU ARGERICH,21,32,49,4,0,53,45,8,47,6,4,4,10,7,16,4,6,2,0,2,10,33,45
20200514,14MAY2020:00:00:00,UFU BORDA-MOYANO,0,2,2,0,0,2,0,2,0,2,0,0,2,0,0,0,0,0,0,0,0,0,0
20200514,14MAY2020:00:00:00,UFU DURAND,26,32,48,6,4,58,20,38,20,38,6,11,21,10,0,7,3,0,0,0,0,20,20
20200514,14MAY2020:00:00:00,UFU ELIZALDE,12,4,10,6,0,16,14,2,14,2,11,5,0,0,0,0,0,0,0,0,0,14,14
20200514,14MAY2020:00:00:00,UFU FERNANDEZ,21,24,36,7,2,45,39,6,43,2,0,0,13,14,6,5,5,2,0,15,8,16,39
20200514,14MAY2020:00:00:00,UFU FERRER,2,2,0,4,0,4,4,0,4,0,0,0,0,2,2,0,0,0,0,0,0,4,4
20200514,14MAY2020:00:00:00,UFU GRIERSON,23,12,31,4,0,35,33,2,35,0,8,8,5,7,1,4,2,0,0,13,1,19,33
20200514,14MAY2020:00:00:00,UFU GUTIERREZ,7,2,4,5,0,9,7,2,7,2,5,0,0,4,0,0,0,0,0,0,4,3,7
20200514,14MAY2020:00:00:00,UFU MUÑIZ,121,65,110,54,22,186,174,12,176,10,13,12,26,46,26,39,19,5,0,8,2,164,174
20200514,14MAY2020:00:00:00,UFU PENNA,18,12,26,4,0,30,14,16,26,4,0,2,11,9,2,2,2,2,0,0,0,14,14
20200514,14MAY2020:00:00:00,UFU PIROVANO,14,12,26,0,0,26,18,8,20,6,6,2,5,5,2,4,0,2,0,0,2,16,18
20200514,14MAY2020:00:00:00,UFU PIÑERO,32,30,54,4,4,62,38,24,58,4,0,4,16,15,14,5,4,4,0,0,0,38,38
20200514,14MAY2020:00:00:00,UFU RAMOS MEJIA,14,10,14,8,2,24,22,2,22,2,0,0,2,14,2,4,0,2,0,0,0,22,22
20200514,14MAY2020:00:00:00,UFU RIVADAVIA,20,17,23,3,11,37,31,6,31,6,0,2,14,8,8,4,1,0,0,9,12,10,31
20200514,14MAY2020:00:00:00,UFU SANTOJANNI,2,4,6,0,0,6,4,2,6,0,0,0,2,2,2,0,0,0,0,0,0,4,4
20200514,14MAY2020:00:00:00,UFU TORNU,6,6,10,2,0,12,12,0,12,0,0,0,2,2,2,0,6,0,0,0,0,12,12
20200514,14MAY2020:00:00:00,UFU VELEZ SARSFIELD,2,2,0,4,0,4,4,0,4,0,0,0,2,0,0,2,0,0,0,0,0,4,4
20200514,14MAY2020:00:00:00,UFU ZUBIZARRETA,2,0,2,0,0,2,0,2,2,0,0,0,0,0,0,2,0,0,0,0,0,0,0
20200515,15MAY2020:00:00:00,UFU ALVAREZ,17,14,29,0,2,31,25,6,25,6,0,2,7,11,7,4,0,0,0,6,6,13,25
20200515,15MAY2020:00:00:00,UFU ARGERICH,6,10,10,6,0,16,12,4,14,2,0,0,4,4,2,4,2,0,0,0,0,12,12
20200515,15MAY2020:00:00:00,UFU DURAND,24,24,32,6,10,48,34,14,38,10,2,2,8,20,10,2,2,2,0,0,0,34,34
20200515,15MAY2020:00:00:00,UFU ELIZALDE,6,12,14,4,0,18,14,4,14,4,4,13,1,0,0,0,0,0,0,0,0,14,14
20200515,15MAY2020:00:00:00,UFU FERNANDEZ,37,48,78,4,3,85,55,30,65,20,2,2,24,23,18,14,2,0,0,16,6,33,55
20200515,15MAY2020:00:00:00,UFU FERRER,4,12,12,4,0,16,8,8,8,8,0,0,8,4,2,0,2,0,0,0,0,8,8
20200515,15MAY2020:00:00:00,UFU GRIERSON,4,8,12,0,0,12,6,6,12,0,4,2,0,2,4,0,0,0,0,0,0,6,6
20200515,15MAY2020:00:00:00,UFU GUTIERREZ,9,4,10,3,0,13,13,0,13,0,2,2,2,6,1,0,0,0,0,1,6,6,13
20200515,15MAY2020:00:00:00,UFU MUÑIZ,34,26,24,32,4,60,54,6,56,4,0,0,14,11,17,14,2,2,0,0,0,54,54
20200515,15MAY2020:00:00:00,UFU PENNA,18,24,30,2,10,42,16,26,40,2,0,2,16,6,6,6,6,0,0,0,0,16,16
20200515,15MAY2020:00:00:00,UFU PIROVANO,20,18,36,2,0,38,30,8,30,8,0,6,7,7,10,8,0,0,0,0,0,30,30
20200515,15MAY2020:00:00:00,UFU PIÑERO,38,20,52,0,6,58,34,24,50,8,7,3,5,21,7,7,4,4,0,0,0,34,34
20200515,15MAY2020:00:00:00,UFU RAMOS MEJIA,6,2,4,4,0,8,6,2,8,0,0,0,4,2,2,0,0,0,0,0,0,6,6
20200515,15MAY2020:00:00:00,UFU RIVADAVIA,34,12,22,10,14,46,44,2,44,2,0,0,4,8,12,20,2,0,0,9,15,20,44
20200515,15MAY2020:00:00:00,UFU SANTOJANNI,6,4,6,4,0,10,8,2,10,0,0,1,5,0,4,0,0,0,0,0,0,8,8
20200515,15MAY2020:00:00:00,UFU TORNU,38,21,57,2,0,59,31,28,31,28,8,14,9,10,13,4,0,1,0,7,4,20,31
20200515,15MAY2020:00:00:00,UFU VELEZ SARSFIELD,36,16,26,26,0,52,50,2,52,0,0,0,5,17,16,4,10,0,0,0,0,50,50
20200515,15MAY2020:00:00:00,UFU ZUBIZARRETA,9,11,13,7,0,20,2,18,14,6,0,4,10,4,0,2,0,0,0,0,2,0,2
20200516,16MAY2020:00:00:00,UFU ALVAREZ,4,8,10,0,2,12,6,6,8,4,0,0,4,6,0,2,0,0,0,1,1,4,6
20200516,16MAY2020:00:00:00,UFU ARGERICH,2,14,16,0,0,16,14,2,14,2,0,0,0,2,0,10,0,4,0,0,0,14,14
20200516,16MAY2020:00:00:00,UFU DURAND,16,2,10,6,2,18,16,2,18,0,0,0,2,6,10,0,0,0,0,0,0,16,16
20200516,16MAY2020:00:00:00,UFU ELIZALDE,12,6,12,6,0,18,12,6,16,2,10,5,3,0,0,0,0,0,0,0,0,12,12
20200516,16MAY2020:00:00:00,UFU FERNANDEZ,21,15,33,3,0,36,32,4,32,4,0,0,8,11,9,8,0,0,0,13,2,17,32
20200516,16MAY2020:00:00:00,UFU FERRER,4,2,6,0,0,6,4,2,4,2,0,0,2,0,2,0,0,2,0,0,0,4,4
20200516,16MAY2020:00:00:00,UFU GRIERSON,4,0,4,0,0,4,0,4,4,0,0,0,0,2,0,2,0,0,0,0,0,0,0
20200516,16MAY2020:00:00:00,UFU GUTIERREZ,10,2,12,0,0,12,10,2,10,2,6,2,2,2,0,0,0,0,0,1,4,5,10
20200516,16MAY2020:00:00:00,UFU MUÑIZ,16,32,44,4,0,48,28,20,28,20,7,3,10,6,9,5,4,4,0,1,1,26,28
20200516,16MAY2020:00:00:00,UFU PENNA,14,16,28,2,0,30,20,10,30,0,0,2,6,6,4,4,6,2,0,0,0,20,20
20200516,16MAY2020:00:00:00,UFU PIROVANO,6,4,4,6,0,10,6,4,8,2,0,0,2,1,1,4,2,0,0,0,0,6,6
20200516,16MAY2020:00:00:00,UFU PIÑERO,12,8,16,2,2,20,12,8,16,4,0,0,6,8,4,2,0,0,0,0,0,12,12
20200516,16MAY2020:00:00:00,UFU RAMOS MEJIA,8,14,18,4,0,22,16,6,18,4,0,0,2,4,10,4,2,0,0,0,0,16,16
20200516,16MAY2020:00:00:00,UFU RIVADAVIA,29,15,34,10,0,44,38,6,38,6,0,2,9,9,13,9,2,0,0,6,12,20,38
20200516,16MAY2020:00:00:00,UFU SANTOJANNI,4,8,10,2,0,12,6,6,12,0,0,0,6,2,4,0,0,0,0,0,0,6,6
20200516,16MAY2020:00:00:00,UFU TORNU,2,2,0,0,4,4,4,0,4,0,0,0,0,0,2,2,0,0,0,0,0,4,4
20200517,17MAY2020:00:00:00,UFU ALVAREZ,6,5,9,2,0,11,5,6,5,6,0,0,2,2,1,2,4,0,0,1,2,2,5
20200517,17MAY2020:00:00:00,UFU ARGERICH,6,6,12,0,0,12,10,2,10,2,0,0,6,2,0,2,0,2,0,0,0,10,10
20200517,17MAY2020:00:00:00,UFU DURAND,10,6,8,2,6,16,16,0,16,0,2,2,4,6,0,2,0,0,0,0,0,16,16
20200517,17MAY2020:00:00:00,UFU ELIZALDE,14,10,18,6,0,24,22,2,24,0,8,10,0,4,2,0,0,0,0,0,0,22,22
20200517,17MAY2020:00:00:00,UFU FERNANDEZ,14,5,19,0,0,19,17,2,19,0,0,0,8,2,7,2,0,0,0,6,4,6,17
20200517,17MAY2020:00:00:00,UFU FERRER,0,4,2,2,0,4,2,2,4,0,0,0,0,0,1,3,0,0,0,0,0,2,2
20200517,17MAY2020:00:00:00,UFU GRIERSON,8,4,10,2,0,12,2,10,8,4,0,0,4,2,2,4,0,0,0,0,0,2,2
20200517,17MAY2020:00:00:00,UFU GUTIERREZ,4,2,6,0,0,6,6,0,6,0,2,2,0,2,0,0,0,0,0,1,2,3,6
20200517,17MAY2020:00:00:00,UFU MUÑIZ,7,7,12,2,0,14,10,4,14,0,2,0,0,4,4,2,2,0,0,5,0,5,10
20200517,17MAY2020:00:00:00,UFU PENNA,10,8,18,0,0,18,8,10,8,10,0,2,9,1,0,1,1,4,0,0,0,8,8
20200517,17MAY2020:00:00:00,UFU PIROVANO,10,4,10,4,0,14,6,8,6,8,0,4,4,2,2,2,0,0,0,1,1,4,6
20200517,17MAY2020:00:00:00,UFU PIÑERO,10,14,18,4,2,24,16,8,22,2,0,0,12,2,4,4,0,2,0,0,1,15,16
20200517,17MAY2020:00:00:00,UFU RAMOS MEJIA,8,22,24,6,0,30,28,2,30,0,0,2,10,2,8,4,4,0,0,0,0,28,28
20200517,17MAY2020:00:00:00,UFU RIVADAVIA,17,11,23,4,1,28,26,2,26,2,0,0,4,8,10,5,1,0,0,10,6,10,26
20200517,17MAY2020:00:00:00,UFU SANTOJANNI,6,0,2,4,0,6,6,0,6,0,0,0,2,0,2,2,0,0,0,0,0,6,6
20200517,17MAY2020:00:00:00,UFU TORNU,3,5,5,3,0,8,8,0,8,0,0,0,0,4,3,1,0,0,0,0,2,6,8
20200518,18MAY2020:00:00:00,UFU ALVAREZ,21,15,33,2,1,36,30,6,30,6,4,3,6,15,4,4,0,0,0,10,6,14,30
20200518,18MAY2020:00:00:00,UFU ARGERICH,28,22,48,0,2,50,30,20,36,14,2,6,19,9,8,4,0,2,0,0,0,30,30
20200518,18MAY2020:00:00:00,UFU BORDA-MOYANO,7,20,19,4,4,27,25,2,25,2,0,0,0,6,9,5,7,0,0,3,12,10,25
20200518,18MAY2020:00:00:00,UFU DURAND,10,12,18,2,2,22,18,4,20,2,0,0,8,6,2,2,4,0,0,0,0,18,18
20200518,18MAY2020:00:00:00,UFU ELIZALDE,2,16,6,12,0,18,10,8,12,6,10,6,0,0,0,1,1,0,0,0,0,10,10
20200518,18MAY2020:00:00:00,UFU FERNANDEZ,24,11,30,5,0,35,33,2,35,0,0,0,14,12,5,0,4,0,0,11,3,19,33
20200518,18MAY2020:00:00:00,UFU FERRER,22,8,12,18,0,30,22,8,22,8,0,0,4,2,12,9,3,0,0,0,0,22,22
20200518,18MAY2020:00:00:00,UFU GRIERSON,10,10,14,6,0,20,12,8,20,0,2,0,4,6,2,6,0,0,0,0,0,12,12
20200518,18MAY2020:00:00:00,UFU GUTIERREZ,39,13,34,18,0,52,28,24,30,22,15,7,10,12,0,8,0,0,0,0,16,11,28
20200518,18MAY2020:00:00:00,UFU MUÑIZ,65,57,78,22,22,122,62,60,62,60,18,12,21,28,23,12,4,4,0,11,20,31,62
20200518,18MAY2020:00:00:00,UFU PENNA,30,8,12,12,14,38,20,18,30,8,0,0,6,12,12,7,1,0,0,4,8,8,20
20200518,18MAY2020:00:00:00,UFU PIROVANO,4,3,5,2,0,7,7,0,7,0,0,0,0,2,1,4,0,0,0,1,2,4,7
20200518,18MAY2020:00:00:00,UFU PIÑERO,78,50,116,6,6,128,68,60,84,44,2,7,34,33,28,16,6,2,0,0,0,68,68
20200518,18MAY2020:00:00:00,UFU RAMOS MEJIA,42,26,50,14,4,68,34,34,60,8,0,0,13,25,8,15,5,2,0,0,1,33,34
20200518,18MAY2020:00:00:00,UFU RIVADAVIA,37,27,44,11,9,64,58,6,58,6,0,4,18,12,15,11,2,2,0,15,16,27,58
20200518,18MAY2020:00:00:00,UFU SANTOJANNI,14,14,25,3,0,28,14,14,18,10,0,0,11,11,4,2,0,0,0,1,4,9,14
20200518,18MAY2020:00:00:00,UFU TORNU,9,6,13,2,0,15,15,0,15,0,0,1,5,1,3,3,2,0,0,0,6,9,15
20200518,18MAY2020:00:00:00,UFU VELEZ SARSFIELD,0,4,2,2,0,4,0,4,2,2,0,0,2,2,0,0,0,0,0,0,0,0,0
20200518,18MAY2020:00:00:00,UFU ZUBIZARRETA,0,2,0,2,0,2,0,2,2,0,0,0,0,0,0,2,0,0,0,0,0,0,0
20200519,19MAY2020:00:00:00,UFU ALVAREZ,6,17,19,4,0,23,23,0,23,0,0,2,0,15,2,2,0,2,0,6,4,13,23
20200519,19MAY2020:00:00:00,UFU ARGERICH,10,20,22,6,2,30,22,8,22,8,0,0,7,5,11,5,2,0,0,0,0,22,22
20200519,19MAY2020:00:00:00,UFU BORDA-MOYANO,15,47,42,14,6,62,48,14,48,14,0,0,8,9,11,19,11,4,0,4,20,24,48
20200519,19MAY2020:00:00:00,UFU DURAND,10,10,18,2,0,20,12,8,18,2,0,1,7,8,2,2,0,0,0,0,0,12,12
20200519,19MAY2020:00:00:00,UFU ELIZALDE,12,14,20,6,0,26,18,8,24,2,16,8,0,2,0,0,0,0,0,0,0,18,18
20200519,19MAY2020:00:00:00,UFU FERNANDEZ,16,14,27,0,3,30,20,10,28,2,0,0,3,16,5,6,0,0,0,7,2,11,20
20200519,19MAY2020:00:00:00,UFU FERRER,24,24,16,32,0,48,22,26,22,26,0,0,13,22,9,4,0,0,0,0,0,22,22
20200519,19MAY2020:00:00:00,UFU GRIERSON,0,2,2,0,0,2,2,0,2,0,0,0,2,0,0,0,0,0,0,1,1,0,2
20200519,19MAY2020:00:00:00,UFU GUTIERREZ,24,6,22,8,0,30,26,4,26,4,7,6,4,4,5,4,0,0,0,4,10,12,26
20200519,19MAY2020:00:00:00,UFU MUÑIZ,37,45,54,22,6,82,58,24,58,24,9,18,6,19,10,9,7,4,0,4,23,31,58
20200519,19MAY2020:00:00:00,UFU PENNA,16,10,18,4,4,26,16,10,22,4,0,3,10,7,2,2,0,2,0,3,5,8,16
20200519,19MAY2020:00:00:00,UFU PIROVANO,21,29,31,17,2,50,34,16,46,4,4,2,12,8,13,6,5,0,0,6,7,21,34
20200519,19MAY2020:00:00:00,UFU PIÑERO,57,68,104,8,13,125,47,78,53,72,10,6,27,48,16,12,6,0,0,21,6,20,47
20200519,19MAY2020:00:00:00,UFU RAMOS MEJIA,62,34,72,22,2,96,72,24,84,12,0,0,23,39,21,10,3,0,0,0,0,72,72
20200519,19MAY2020:00:00:00,UFU RIVADAVIA,36,22,41,4,13,58,50,8,50,8,0,6,12,16,14,6,4,0,0,6,15,25,50
20200519,19MAY2020:00:00:00,UFU SANTOJANNI,15,10,16,9,0,25,17,8,21,4,5,0,2,3,4,3,6,2,0,5,5,7,17
20200519,19MAY2020:00:00:00,UFU TORNU,6,2,4,4,0,8,6,2,8,0,0,0,0,0,1,3,4,0,0,1,1,4,6
20200519,19MAY2020:00:00:00,UFU VELEZ SARSFIELD,0,2,0,2,0,2,2,0,2,0,0,0,0,0,0,2,0,0,0,0,1,1,2
20200519,19MAY2020:00:00:00,UFU ZUBIZARRETA,2,6,6,2,0,8,6,2,6,2,0,0,2,2,4,0,0,0,0,1,2,3,6
20200520,20MAY2020:00:00:00,UFU ALVAREZ,15,20,27,4,4,35,29,6,31,4,4,2,5,4,12,6,0,2,0,2,12,15,29
20200520,20MAY2020:00:00:00,UFU ARGERICH,12,30,34,6,2,42,34,8,38,4,2,0,13,8,5,8,2,4,0,0,0,34,34
20200520,20MAY2020:00:00:00,UFU BORDA-MOYANO,22,7,14,15,0,29,29,0,29,0,0,0,4,3,10,7,5,0,0,0,16,13,29
20200520,20MAY2020:00:00:00,UFU DURAND,16,6,10,10,2,22,16,6,20,2,0,6,6,1,3,2,4,0,0,0,0,16,16
20200520,20MAY2020:00:00:00,UFU ELIZALDE,8,8,6,10,0,16,12,4,16,0,8,8,0,0,0,0,0,0,0,0,0,12,12
20200520,20MAY2020:00:00:00,UFU FERNANDEZ,24,21,39,4,2,45,43,2,43,2,0,0,12,14,7,5,7,0,0,13,11,19,43
20200520,20MAY2020:00:00:00,UFU FERRER,14,8,18,4,0,22,18,4,18,4,0,4,2,12,0,2,0,2,0,0,2,16,18
20200520,20MAY2020:00:00:00,UFU GRIERSON,8,2,10,0,0,10,8,2,10,0,2,0,0,4,0,2,2,0,0,1,3,4,8
20200520,20MAY2020:00:00:00,UFU GUTIERREZ,12,6,10,8,0,18,16,2,16,2,1,4,4,3,4,0,2,0,0,0,9,7,16
20200520,20MAY2020:00:00:00,UFU MUÑIZ,42,41,68,13,2,83,63,20,63,20,11,10,22,13,15,4,6,2,0,14,21,28,63
20200520,20MAY2020:00:00:00,UFU PENNA,49,5,36,13,5,54,44,10,48,6,0,0,6,21,11,8,7,1,0,2,22,20,44
20200520,20MAY2020:00:00:00,UFU PIROVANO,9,3,6,6,0,12,12,0,12,0,0,0,5,1,0,6,0,0,0,1,6,5,12
20200520,20MAY2020:00:00:00,UFU PIÑERO,49,57,96,4,6,106,50,56,78,28,0,12,26,31,13,8,12,4,0,15,14,21,50
20200520,20MAY2020:00:00:00,UFU RAMOS MEJIA,48,24,50,20,2,72,66,6,66,6,0,0,8,34,14,12,2,2,0,0,0,66,66
20200520,20MAY2020:00:00:00,UFU RIVADAVIA,50,44,69,14,11,94,76,18,76,18,0,0,29,24,17,10,9,5,0,20,20,36,76
20200520,20MAY2020:00:00:00,UFU SANTOJANNI,12,11,16,7,0,23,15,8,17,6,4,0,0,10,3,2,0,4,0,2,8,5,15
20200520,20MAY2020:00:00:00,UFU TORNU,4,5,7,2,0,9,7,2,7,2,0,0,4,2,2,1,0,0,0,1,1,5,7
20200520,20MAY2020:00:00:00,UFU ZUBIZARRETA,4,2,4,0,2,6,2,4,2,4,0,0,0,3,3,0,0,0,0,0,0,2,2
20200521,21MAY2020:00:00:00,UFU ALVAREZ,26,24,44,2,4,50,40,10,46,4,4,6,5,10,11,8,4,2,0,12,10,18,40
20200521,21MAY2020:00:00:00,UFU ARGERICH,15,20,31,2,2,35,31,4,31,4,0,2,6,8,7,3,3,6,0,1,0,30,31
20200521,21MAY2020:00:00:00,UFU BORDA-MOYANO,6,5,3,2,6,11,9,2,9,2,0,0,0,0,8,0,1,2,0,0,5,4,9
20200521,21MAY2020:00:00:00,UFU DURAND,14,6,18,2,0,20,6,14,20,0,0,2,4,5,5,4,0,0,0,0,0,6,6
20200521,21MAY2020:00:00:00,UFU ELIZALDE,12,2,10,4,0,14,8,6,14,0,7,7,0,0,0,0,0,0,0,0,5,3,8
20200521,21MAY2020:00:00:00,UFU FERNANDEZ,16,17,33,0,0,33,27,6,33,0,0,1,5,14,5,6,0,2,0,9,6,12,27
20200521,21MAY2020:00:00:00,UFU FERRER,18,18,22,14,0,36,12,24,12,24,0,0,4,10,12,10,0,0,0,1,5,6,12
20200521,21MAY2020:00:00:00,UFU GRIERSON,4,11,13,2,0,15,7,8,13,2,0,0,6,5,0,2,0,2,0,1,2,4,7
20200521,21MAY2020:00:00:00,UFU GUTIERREZ,21,12,10,23,0,33,25,8,25,8,10,6,4,6,0,7,0,0,0,0,13,12,25
20200521,21MAY2020:00:00:00,UFU MUÑIZ,26,29,43,11,1,55,35,20,35,20,3,8,3,12,11,9,7,2,0,9,12,14,35
20200521,21MAY2020:00:00:00,UFU PENNA,21,17,30,6,2,38,24,14,32,6,0,2,14,10,6,4,0,2,0,8,4,12,24
20200521,21MAY2020:00:00:00,UFU PIROVANO,31,10,28,13,0,41,33,8,33,8,2,2,2,11,12,10,2,0,0,2,1,30,33
20200521,21MAY2020:00:00:00,UFU RAMOS MEJIA,22,20,34,2,6,42,32,10,36,6,0,2,10,10,4,10,4,2,0,0,0,32,32
20200521,21MAY2020:00:00:00,UFU RIVADAVIA,24,29,31,6,16,53,43,10,43,10,0,1,24,2,8,11,5,2,0,13,14,16,43
20200521,21MAY2020:00:00:00,UFU SANTOJANNI,14,11,19,6,0,25,13,12,17,8,3,3,4,8,5,2,0,0,0,1,6,6,13
20200521,21MAY2020:00:00:00,UFU TORNU,8,7,13,2,0,15,15,0,15,0,0,0,0,6,4,4,1,0,0,1,2,12,15
20200521,21MAY2020:00:00:00,UFU VELEZ SARSFIELD,6,4,8,2,0,10,10,0,10,0,0,1,3,2,2,2,0,0,0,1,2,7,10
20200521,21MAY2020:00:00:00,UFU ZUBIZARRETA,2,5,7,0,0,7,1,6,1,6,2,0,3,0,0,0,2,0,0,0,1,0,1
20200522,22MAY2020:00:00:00,UFU ALVAREZ,16,14,27,1,2,30,28,2,30,0,1,4,10,10,5,0,0,0,0,7,8,13,28
20200522,22MAY2020:00:00:00,UFU ARGERICH,18,16,26,6,2,34,10,24,18,16,6,2,10,5,3,4,2,2,0,0,0,10,10
20200522,22MAY2020:00:00:00,UFU BORDA-MOYANO,32,16,23,23,2,48,46,2,46,2,0,0,1,6,14,23,4,0,0,0,25,21,46
20200522,22MAY2020:00:00:00,UFU DURAND,12,7,15,4,0,19,15,4,19,0,0,2,5,6,0,4,2,0,0,4,4,7,15
20200522,22MAY2020:00:00:00,UFU ELIZALDE,8,7,13,2,0,15,9,6,13,2,7,3,3,2,0,0,0,0,0,3,2,4,9
20200522,22MAY2020:00:00:00,UFU FERNANDEZ,33,24,47,6,4,57,57,0,57,0,0,2,18,6,13,12,4,2,0,18,11,28,57
20200522,22MAY2020:00:00:00,UFU FERRER,7,10,4,13,0,17,5,12,5,12,0,0,2,2,6,3,2,2,0,0,2,3,5
20200522,22MAY2020:00:00:00,UFU GRIERSON,6,6,10,0,2,12,4,8,12,0,0,0,1,7,0,2,2,0,0,0,1,3,4
20200522,22MAY2020:00:00:00,UFU GUTIERREZ,23,17,38,2,0,40,38,2,38,2,5,8,2,15,6,2,2,0,0,2,18,18,38
20200522,22MAY2020:00:00:00,UFU MUÑIZ,31,45,56,18,2,76,50,26,50,26,11,6,8,18,11,11,5,6,0,9,14,27,50
20200522,22MAY2020:00:00:00,UFU PENNA,13,19,27,0,5,32,22,10,28,4,0,4,6,13,5,2,2,0,0,4,7,11,22
20200522,22MAY2020:00:00:00,UFU PIROVANO,9,8,14,2,1,17,17,0,17,0,1,4,2,4,2,4,0,0,0,8,3,6,17
20200522,22MAY2020:00:00:00,UFU PIÑERO,73,52,107,2,16,125,51,74,67,58,10,15,28,37,15,12,4,4,0,4,8,39,51
20200522,22MAY2020:00:00:00,UFU RAMOS MEJIA,20,28,30,18,0,48,44,4,44,4,0,2,13,15,12,6,0,0,0,0,0,44,44
20200522,22MAY2020:00:00:00,UFU RIVADAVIA,16,26,28,1,13,42,42,0,42,0,0,0,4,17,12,8,1,0,0,7,15,20,42
20200522,22MAY2020:00:00:00,UFU SANTOJANNI,11,12,10,13,0,23,13,10,17,6,0,0,9,5,4,3,0,2,0,2,6,5,13
20200522,22MAY2020:00:00:00,UFU TORNU,10,3,11,0,2,13,11,2,11,2,0,0,2,4,4,1,2,0,0,3,3,5,11
20200522,22MAY2020:00:00:00,UFU VELEZ SARSFIELD,3,3,1,5,0,6,6,0,6,0,0,0,0,5,1,0,0,0,0,0,4,2,6
20200522,22MAY2020:00:00:00,UFU ZUBIZARRETA,8,6,12,2,0,14,14,0,14,0,2,2,0,6,2,2,0,0,0,2,4,8,14
20200523,23MAY2020:00:00:00,UFU ALVAREZ,12,5,13,2,2,17,15,2,15,2,0,0,5,5,3,3,1,0,0,4,6,5,15
20200523,23MAY2020:00:00:00,UFU ARGERICH,6,8,10,4,0,14,6,8,8,6,0,0,4,3,3,4,0,0,0,0,0,6,6
20200523,23MAY2020:00:00:00,UFU BORDA-MOYANO,8,4,4,8,0,12,12,0,12,0,0,0,2,2,2,6,0,0,0,0,6,6,12
20200523,23MAY2020:00:00:00,UFU DURAND,7,5,7,4,1,12,8,4,10,2,0,0,0,4,2,4,0,2,0,1,4,3,8
20200523,23MAY2020:00:00:00,UFU ELIZALDE,0,7,2,5,0,7,7,0,7,0,5,2,0,0,0,0,0,0,0,0,3,4,7
20200523,23MAY2020:00:00:00,UFU FERNANDEZ,8,8,14,0,2,16,8,8,16,0,0,4,2,4,3,1,2,0,0,0,3,5,8
20200523,23MAY2020:00:00:00,UFU FERRER,4,6,7,1,2,10,10,0,10,0,0,2,0,4,0,2,2,0,0,1,5,4,10
20200523,23MAY2020:00:00:00,UFU GRIERSON,4,0,4,0,0,4,0,4,4,0,0,0,0,2,0,0,2,0,0,0,0,0,0
20200523,23MAY2020:00:00:00,UFU GUTIERREZ,6,0,4,2,0,6,6,0,6,0,2,0,0,4,0,0,0,0,0,0,3,3,6
20200523,23MAY2020:00:00:00,UFU MUÑIZ,13,7,20,0,0,20,18,2,18,2,0,2,5,2,9,0,2,0,0,6,4,8,18
20200523,23MAY2020:00:00:00,UFU PENNA,8,11,13,6,0,19,13,6,19,0,0,0,5,5,6,0,3,0,0,3,3,7,13
20200523,23MAY2020:00:00:00,UFU PIROVANO,10,8,10,2,6,18,8,10,10,8,0,2,6,2,8,0,0,0,0,2,2,4,8
20200523,23MAY2020:00:00:00,UFU PIÑERO,44,29,71,0,2,73,47,26,63,10,0,9,29,20,9,2,4,0,0,12,14,21,47
20200523,23MAY2020:00:00:00,UFU RAMOS MEJIA,4,18,20,2,0,22,22,0,22,0,0,0,3,7,8,2,2,0,0,0,0,22,22
20200523,23MAY2020:00:00:00,UFU RIVADAVIA,12,16,22,4,2,28,28,0,28,0,0,0,0,13,8,4,3,0,0,6,10,12,28
20200523,23MAY2020:00:00:00,UFU SANTOJANNI,4,2,4,2,0,6,6,0,6,0,0,0,0,4,2,0,0,0,0,0,3,3,6
20200523,23MAY2020:00:00:00,UFU TORNU,8,24,14,8,10,32,28,4,28,4,2,6,10,6,4,4,0,0,0,1,8,19,28
20200524,24MAY2020:00:00:00,UFU ALVAREZ,17,11,24,2,2,28,26,2,26,2,2,0,6,14,2,4,0,0,0,8,7,11,26
20200524,24MAY2020:00:00:00,UFU ARGERICH,4,16,12,8,0,20,18,2,18,2,0,2,0,4,8,6,0,0,0,0,0,18,18
20200524,24MAY2020:00:00:00,UFU BORDA-MOYANO,0,1,1,0,0,1,1,0,1,0,0,1,0,0,0,0,0,0,0,0,1,0,1
20200524,24MAY2020:00:00:00,UFU DURAND,2,2,4,0,0,4,2,2,4,0,0,0,0,2,2,0,0,0,0,0,1,1,2
20200524,24MAY2020:00:00:00,UFU ELIZALDE,43,25,27,41,0,68,63,5,65,3,12,5,2,24,13,9,3,0,0,3,37,23,63
20200524,24MAY2020:00:00:00,UFU FERNANDEZ,13,6,17,2,0,19,15,4,17,2,0,0,8,7,3,0,1,0,0,6,3,6,15
20200524,24MAY2020:00:00:00,UFU FERRER,3,2,5,0,0,5,5,0,5,0,0,0,0,0,1,4,0,0,0,0,2,3,5
20200524,24MAY2020:00:00:00,UFU GRIERSON,12,9,21,0,0,21,1,20,11,10,0,7,6,0,6,2,0,0,0,1,0,0,1
20200524,24MAY2020:00:00:00,UFU GUTIERREZ,12,2,10,2,2,14,12,2,12,2,2,0,1,10,1,0,0,0,0,2,5,5,12
20200524,24MAY2020:00:00:00,UFU MUÑIZ,12,23,27,8,0,35,9,26,9,26,3,6,9,5,2,2,8,0,0,2,3,4,9
20200524,24MAY2020:00:00:00,UFU PENNA,23,10,31,2,0,33,15,18,33,0,0,0,4,4,8,9,6,2,0,3,6,6,15
20200524,24MAY2020:00:00:00,UFU PIROVANO,6,12,14,4,0,18,4,14,12,6,2,1,1,2,4,2,6,0,0,1,1,2,4
20200524,24MAY2020:00:00:00,UFU PIÑERO,24,46,66,0,4,70,48,22,62,8,0,7,19,6,19,15,2,2,0,0,1,47,48
20200524,24MAY2020:00:00:00,UFU RAMOS MEJIA,20,22,36,6,0,42,36,6,38,4,0,4,10,12,8,2,6,0,0,0,0,36,36
20200524,24MAY2020:00:00:00,UFU RIVADAVIA,21,16,28,5,4,37,27,10,27,10,0,0,4,7,7,11,6,2,0,8,8,11,27
20200524,24MAY2020:00:00:00,UFU SANTOJANNI,4,4,1,7,0,8,4,4,6,2,2,0,1,1,2,0,2,0,0,0,3,1,4
20200524,24MAY2020:00:00:00,UFU TORNU,3,2,5,0,0,5,5,0,5,0,0,0,0,0,3,0,2,0,0,1,2,2,5
20200525,25MAY2020:00:00:00,UFU ALVAREZ,24,15,37,2,0,39,31,8,31,8,5,3,4,10,10,5,2,0,0,9,10,12,31
20200525,25MAY2020:00:00:00,UFU ARGERICH,4,2,6,0,0,6,4,2,4,2,0,0,2,2,0,0,0,2,0,0,0,4,4
20200525,25MAY2020:00:00:00,UFU BORDA-MOYANO,2,6,8,0,0,8,0,8,8,0,0,0,0,6,2,0,0,0,0,0,0,0,0
20200525,25MAY2020:00:00:00,UFU DURAND,16,5,13,2,6,21,11,10,13,8,0,0,12,3,3,2,0,1,0,3,3,5,11
20200525,25MAY2020:00:00:00,UFU ELIZALDE,5,2,5,2,0,7,3,4,5,2,4,1,0,2,0,0,0,0,0,1,0,2,3
20200525,25MAY2020:00:00:00,UFU FERNANDEZ,21,22,39,2,2,43,25,18,43,0,0,2,15,13,10,3,0,0,0,7,5,12,25
20200525,25MAY2020:00:00:00,UFU FERRER,25,27,30,18,4,52,32,20,32,20,2,0,14,17,11,6,2,0,0,3,8,21,32
20200525,25MAY2020:00:00:00,UFU GRIERSON,0,2,0,0,2,2,0,2,0,2,0,0,0,0,1,1,0,0,0,0,0,0,0
20200525,25MAY2020:00:00:00,UFU GUTIERREZ,25,2,15,8,4,27,23,4,23,4,6,1,5,13,2,0,0,0,0,0,12,11,23
20200525,25MAY2020:00:00:00,UFU MUÑIZ,13,21,30,4,0,34,34,0,34,0,4,2,2,8,7,6,2,3,0,8,11,15,34
20200525,25MAY2020:00:00:00,UFU PENNA,22,17,30,9,0,39,31,8,33,6,0,0,11,10,7,5,4,2,0,10,9,12,31
20200525,25MAY2020:00:00:00,UFU PIROVANO,10,9,19,0,0,19,15,4,15,4,0,0,4,0,4,5,2,4,0,5,3,7,15
20200525,25MAY2020:00:00:00,UFU PIÑERO,63,41,98,2,4,104,46,58,74,30,8,6,32,22,21,9,6,0,0,13,8,24,46
20200525,25MAY2020:00:00:00,UFU RAMOS MEJIA,30,14,36,6,2,44,22,22,34,10,0,2,19,11,8,2,2,0,0,0,0,22,22
20200525,25MAY2020:00:00:00,UFU RIVADAVIA,33,25,50,4,4,58,50,8,50,8,0,2,7,22,12,13,2,0,0,10,17,23,50
20200525,25MAY2020:00:00:00,UFU SANTOJANNI,13,7,16,4,0,20,10,10,10,10,1,2,3,7,3,4,0,0,0,6,0,4,10
20200525,25MAY2020:00:00:00,UFU TORNU,0,4,4,0,0,4,2,2,2,2,0,0,2,2,0,0,0,0,0,0,1,1,2
20200526,26MAY2020:00:00:00,UFU ALVAREZ,30,22,50,2,0,52,46,6,48,4,8,4,12,9,12,5,2,0,0,10,15,21,46
20200526,26MAY2020:00:00:00,UFU ARGERICH,42,35,67,10,0,77,55,22,61,16,7,2,16,20,7,19,4,2,0,6,1,48,55
20200526,26MAY2020:00:00:00,UFU BORDA-MOYANO,15,14,10,19,0,29,29,0,29,0,0,0,0,9,8,7,5,0,0,0,16,13,29
20200526,26MAY2020:00:00:00,UFU DURAND,31,15,29,13,4,46,34,12,36,10,0,6,9,7,12,9,3,0,0,5,15,14,34
20200526,26MAY2020:00:00:00,UFU ELIZALDE,10,10,14,6,0,20,14,6,20,0,15,4,1,0,0,0,0,0,0,3,5,6,14
20200526,26MAY2020:00:00:00,UFU FERNANDEZ,17,7,24,0,0,24,20,4,24,0,0,0,6,8,6,0,0,4,0,6,3,11,20
20200526,26MAY2020:00:00:00,UFU FERRER,28,24,44,8,0,52,28,24,32,20,0,1,10,14,15,7,3,2,0,9,7,12,28
20200526,26MAY2020:00:00:00,UFU GRIERSON,6,6,12,0,0,12,2,10,12,0,0,0,6,2,0,3,1,0,0,0,1,1,2
20200526,26MAY2020:00:00:00,UFU GUTIERREZ,14,19,27,6,0,33,17,16,19,14,5,2,4,20,2,0,0,0,0,1,10,6,17
20200526,26MAY2020:00:00:00,UFU MUÑIZ,19,14,23,6,4,33,27,6,27,6,4,2,2,5,8,4,8,0,0,4,5,18,27
20200526,26MAY2020:00:00:00,UFU PENNA,16,18,28,2,4,34,18,16,26,8,0,0,8,7,6,10,3,0,0,10,2,6,18
20200526,26MAY2020:00:00:00,UFU PIROVANO,14,12,17,8,1,26,26,0,26,0,0,2,5,3,8,3,2,3,0,5,11,10,26
20200526,26MAY2020:00:00:00,UFU PIÑERO,58,37,78,5,12,95,63,32,67,28,8,11,25,19,17,10,3,2,0,24,15,24,63
20200526,26MAY2020:00:00:00,UFU RAMOS MEJIA,46,40,74,12,0,86,76,10,80,6,0,0,17,23,20,18,8,0,0,0,0,76,76
20200526,26MAY2020:00:00:00,UFU RIVADAVIA,43,41,51,9,24,84,74,10,74,10,0,0,18,23,20,17,5,1,0,15,19,40,74
20200526,26MAY2020:00:00:00,UFU SANTOJANNI,12,8,16,4,0,20,12,8,16,4,0,4,0,7,0,3,6,0,0,4,2,6,12
20200526,26MAY2020:00:00:00,UFU TORNU,12,14,20,6,0,26,24,2,26,0,0,2,10,3,2,5,4,0,0,9,9,6,24
20200526,26MAY2020:00:00:00,UFU VELEZ SARSFIELD,4,1,3,2,0,5,5,0,5,0,0,0,0,2,0,3,0,0,0,0,3,2,5
20200526,26MAY2020:00:00:00,UFU ZUBIZARRETA,0,2,0,2,0,2,2,0,2,0,0,0,2,0,0,0,0,0,0,0,0,2,2
20200527,27MAY2020:00:00:00,UFU ALVAREZ,19,14,29,2,2,33,29,4,31,2,0,8,4,10,4,2,5,0,0,12,5,12,29
20200527,27MAY2020:00:00:00,UFU ARGERICH,24,29,39,14,0,53,41,12,45,8,2,2,15,17,7,4,3,3,0,3,2,36,41
20200527,27MAY2020:00:00:00,UFU BORDA-MOYANO,13,2,9,4,2,15,13,2,13,2,0,0,0,2,5,4,2,2,0,0,7,6,13
20200527,27MAY2020:00:00:00,UFU DURAND,15,17,31,1,0,32,26,6,28,4,2,0,11,10,6,3,0,0,0,9,7,10,26
20200527,27MAY2020:00:00:00,UFU ELIZALDE,11,6,12,5,0,17,13,4,17,0,7,7,0,2,1,0,0,0,0,0,8,5,13
20200527,27MAY2020:00:00:00,UFU FERNANDEZ,10,13,18,5,0,23,23,0,23,0,0,0,6,3,2,8,2,2,0,5,5,13,23
20200527,27MAY2020:00:00:00,UFU FERRER,22,14,19,17,0,36,16,20,16,20,0,0,3,15,4,14,0,0,0,2,5,9,16
20200527,27MAY2020:00:00:00,UFU GRIERSON,4,11,15,0,0,15,13,2,15,0,0,0,10,4,1,0,0,0,0,5,2,6,13
20200527,27MAY2020:00:00:00,UFU GUTIERREZ,22,2,21,3,0,24,18,6,20,4,8,0,6,6,4,0,0,0,0,0,12,6,18
20200527,27MAY2020:00:00:00,UFU MUÑIZ,24,22,25,19,2,46,46,0,46,0,0,0,4,16,10,10,6,0,0,7,16,23,46
20200527,27MAY2020:00:00:00,UFU PENNA,25,7,21,2,9,32,28,4,30,2,0,0,3,10,11,2,4,2,0,2,16,10,28
20200527,27MAY2020:00:00:00,UFU PIROVANO,5,13,10,6,2,18,14,4,14,4,0,0,2,2,2,6,4,2,0,2,5,7,14
20200527,27MAY2020:00:00:00,UFU PIÑERO,63,43,92,0,14,106,90,16,94,12,15,8,31,24,16,7,3,2,0,33,17,40,90
20200527,27MAY2020:00:00:00,UFU RAMOS MEJIA,42,14,48,8,0,56,46,10,48,8,2,2,8,28,4,10,2,0,0,0,0,46,46
20200527,27MAY2020:00:00:00,UFU RIVADAVIA,21,26,33,11,3,47,39,8,39,8,0,0,11,13,8,13,2,0,0,7,10,22,39
20200527,27MAY2020:00:00:00,UFU SANTOJANNI,4,11,12,3,0,15,11,4,13,2,1,0,4,1,6,0,3,0,0,3,5,3,11
20200527,27MAY2020:00:00:00,UFU TORNU,25,9,30,2,2,34,22,12,30,4,0,4,14,8,0,4,2,2,0,6,6,10,22
20200527,27MAY2020:00:00:00,UFU VELEZ SARSFIELD,14,2,12,2,2,16,6,10,6,10,0,0,2,6,2,0,1,5,0,0,3,3,6
20200527,27MAY2020:00:00:00,UFU ZUBIZARRETA,5,4,7,2,0,9,5,4,7,2,0,0,1,6,0,0,2,0,0,1,1,3,5
20200528,28MAY2020:00:00:00,UFU ALVAREZ,28,8,36,0,0,36,36,0,36,0,7,9,1,7,8,0,2,2,0,16,6,14,36
20200528,28MAY2020:00:00:00,UFU ARGERICH,50,35,69,14,2,85,51,34,57,28,12,8,14,9,23,14,5,0,0,1,0,50,51
20200528,28MAY2020:00:00:00,UFU BORDA-MOYANO,8,5,7,6,0,13,13,0,13,0,0,0,2,2,7,0,2,0,0,1,5,7,13
20200528,28MAY2020:00:00:00,UFU DURAND,14,7,16,3,2,21,17,4,19,2,0,2,2,9,5,2,1,0,0,3,6,8,17
20200528,28MAY2020:00:00:00,UFU ELIZALDE,12,19,14,17,0,31,31,0,31,0,13,2,2,4,1,6,3,0,0,1,18,12,31
20200528,28MAY2020:00:00:00,UFU FERNANDEZ,7,22,28,1,0,29,27,2,29,0,0,0,6,10,6,3,4,0,0,9,4,14,27
20200528,28MAY2020:00:00:00,UFU FERRER,24,22,15,29,2,46,22,24,22,24,0,0,7,14,15,6,4,0,0,1,8,13,22
20200528,28MAY2020:00:00:00,UFU GRIERSON,9,6,14,1,0,15,5,10,15,0,1,1,2,5,4,2,0,0,0,2,1,2,5
20200528,28MAY2020:00:00:00,UFU GUTIERREZ,37,7,42,2,0,44,32,12,34,10,7,2,2,18,11,4,0,0,0,0,19,13,32
20200528,28MAY2020:00:00:00,UFU MUÑIZ,18,22,26,12,2,40,34,6,34,6,0,8,16,6,6,4,0,0,0,6,11,17,34
20200528,28MAY2020:00:00:00,UFU PENNA,7,18,19,4,2,25,15,10,21,4,0,0,2,12,6,3,2,0,0,5,3,7,15
20200528,28MAY2020:00:00:00,UFU PIROVANO,14,16,26,4,0,30,30,0,30,0,0,2,3,10,3,9,0,3,0,2,14,14,30
20200528,28MAY2020:00:00:00,UFU PIÑERO,60,81,114,6,21,141,91,50,93,48,15,20,29,41,13,11,6,6,0,26,25,40,91
20200528,28MAY2020:00:00:00,UFU RAMOS MEJIA,38,34,52,14,6,72,50,22,50,22,0,2,18,24,12,6,8,2,0,0,0,50,50
20200528,28MAY2020:00:00:00,UFU RIVADAVIA,21,31,39,1,12,52,52,0,52,0,1,0,13,16,14,6,2,0,0,11,19,22,52
20200528,28MAY2020:00:00:00,UFU SANTOJANNI,16,14,16,12,2,30,24,6,28,2,0,0,8,16,2,0,4,0,0,7,8,9,24
20200528,28MAY2020:00:00:00,UFU TORNU,20,11,29,2,0,31,27,4,27,4,0,1,8,13,2,5,2,0,0,10,7,10,27
20200528,28MAY2020:00:00:00,UFU VELEZ SARSFIELD,10,6,12,4,0,16,14,2,14,2,0,0,4,5,7,0,0,0,0,1,5,8,14
20200528,28MAY2020:00:00:00,UFU ZUBIZARRETA,3,4,3,4,0,7,5,2,5,2,0,2,1,2,2,0,0,0,0,0,3,2,5
20200529,29MAY2020:00:00:00,UFU ALVAREZ,31,18,35,2,12,49,41,8,43,6,8,0,17,12,8,3,1,0,0,15,9,17,41
20200529,29MAY2020:00:00:00,UFU ARGERICH,46,28,58,14,2,74,58,16,60,14,8,0,16,27,5,14,4,0,0,0,1,57,58
20200529,29MAY2020:00:00:00,UFU BORDA-MOYANO,21,32,22,29,2,53,49,4,49,4,0,2,2,15,11,11,7,5,0,0,31,18,49
20200529,29MAY2020:00:00:00,UFU DURAND,24,14,37,0,1,38,30,8,36,2,5,2,13,4,4,5,2,3,0,12,8,10,30
20200529,29MAY2020:00:00:00,UFU ELIZALDE,10,9,13,4,2,19,17,2,17,2,16,0,0,3,0,0,0,0,0,3,7,7,17
20200529,29MAY2020:00:00:00,UFU FERNANDEZ,17,13,23,7,0,30,28,2,30,0,0,2,6,11,8,2,1,0,0,8,6,14,28
20200529,29MAY2020:00:00:00,UFU FERRER,15,9,13,9,2,24,12,12,12,12,0,0,8,7,2,5,2,0,0,5,3,4,12
20200529,29MAY2020:00:00:00,UFU GRIERSON,13,5,16,2,0,18,4,14,18,0,0,2,6,4,4,0,2,0,0,2,0,2,4
20200529,29MAY2020:00:00:00,UFU GUTIERREZ,20,8,17,11,0,28,26,2,26,2,6,1,6,8,3,4,0,0,0,2,14,10,26
20200529,29MAY2020:00:00:00,UFU MUÑIZ,55,45,76,22,2,100,74,26,80,20,7,15,22,30,6,15,2,3,0,25,14,35,74
20200529,29MAY2020:00:00:00,UFU PENNA,24,17,31,8,2,41,21,20,33,8,0,0,6,9,15,6,5,0,0,3,8,10,21
20200529,29MAY2020:00:00:00,UFU PIROVANO,2,12,11,3,0,14,12,2,12,2,2,0,2,4,4,2,0,0,0,2,4,6,12
20200529,29MAY2020:00:00:00,UFU PIÑERO,52,60,92,6,14,112,66,46,100,12,6,9,29,27,20,10,8,3,0,14,23,29,66
20200529,29MAY2020:00:00:00,UFU RAMOS MEJIA,16,22,32,4,2,38,36,2,36,2,0,4,10,12,8,2,2,0,0,0,0,36,36
20200529,29MAY2020:00:00:00,UFU RIVADAVIA,17,25,27,9,6,42,36,6,36,6,0,0,10,12,7,11,2,0,0,10,12,14,36
20200529,29MAY2020:00:00:00,UFU SANTOJANNI,22,14,21,15,0,36,30,6,34,2,0,0,6,9,6,14,1,0,0,3,23,4,30
20200529,29MAY2020:00:00:00,UFU TORNU,21,12,29,0,4,33,29,4,29,4,0,2,11,7,9,4,0,0,0,7,6,16,29
20200529,29MAY2020:00:00:00,UFU VELEZ SARSFIELD,25,15,23,17,0,40,32,8,32,8,0,0,2,21,7,8,2,0,0,1,14,17,32
20200529,29MAY2020:00:00:00,UFU ZUBIZARRETA,11,13,10,14,0,24,22,2,22,2,0,0,2,10,6,4,2,0,0,1,14,7,22
20200530,30MAY2020:00:00:00,UFU ALVAREZ,22,25,45,2,0,47,41,6,41,6,2,5,6,16,6,6,6,0,0,15,5,21,41
20200530,30MAY2020:00:00:00,UFU ARGERICH,20,10,30,0,0,30,20,10,26,4,0,2,14,4,6,0,0,4,0,0,0,20,20
20200530,30MAY2020:00:00:00,UFU BORDA-MOYANO,0,1,1,0,0,1,1,0,1,0,0,0,1,0,0,0,0,0,0,0,1,0,1
20200530,30MAY2020:00:00:00,UFU DURAND,2,7,5,2,2,9,7,2,7,2,0,0,2,1,6,0,0,0,0,1,3,3,7
20200530,30MAY2020:00:00:00,UFU ELIZALDE,2,4,4,2,0,6,6,0,6,0,6,0,0,0,0,0,0,0,0,2,1,3,6
20200530,30MAY2020:00:00:00,UFU FERNANDEZ,6,10,14,0,2,16,14,2,16,0,0,2,1,8,4,1,0,0,0,5,1,8,14
20200530,30MAY2020:00:00:00,UFU FERRER,2,4,0,4,2,6,2,4,2,4,0,0,4,2,0,0,0,0,0,0,0,2,2
20200530,30MAY2020:00:00:00,UFU GRIERSON,10,2,12,0,0,12,0,12,12,0,0,0,8,2,0,0,2,0,0,0,0,0,0
20200530,30MAY2020:00:00:00,UFU GUTIERREZ,8,1,6,3,0,9,9,0,9,0,3,0,2,2,0,2,0,0,0,2,4,3,9
20200530,30MAY2020:00:00:00,UFU MUÑIZ,26,26,33,17,2,52,48,4,48,4,0,1,14,21,7,7,2,0,0,5,23,20,48
20200530,30MAY2020:00:00:00,UFU PENNA,13,25,33,3,2,38,30,8,34,4,0,1,13,13,9,2,0,0,0,9,7,14,30
20200530,30MAY2020:00:00:00,UFU PIROVANO,12,0,8,4,0,12,12,0,12,0,4,0,8,0,0,0,0,0,0,1,3,8,12
20200530,30MAY2020:00:00:00,UFU PIÑERO,57,67,97,17,10,124,80,44,88,36,8,15,38,32,14,11,6,0,0,21,24,35,80
20200530,30MAY2020:00:00:00,UFU RAMOS MEJIA,20,8,24,4,0,28,28,0,28,0,0,0,16,6,4,2,0,0,0,0,0,28,28
20200530,30MAY2020:00:00:00,UFU RIVADAVIA,16,23,37,2,0,39,35,4,37,2,0,0,10,14,4,7,2,2,0,2,19,14,35
20200530,30MAY2020:00:00:00,UFU SANTOJANNI,16,11,19,7,1,27,21,6,25,2,0,0,3,3,7,7,7,0,0,5,15,1,21
20200530,30MAY2020:00:00:00,UFU TORNU,15,15,22,2,6,30,22,8,22,8,4,4,5,15,1,1,0,0,0,1,6,15,22
20200531,31MAY2020:00:00:00,UFU ALVAREZ,14,9,23,0,0,23,9,14,9,14,2,0,6,5,8,0,0,2,0,2,4,3,9
20200531,31MAY2020:00:00:00,UFU ARGERICH,4,18,20,2,0,22,8,14,22,0,0,0,2,2,2,10,6,0,0,0,0,8,8
20200531,31MAY2020:00:00:00,UFU BORDA-MOYANO,43,11,23,27,4,54,52,2,52,2,0,0,3,15,18,5,6,7,0,0,32,20,52
20200531,31MAY2020:00:00:00,UFU DURAND,12,9,14,2,5,21,11,10,19,2,2,0,6,4,7,2,0,0,0,4,3,4,11
20200531,31MAY2020:00:00:00,UFU ELIZALDE,0,6,2,4,0,6,2,4,6,0,6,0,0,0,0,0,0,0,0,0,1,1,2
20200531,31MAY2020:00:00:00,UFU FERNANDEZ,7,7,12,2,0,14,12,2,12,2,0,0,2,6,2,2,2,0,0,3,4,5,12
20200531,31MAY2020:00:00:00,UFU FERRER,3,6,4,4,1,9,5,4,7,2,0,0,0,4,3,2,0,0,0,1,2,2,5
20200531,31MAY2020:00:00:00,UFU GRIERSON,6,10,16,0,0,16,0,16,0,16,0,0,8,4,2,0,0,2,0,0,0,0,0
20200531,31MAY2020:00:00:00,UFU GUTIERREZ,22,5,22,5,0,27,25,2,25,2,6,1,5,4,3,3,5,0,0,0,15,10,25
20200531,31MAY2020:00:00:00,UFU MUÑIZ,39,37,56,18,2,76,32,44,32,44,6,5,10,20,18,11,6,0,0,2,18,12,32
20200531,31MAY2020:00:00:00,UFU PENNA,9,7,12,4,0,16,14,2,16,0,0,0,1,5,4,6,0,0,0,5,4,5,14
20200531,31MAY2020:00:00:00,UFU PIROVANO,6,9,15,0,0,15,13,2,15,0,0,0,4,0,4,0,4,3,0,3,1,9,13
20200531,31MAY2020:00:00:00,UFU PIÑERO,51,35,66,16,4,86,56,30,58,28,4,20,19,19,6,13,5,0,0,17,14,25,56
20200531,31MAY2020:00:00:00,UFU RAMOS MEJIA,18,10,26,2,0,28,22,6,26,2,0,1,7,8,6,2,4,0,0,1,4,17,22
20200531,31MAY2020:00:00:00,UFU RIVADAVIA,10,9,16,2,1,19,19,0,19,0,0,0,5,5,2,5,2,0,0,6,4,9,19
20200531,31MAY2020:00:00:00,UFU SANTOJANNI,6,1,3,4,0,7,3,4,5,2,0,0,0,3,4,0,0,0,0,0,3,0,3
20200531,31MAY2020:00:00:00,UFU TORNU,8,3,8,1,2,11,11,0,11,0,0,0,3,0,6,2,0,0,0,2,5,4,11
20200531,31MAY2020:00:00:00,UFU VELEZ SARSFIELD,4,20,24,0,0,24,2,22,2,22,0,0,5,9,6,4,0,0,0,1,0,1,2
20200601,01JUN2020:00:00:00,UFU ALVAREZ,34,33,56,8,3,67,59,8,61,6,13,2,22,10,11,3,2,4,0,8,25,26,59
20200601,01JUN2020:00:00:00,UFU ARGERICH,55,32,73,10,4,87,35,52,63,24,4,2,27,16,14,14,10,0,0,2,1,32,35
20200601,01JUN2020:00:00:00,UFU BORDA-MOYANO,11,33,37,7,0,44,40,4,40,4,0,0,4,5,8,12,2,13,0,0,24,16,40
20200601,01JUN2020:00:00:00,UFU DURAND,29,15,42,2,0,44,42,2,42,2,7,2,7,14,8,5,1,0,0,13,12,17,42
20200601,01JUN2020:00:00:00,UFU ELIZALDE,18,27,24,21,0,45,39,6,43,2,17,10,2,10,2,0,4,0,0,0,13,26,39
20200601,01JUN2020:00:00:00,UFU FERNANDEZ,15,13,23,1,4,28,26,2,28,0,0,3,6,12,2,5,0,0,0,6,10,10,26
20200601,01JUN2020:00:00:00,UFU FERRER,23,14,18,17,2,37,25,12,25,12,0,3,5,14,15,0,0,0,0,1,2,22,25
20200601,01JUN2020:00:00:00,UFU GRIERSON,3,5,7,1,0,8,6,2,8,0,0,0,4,4,0,0,0,0,0,4,0,2,6
20200601,01JUN2020:00:00:00,UFU GUTIERREZ,18,7,17,8,0,25,23,2,23,2,11,0,4,9,1,0,0,0,0,0,14,9,23
20200601,01JUN2020:00:00:00,UFU MUÑIZ,40,33,50,21,2,73,69,4,69,4,2,7,13,21,13,6,10,1,0,24,13,32,69
20200601,01JUN2020:00:00:00,UFU PENNA,13,16,23,4,2,29,19,10,29,0,0,1,3,3,6,7,7,2,0,5,7,7,19
20200601,01JUN2020:00:00:00,UFU PIROVANO,10,14,16,6,2,24,18,6,18,6,0,0,11,8,3,2,0,0,0,4,8,6,18
20200601,01JUN2020:00:00:00,UFU PIÑERO,64,59,104,14,5,123,75,48,75,48,10,8,29,42,19,11,4,0,0,22,24,29,75
20200601,01JUN2020:00:00:00,UFU RAMOS MEJIA,30,16,40,6,0,46,40,6,40,6,0,0,18,16,8,4,0,0,0,1,1,38,40
20200601,01JUN2020:00:00:00,UFU RIVADAVIA,7,19,8,6,12,26,26,0,26,0,0,0,5,6,10,3,0,2,0,10,5,11,26
20200601,01JUN2020:00:00:00,UFU SANTOJANNI,11,9,19,1,0,20,8,12,12,8,4,2,4,7,2,1,0,0,0,4,3,1,8
20200601,01JUN2020:00:00:00,UFU TORNU,10,7,10,5,2,17,13,4,15,2,0,2,3,8,2,2,0,0,0,3,5,5,13
20200601,01JUN2020:00:00:00,UFU VELEZ SARSFIELD,4,4,4,4,0,8,4,4,4,4,0,0,0,4,2,2,0,0,0,0,2,2,4
20200601,01JUN2020:00:00:00,UFU ZUBIZARRETA,2,2,4,0,0,4,4,0,4,0,0,0,0,4,0,0,0,0,0,0,0,4,4
20200602,02JUN2020:00:00:00,UFU ALVAREZ,26,38,53,4,7,64,50,14,50,14,6,10,19,17,6,4,2,0,0,16,14,20,50
20200602,02JUN2020:00:00:00,UFU ARGERICH,53,23,59,17,0,76,50,26,50,26,8,6,16,17,5,9,9,6,0,13,10,27,50
20200602,02JUN2020:00:00:00,UFU BORDA-MOYANO,31,27,35,21,2,58,52,6,52,6,0,2,10,9,9,11,15,2,0,1,28,23,52
20200602,02JUN2020:00:00:00,UFU DURAND,25,25,44,4,2,50,44,6,46,4,4,15,7,12,6,4,1,1,0,15,11,18,44
20200602,02JUN2020:00:00:00,UFU ELIZALDE,18,12,10,18,2,30,28,2,30,0,9,5,2,7,4,3,0,0,0,1,10,17,28
20200602,02JUN2020:00:00:00,UFU FERNANDEZ,16,6,18,4,0,22,18,4,20,2,0,0,4,8,6,2,2,0,0,2,6,10,18
20200602,02JUN2020:00:00:00,UFU FERRER,24,11,10,25,0,35,23,12,23,12,0,0,8,12,5,6,2,2,0,1,7,15,23
20200602,02JUN2020:00:00:00,UFU GRIERSON,10,8,18,0,0,18,2,16,18,0,0,0,11,2,3,2,0,0,0,1,0,1,2
20200602,02JUN2020:00:00:00,UFU GUTIERREZ,9,6,11,4,0,15,15,0,15,0,6,2,2,1,2,2,0,0,0,1,6,8,15
20200602,02JUN2020:00:00:00,UFU MUÑIZ,19,38,35,20,2,57,51,6,51,6,0,0,7,17,7,18,7,1,0,10,19,22,51
20200602,02JUN2020:00:00:00,UFU PENNA,10,13,19,0,4,23,15,8,23,0,0,0,10,4,4,5,0,0,0,4,4,7,15
20200602,02JUN2020:00:00:00,UFU PIROVANO,30,12,29,13,0,42,42,0,42,0,4,8,4,7,12,6,0,1,0,4,22,16,42
20200602,02JUN2020:00:00:00,UFU PIÑERO,85,48,119,7,7,133,119,14,127,6,19,14,21,30,17,16,10,6,0,30,37,52,119
20200602,02JUN2020:00:00:00,UFU RAMOS MEJIA,30,27,52,3,2,57,49,8,55,2,0,4,20,15,4,6,6,2,0,10,10,29,49
20200602,02JUN2020:00:00:00,UFU RIVADAVIA,18,27,21,4,20,45,45,0,45,0,0,0,5,17,10,8,5,0,0,7,12,26,45
20200602,02JUN2020:00:00:00,UFU SANTOJANNI,1,6,2,4,1,7,5,2,7,0,0,0,2,3,0,0,2,0,0,0,3,2,5
20200602,02JUN2020:00:00:00,UFU TORNU,11,16,22,3,2,27,25,2,25,2,0,4,3,12,3,0,3,2,0,4,7,14,25
20200602,02JUN2020:00:00:00,UFU VELEZ SARSFIELD,6,6,5,7,0,12,8,4,8,4,0,0,2,6,0,2,2,0,0,1,2,5,8
20200603,03JUN2020:00:00:00,UFU ALVAREZ,23,23,36,5,5,46,38,8,40,6,3,3,3,15,17,2,3,0,0,11,12,15,38
20200603,03JUN2020:00:00:00,UFU ARGERICH,44,42,80,4,2,86,50,36,60,26,8,8,12,21,15,16,4,2,0,12,11,27,50
20200603,03JUN2020:00:00:00,UFU BORDA-MOYANO,9,14,8,15,0,23,19,4,21,2,0,0,5,9,7,2,0,0,0,6,5,8,19
20200603,03JUN2020:00:00:00,UFU DURAND,8,21,17,10,2,29,21,8,29,0,0,0,3,13,6,5,2,0,0,6,5,10,21
20200603,03JUN2020:00:00:00,UFU ELIZALDE,19,9,4,24,0,28,24,4,26,2,8,4,0,11,2,0,3,0,0,1,12,11,24
20200603,03JUN2020:00:00:00,UFU FERNANDEZ,8,11,19,0,0,19,17,2,19,0,0,0,6,6,3,4,0,0,0,1,8,8,17
20200603,03JUN2020:00:00:00,UFU FERRER,18,14,11,21,0,32,18,14,18,14,0,0,9,10,6,7,0,0,0,3,6,9,18
20200603,03JUN2020:00:00:00,UFU GRIERSON,8,7,13,2,0,15,9,6,15,0,0,0,8,2,2,2,0,1,0,2,4,3,9
20200603,03JUN2020:00:00:00,UFU GUTIERREZ,10,1,7,4,0,11,11,0,11,0,2,1,0,4,1,3,0,0,0,0,7,4,11
20200603,03JUN2020:00:00:00,UFU MUÑIZ,36,37,43,28,2,73,43,30,45,28,3,7,19,21,7,5,9,2,0,6,12,25,43
20200603,03JUN2020:00:00:00,UFU PENNA,11,10,19,0,2,21,17,4,17,4,0,0,4,7,5,4,1,0,0,8,1,8,17
20200603,03JUN2020:00:00:00,UFU PIROVANO,5,11,16,0,0,16,10,6,14,2,0,4,3,6,3,0,0,0,0,5,3,2,10
20200603,03JUN2020:00:00:00,UFU PIÑERO,76,54,113,10,7,130,112,18,114,16,7,10,48,24,18,14,8,1,0,17,50,44,112
20200603,03JUN2020:00:00:00,UFU RAMOS MEJIA,33,35,45,23,0,68,40,28,46,22,0,0,22,16,10,12,6,2,0,6,15,19,40
20200603,03JUN2020:00:00:00,UFU RIVADAVIA,22,12,25,6,3,34,22,12,22,12,0,0,13,9,5,3,0,4,0,5,8,9,22
20200603,03JUN2020:00:00:00,UFU SANTOJANNI,17,14,18,13,0,31,25,6,27,4,0,0,8,6,9,7,1,0,0,7,14,4,25
20200603,03JUN2020:00:00:00,UFU TORNU,11,12,17,0,6,23,19,4,19,4,2,0,6,4,3,3,3,2,0,4,5,10,19
20200603,03JUN2020:00:00:00,UFU VELEZ SARSFIELD,8,13,18,3,0,21,5,16,5,16,0,1,7,3,6,2,2,0,0,1,3,1,5
20200603,03JUN2020:00:00:00,UFU ZUBIZARRETA,0,2,2,0,0,2,2,0,2,0,0,0,2,0,0,0,0,0,0,0,1,1,2
20200604,04JUN2020:00:00:00,UFU ALVAREZ,37,33,61,2,7,70,68,2,68,2,5,18,6,14,12,6,6,3,0,20,15,33,68
20200604,04JUN2020:00:00:00,UFU ARGERICH,43,40,64,15,4,83,57,26,57,26,9,10,14,11,12,17,8,2,0,5,5,47,57
20200604,04JUN2020:00:00:00,UFU BORDA-MOYANO,4,47,41,10,0,51,47,4,47,4,0,0,3,11,15,9,7,6,0,3,21,22,47
20200604,04JUN2020:00:00:00,UFU DURAND,30,40,58,12,0,70,64,6,68,2,0,4,13,16,11,20,6,0,0,9,28,27,64
20200604,04JUN2020:00:00:00,UFU ELIZALDE,19,23,26,15,1,42,34,8,38,4,23,6,2,6,5,0,0,0,0,2,18,14,34
20200604,04JUN2020:00:00:00,UFU FERNANDEZ,6,7,11,2,0,13,9,4,13,0,0,0,2,5,4,2,0,0,0,0,3,6,9
20200604,04JUN2020:00:00:00,UFU FERRER,13,15,15,13,0,28,20,8,20,8,0,0,7,7,7,7,0,0,0,2,9,9,20
20200604,04JUN2020:00:00:00,UFU GRIERSON,8,6,14,0,0,14,0,14,12,2,0,0,6,4,2,2,0,0,0,0,0,0,0
20200604,04JUN2020:00:00:00,UFU GUTIERREZ,23,6,28,1,0,29,25,4,29,0,5,6,2,5,8,0,3,0,0,1,12,12,25
20200604,04JUN2020:00:00:00,UFU MUÑIZ,19,25,26,16,2,44,26,18,26,18,0,0,14,8,10,7,2,3,0,11,7,8,26
20200604,04JUN2020:00:00:00,UFU PENNA,21,14,28,2,5,35,23,12,31,4,0,2,17,10,3,2,1,0,0,10,5,8,23
20200604,04JUN2020:00:00:00,UFU PIROVANO,28,14,30,12,0,42,38,4,38,4,0,0,9,13,9,6,3,2,0,3,18,17,38
20200604,04JUN2020:00:00:00,UFU PIÑERO,66,66,120,10,2,132,106,26,130,2,17,12,24,35,14,15,8,7,0,23,36,46,106
20200604,04JUN2020:00:00:00,UFU RAMOS MEJIA,22,17,27,8,4,39,25,14,25,14,0,0,12,18,2,5,2,0,0,7,7,11,25
20200604,04JUN2020:00:00:00,UFU RIVADAVIA,23,13,20,8,8,36,36,0,36,0,0,0,7,9,10,6,4,0,0,4,14,18,36
20200604,04JUN2020:00:00:00,UFU SANTOJANNI,13,12,24,1,0,25,9,16,13,12,9,5,5,1,3,2,0,0,0,5,4,0,9
20200604,04JUN2020:00:00:00,UFU TORNU,20,21,38,3,0,41,37,4,39,2,5,6,12,9,3,2,4,0,0,7,11,19,37
20200604,04JUN2020:00:00:00,UFU VELEZ SARSFIELD,15,14,18,9,2,29,17,12,19,10,0,0,7,14,5,3,0,0,0,6,1,10,17
20200604,04JUN2020:00:00:00,UFU ZUBIZARRETA,10,4,10,4,0,14,8,6,10,4,4,0,4,2,3,1,0,0,0,1,2,5,8
20200605,05JUN2020:00:00:00,UFU ALVAREZ,28,31,46,4,9,59,53,6,53,6,4,8,5,17,17,6,2,0,0,16,8,29,53
20200605,05JUN2020:00:00:00,UFU ARGERICH,60,46,90,14,2,106,56,50,58,48,12,5,22,26,15,13,9,4,0,17,14,25,56
20200605,05JUN2020:00:00:00,UFU BORDA-MOYANO,6,35,38,1,2,41,41,0,41,0,0,1,0,0,4,6,26,4,0,2,22,17,41
20200605,05JUN2020:00:00:00,UFU DURAND,20,25,34,11,0,45,41,4,45,0,2,0,10,13,16,2,2,0,0,7,14,20,41
20200605,05JUN2020:00:00:00,UFU ELIZALDE,24,8,23,9,0,32,22,10,28,4,14,9,2,7,0,0,0,0,0,2,10,10,22
20200605,05JUN2020:00:00:00,UFU FERNANDEZ,11,16,23,2,2,27,23,4,27,0,0,2,6,3,7,3,4,2,0,8,4,11,23
20200605,05JUN2020:00:00:00,UFU FERRER,19,20,24,15,0,39,29,10,29,10,2,2,6,12,12,4,1,0,0,3,12,14,29
20200605,05JUN2020:00:00:00,UFU GRIERSON,3,8,11,0,0,11,5,6,11,0,2,0,7,0,2,0,0,0,0,2,0,3,5
20200605,05JUN2020:00:00:00,UFU GUTIERREZ,24,14,32,6,0,38,30,8,32,6,11,8,5,7,1,6,0,0,0,5,12,13,30
20200605,05JUN2020:00:00:00,UFU MUÑIZ,29,41,40,28,2,70,62,8,62,8,4,4,16,15,17,10,2,2,0,16,12,34,62
20200605,05JUN2020:00:00:00,UFU PENNA,18,19,33,0,4,37,25,12,29,8,0,0,8,13,12,4,0,0,0,10,3,12,25
20200605,05JUN2020:00:00:00,UFU PIROVANO,5,11,6,10,0,16,16,0,16,0,0,0,7,2,3,4,0,0,0,1,8,7,16
20200605,05JUN2020:00:00:00,UFU PIÑERO,87,58,127,10,8,145,93,52,141,4,11,19,27,50,23,11,4,0,0,20,29,44,93
20200605,05JUN2020:00:00:00,UFU RAMOS MEJIA,21,26,39,4,4,47,39,8,43,4,0,0,19,15,4,6,3,0,0,5,6,28,39
20200605,05JUN2020:00:00:00,UFU RIVADAVIA,22,13,11,13,11,35,35,0,35,0,0,0,4,14,11,4,0,2,0,3,10,21,35
20200605,05JUN2020:00:00:00,UFU SANTOJANNI,7,8,11,2,2,15,11,4,11,4,1,0,6,3,1,0,3,1,0,5,6,0,11
20200605,05JUN2020:00:00:00,UFU TORNU,30,17,44,2,1,47,41,6,41,6,2,0,10,9,7,11,8,0,0,15,9,17,41
20200605,05JUN2020:00:00:00,UFU VELEZ SARSFIELD,4,5,4,4,1,9,7,2,7,2,0,0,2,0,3,4,0,0,0,4,0,3,7
20200605,05JUN2020:00:00:00,UFU ZUBIZARRETA,1,4,5,0,0,5,5,0,5,0,2,0,0,3,0,0,0,0,0,2,0,3,5
20200606,06JUN2020:00:00:00,UFU ALVAREZ,15,16,28,1,2,31,25,6,25,6,7,0,3,6,6,3,6,0,0,9,4,12,25
20200606,06JUN2020:00:00:00,UFU ARGERICH,13,7,15,5,0,20,14,6,16,4,0,0,5,3,4,4,4,0,0,5,4,5,14
20200606,06JUN2020:00:00:00,UFU BORDA-MOYANO,2,3,5,0,0,5,5,0,5,0,0,0,0,1,4,0,0,0,0,1,2,2,5
20200606,06JUN2020:00:00:00,UFU DURAND,23,11,27,2,5,34,34,0,34,0,0,0,10,10,5,6,2,1,0,7,14,13,34
20200606,06JUN2020:00:00:00,UFU ELIZALDE,8,12,17,2,1,20,18,2,18,2,12,8,0,0,0,0,0,0,0,5,4,9,18
20200606,06JUN2020:00:00:00,UFU FERNANDEZ,13,12,19,6,0,25,9,16,25,0,0,0,5,4,8,2,6,0,0,3,2,4,9
20200606,06JUN2020:00:00:00,UFU FERRER,10,3,9,4,0,13,9,4,9,4,0,0,3,4,2,0,4,0,0,4,1,4,9
20200606,06JUN2020:00:00:00,UFU GRIERSON,14,12,22,4,0,26,0,26,24,2,0,5,15,2,3,1,0,0,0,0,0,0,0
20200606,06JUN2020:00:00:00,UFU GUTIERREZ,14,7,14,7,0,21,11,10,11,10,3,5,2,2,7,2,0,0,0,0,6,5,11
20200606,06JUN2020:00:00:00,UFU MUÑIZ,30,47,31,46,0,77,69,8,69,8,2,0,10,19,27,14,2,3,0,5,34,30,69
20200606,06JUN2020:00:00:00,UFU PENNA,16,22,30,6,2,38,30,8,34,4,4,0,4,12,10,4,2,2,0,9,6,15,30
20200606,06JUN2020:00:00:00,UFU PIROVANO,12,14,19,7,0,26,26,0,26,0,0,0,5,10,8,3,0,0,0,4,8,14,26
20200606,06JUN2020:00:00:00,UFU PIÑERO,30,23,53,0,0,53,45,8,45,8,10,10,7,10,9,3,2,2,0,10,15,20,45
20200606,06JUN2020:00:00:00,UFU RAMOS MEJIA,17,19,31,5,0,36,34,2,34,2,0,0,9,8,9,8,2,0,0,10,11,13,34
20200606,06JUN2020:00:00:00,UFU RIVADAVIA,14,12,22,4,0,26,26,0,26,0,0,0,14,5,3,4,0,0,0,0,14,12,26
20200606,06JUN2020:00:00:00,UFU SANTOJANNI,11,14,19,6,0,25,17,8,23,2,3,2,4,5,9,1,0,1,0,9,6,2,17
20200606,06JUN2020:00:00:00,UFU TORNU,26,22,30,0,18,48,44,4,44,4,6,7,15,6,9,2,3,0,0,6,16,20,44
20200606,06JUN2020:00:00:00,UFU VELEZ SARSFIELD,10,17,24,3,0,27,11,16,13,14,0,0,10,4,3,6,4,0,0,3,2,6,11
20200607,07JUN2020:00:00:00,UFU ALVAREZ,22,24,45,1,0,46,40,6,40,6,12,4,9,4,7,2,4,4,0,16,4,20,40
20200607,07JUN2020:00:00:00,UFU ARGERICH,16,20,31,3,2,36,28,8,30,6,0,0,4,5,8,15,4,0,0,1,15,12,28
20200607,07JUN2020:00:00:00,UFU BORDA-MOYANO,61,3,64,0,0,64,62,2,62,2,0,0,1,5,8,14,21,15,0,3,35,24,62
20200607,07JUN2020:00:00:00,UFU DURAND,27,17,37,2,5,44,38,6,42,2,4,0,9,17,5,5,4,0,0,12,12,14,38
20200607,07JUN2020:00:00:00,UFU ELIZALDE,7,6,4,9,0,13,9,4,13,0,10,3,0,0,0,0,0,0,0,0,4,5,9
20200607,07JUN2020:00:00:00,UFU FERNANDEZ,14,0,14,0,0,14,12,2,14,0,0,1,2,7,3,1,0,0,0,3,5,4,12
20200607,07JUN2020:00:00:00,UFU FERRER,21,20,33,6,2,41,7,34,7,34,2,4,10,13,6,2,4,0,0,1,3,3,7
20200607,07JUN2020:00:00:00,UFU GRIERSON,10,4,12,2,0,14,0,14,2,12,0,4,4,2,0,2,2,0,0,0,0,0,0
20200607,07JUN2020:00:00:00,UFU GUTIERREZ,11,7,14,4,0,18,18,0,18,0,5,5,0,4,2,2,0,0,0,2,8,8,18
20200607,07JUN2020:00:00:00,UFU MUÑIZ,27,24,32,19,0,51,45,6,45,6,2,0,12,18,13,2,2,2,0,6,19,20,45
20200607,07JUN2020:00:00:00,UFU PENNA,19,22,39,2,0,41,33,8,37,4,0,0,14,9,10,4,4,0,0,12,6,15,33
20200607,07JUN2020:00:00:00,UFU PIROVANO,8,2,6,4,0,10,6,4,10,0,1,3,0,4,0,2,0,0,0,1,3,2,6
20200607,07JUN2020:00:00:00,UFU PIÑERO,6,6,12,0,0,12,8,4,8,4,0,0,0,6,4,2,0,0,0,2,2,4,8
20200607,07JUN2020:00:00:00,UFU RAMOS MEJIA,26,22,42,6,0,48,42,6,46,2,0,0,21,3,15,5,4,0,0,15,8,19,42
20200607,07JUN2020:00:00:00,UFU RIVADAVIA,5,0,1,4,0,5,3,2,3,2,0,0,1,0,3,0,1,0,0,2,1,0,3
20200607,07JUN2020:00:00:00,UFU SANTOJANNI,7,11,13,5,0,18,12,6,18,0,0,1,3,10,3,0,1,0,0,8,4,0,12
20200607,07JUN2020:00:00:00,UFU TORNU,13,15,17,0,11,28,26,2,26,2,2,2,6,6,8,4,0,0,0,3,9,14,26
20200607,07JUN2020:00:00:00,UFU VELEZ SARSFIELD,12,15,26,1,0,27,5,22,13,14,4,0,4,9,0,6,2,2,0,2,1,2,5
20200608,08JUN2020:00:00:00,UFU ALVAREZ,31,34,46,8,11,65,45,20,49,16,4,9,12,18,19,3,0,0,0,7,3,35,45
20200608,08JUN2020:00:00:00,UFU ARGERICH,60,40,69,20,11,100,60,40,68,32,8,6,26,28,12,10,6,4,0,21,13,26,60
20200608,08JUN2020:00:00:00,UFU BORDA-MOYANO,25,43,24,33,11,68,66,2,66,2,0,0,7,28,17,10,4,2,0,4,38,24,66
20200608,08JUN2020:00:00:00,UFU DURAND,24,49,55,16,2,73,59,14,71,2,6,4,10,19,18,10,6,0,0,5,25,29,59
20200608,08JUN2020:00:00:00,UFU ELIZALDE,6,6,6,6,0,12,6,6,8,4,9,0,0,2,1,0,0,0,0,0,4,2,6
20200608,08JUN2020:00:00:00,UFU FERNANDEZ,10,7,13,4,0,17,1,16,17,0,0,0,4,4,4,4,1,0,0,1,0,0,1
20200608,08JUN2020:00:00:00,UFU FERRER,17,14,18,13,0,31,23,8,23,8,0,0,9,8,4,8,1,1,0,3,8,12,23
20200608,08JUN2020:00:00:00,UFU GRIERSON,8,5,13,0,0,13,11,2,13,0,0,0,3,5,3,2,0,0,0,3,4,4,11
20200626,26JUN2020:00:00:00,UFU TORNU,50,21,55,14,2,71,53,18,63,8,1,6,10,10,27,5,10,2,0,1,0,52,53
20200626,26JUN2020:00:00:00,UFU VELEZ SARSFIELD,10,17,18,8,1,27,15,12,19,8,0,0,5,6,7,7,2,0,0,6,9,0,15
20200626,26JUN2020:00:00:00,UFU ZUBIZARRETA,27,14,31,10,0,41,11,30,11,30,3,3,6,12,3,5,9,0,0,1,2,8,11
20200627,27JUN2020:00:00:00,UFU ALVAREZ,17,16,25,4,4,33,27,6,29,4,4,1,11,8,4,4,1,0,0,18,7,2,27
20200627,27JUN2020:00:00:00,UFU ARGERICH,16,13,21,8,0,29,7,22,7,22,0,0,5,13,4,3,4,0,0,2,1,4,7
20200627,27JUN2020:00:00:00,UFU BORDA-MOYANO,15,11,17,9,0,26,14,12,14,12,0,0,2,5,7,8,3,1,0,3,9,2,14
20200627,27JUN2020:00:00:00,UFU DURAND,33,28,54,4,3,61,53,8,55,6,0,3,21,11,10,8,4,4,0,28,16,9,53
20200627,27JUN2020:00:00:00,UFU ELIZALDE,7,8,6,8,1,15,15,0,15,0,8,7,0,0,0,0,0,0,0,3,7,5,15
20200627,27JUN2020:00:00:00,UFU FERNANDEZ,16,18,26,8,0,34,32,2,32,2,0,1,9,8,8,5,2,1,0,15,8,9,32
20200627,27JUN2020:00:00:00,UFU FERRER,20,25,21,20,4,45,25,20,27,18,0,0,6,22,11,3,2,1,0,6,9,10,25
20200627,27JUN2020:00:00:00,UFU GRIERSON,2,3,3,2,0,5,5,0,5,0,0,0,4,0,1,0,0,0,0,3,1,1,5
20200627,27JUN2020:00:00:00,UFU GUTIERREZ,25,6,21,10,0,31,9,22,25,6,2,3,1,3,17,3,2,0,0,1,8,0,9
20200627,27JUN2020:00:00:00,UFU MUÑIZ,37,40,58,19,0,77,65,12,77,0,7,9,8,26,20,1,4,2,0,16,22,27,65
20200627,27JUN2020:00:00:00,UFU PENNA,20,11,22,7,2,31,21,10,23,8,2,3,5,7,6,6,2,0,0,7,10,4,21
20200627,27JUN2020:00:00:00,UFU PIROVANO,11,5,10,3,3,16,12,4,14,2,0,0,2,4,1,7,1,1,0,5,4,3,12
20200627,27JUN2020:00:00:00,UFU PIÑERO,38,29,59,8,0,67,21,46,21,46,7,7,17,13,10,11,0,2,0,11,8,2,21
20200627,27JUN2020:00:00:00,UFU RAMOS MEJIA,35,23,52,4,2,58,52,6,54,4,0,2,13,10,15,7,10,1,0,16,26,10,52
20200627,27JUN2020:00:00:00,UFU RIVADAVIA,22,15,26,11,0,37,23,14,23,14,0,3,7,11,10,5,1,0,0,5,12,5,23
20200627,27JUN2020:00:00:00,UFU SANTOJANNI,17,24,22,17,2,41,25,16,37,4,2,3,9,9,9,7,2,0,0,12,12,1,25
20200627,27JUN2020:00:00:00,UFU TORNU,21,16,21,5,11,37,27,10,33,4,0,2,4,15,9,4,1,2,0,6,12,8,27
20200627,27JUN2020:00:00:00,UFU VELEZ SARSFIELD,12,15,20,7,0,27,15,12,19,8,0,0,5,7,6,7,2,0,0,6,3,6,15
20200627,27JUN2020:00:00:00,UFU ZUBIZARRETA,23,8,16,14,1,31,13,18,17,14,0,0,2,15,8,2,4,0,0,2,8,3,13
20200628,28JUN2020:00:00:00,UFU ALVAREZ,8,8,9,6,1,16,10,6,10,6,1,0,5,3,7,0,0,0,0,6,3,1,10
20200628,28JUN2020:00:00:00,UFU ARGERICH,8,12,19,1,0,20,6,14,8,12,0,0,3,6,3,4,2,2,0,4,2,0,6
20200628,28JUN2020:00:00:00,UFU DURAND,29,30,32,16,11,59,57,2,57,2,0,0,12,26,13,4,4,0,0,18,24,15,57
20200628,28JUN2020:00:00:00,UFU ELIZALDE,10,12,9,13,0,22,18,4,20,2,15,5,0,2,0,0,0,0,0,2,2,14,18
20200628,28JUN2020:00:00:00,UFU FERNANDEZ,7,17,21,3,0,24,20,4,20,4,0,0,4,10,4,3,2,1,0,10,4,5,20
20200628,28JUN2020:00:00:00,UFU FERRER,10,19,17,8,4,29,9,20,9,20,0,0,7,10,5,5,2,0,0,6,2,1,9
20200628,28JUN2020:00:00:00,UFU GRIERSON,9,5,7,4,3,14,8,6,10,4,1,1,5,2,4,0,1,0,0,5,3,0,8
20200628,28JUN2020:00:00:00,UFU GUTIERREZ,23,4,12,11,4,27,21,6,23,4,6,4,4,9,1,3,0,0,0,3,12,6,21
20200628,28JUN2020:00:00:00,UFU MUÑIZ,15,29,31,12,1,44,30,14,42,2,0,0,7,15,9,3,10,0,0,4,17,9,30
20200628,28JUN2020:00:00:00,UFU PENNA,13,11,16,6,2,24,16,8,18,6,0,0,4,8,6,5,0,1,0,9,5,2,16
20200628,28JUN2020:00:00:00,UFU PIROVANO,8,6,13,1,0,14,10,4,14,0,4,0,7,1,1,1,0,0,0,4,3,3,10
20200628,28JUN2020:00:00:00,UFU PIÑERO,26,36,54,8,0,62,36,26,46,16,1,6,10,24,13,4,2,2,0,19,14,3,36
20200628,28JUN2020:00:00:00,UFU RAMOS MEJIA,26,14,40,0,0,40,26,14,28,12,0,1,10,7,6,6,6,4,0,14,9,3,26
20200628,28JUN2020:00:00:00,UFU RIVADAVIA,22,14,31,3,2,36,14,22,14,22,0,1,1,19,7,6,2,0,0,1,10,2,14
20200628,28JUN2020:00:00:00,UFU SANTOJANNI,21,16,25,12,0,37,27,10,35,2,5,0,10,9,5,8,0,0,0,15,12,0,27
20200628,28JUN2020:00:00:00,UFU TORNU,18,17,21,6,8,35,27,8,29,6,2,1,5,11,7,9,0,0,0,11,7,9,27
20200628,28JUN2020:00:00:00,UFU VELEZ SARSFIELD,9,14,16,7,0,23,9,14,9,14,0,0,8,10,2,2,1,0,0,6,2,1,9
20200628,28JUN2020:00:00:00,UFU ZUBIZARRETA,7,10,11,5,1,17,11,6,15,2,1,1,8,4,2,1,0,0,0,6,4,1,11
20200629,29JUN2020:00:00:00,UFU ALVAREZ,31,22,47,6,0,53,37,16,43,10,3,5,9,14,12,6,2,2,0,17,9,11,37
20200629,29JUN2020:00:00:00,UFU ARGERICH,37,49,68,11,7,86,49,37,51,35,0,8,17,26,15,9,8,3,0,13,18,18,49
20200629,29JUN2020:00:00:00,UFU BORDA-MOYANO,21,27,28,18,2,48,44,4,44,4,0,0,5,7,10,13,8,5,0,6,31,7,44
20200629,29JUN2020:00:00:00,UFU DURAND,30,28,48,10,0,58,54,4,54,4,0,4,15,19,8,9,3,0,0,15,21,18,54
20200629,29JUN2020:00:00:00,UFU ELIZALDE,20,27,24,23,0,47,13,34,19,28,35,12,0,0,0,0,0,0,0,7,3,3,13
20200629,29JUN2020:00:00:00,UFU FERNANDEZ,10,7,11,6,0,17,17,0,17,0,0,0,4,4,3,5,1,0,0,7,8,2,17
20200629,29JUN2020:00:00:00,UFU FERRER,28,22,30,20,0,50,38,12,38,12,0,0,12,10,16,7,5,0,0,12,12,14,38
20200629,29JUN2020:00:00:00,UFU GRIERSON,7,14,12,6,3,21,17,4,17,4,0,1,9,10,0,1,0,0,0,9,5,3,17
20200629,29JUN2020:00:00:00,UFU GUTIERREZ,31,20,30,21,0,51,47,4,49,2,10,8,6,11,9,4,3,0,0,3,34,9,47
20200629,29JUN2020:00:00:00,UFU MUÑIZ,55,72,71,47,9,127,87,40,93,34,0,5,23,41,28,15,13,2,0,26,42,19,87
20200629,29JUN2020:00:00:00,UFU PENNA,14,17,28,1,2,31,23,8,27,4,0,0,10,8,3,7,3,0,0,9,7,7,23
20200629,29JUN2020:00:00:00,UFU PIROVANO,11,7,15,3,0,18,14,4,14,4,0,0,4,4,4,4,0,2,0,4,9,1,14
20200629,29JUN2020:00:00:00,UFU PIÑERO,75,58,103,23,7,133,39,94,47,86,7,13,28,32,28,12,5,8,0,17,14,8,39
20200629,29JUN2020:00:00:00,UFU RAMOS MEJIA,25,41,52,11,3,66,58,8,58,8,0,0,25,20,13,4,4,0,0,17,21,20,58
20200629,29JUN2020:00:00:00,UFU RIVADAVIA,18,17,25,7,3,35,25,10,25,10,0,0,8,12,11,1,3,0,0,5,15,5,25
20200629,29JUN2020:00:00:00,UFU SANTOJANNI,26,18,31,10,3,44,38,6,42,2,2,1,17,8,8,4,4,0,0,24,11,3,38
20200629,29JUN2020:00:00:00,UFU TORNU,31,11,29,13,0,42,32,10,36,6,1,0,6,15,10,7,2,1,0,6,15,10,32
20200629,29JUN2020:00:00:00,UFU VELEZ SARSFIELD,30,21,35,16,0,51,7,44,47,4,0,1,6,23,9,11,1,0,0,3,4,0,7
20200629,29JUN2020:00:00:00,UFU ZUBIZARRETA,15,11,15,10,1,26,16,10,18,8,1,3,2,7,7,4,2,0,0,3,8,5,16
20200630,30JUN2020:00:00:00,UFU ALVAREZ,18,13,27,4,0,31,31,0,31,0,1,4,9,6,6,4,1,0,0,24,7,0,31
20200630,30JUN2020:00:00:00,UFU ARGERICH,22,30,36,6,10,52,38,14,42,10,3,1,12,14,5,7,10,0,0,11,9,18,38
20200630,30JUN2020:00:00:00,UFU BORDA-MOYANO,54,27,64,11,6,81,47,34,47,34,0,0,11,8,14,18,10,20,0,0,35,12,47
20200630,30JUN2020:00:00:00,UFU DURAND,35,37,59,12,1,72,66,6,66,6,6,4,11,17,14,12,8,0,0,25,27,14,66
20200630,30JUN2020:00:00:00,UFU ELIZALDE,22,24,30,14,2,46,0,46,26,20,22,17,1,2,4,0,0,0,0,0,0,0,0
20200630,30JUN2020:00:00:00,UFU FERNANDEZ,21,13,26,8,0,34,34,0,34,0,0,1,4,15,9,2,3,0,0,10,10,9,34
20200630,30JUN2020:00:00:00,UFU FERRER,13,21,14,19,1,34,14,20,14,20,0,0,12,15,4,2,1,0,0,6,4,4,14
20200630,30JUN2020:00:00:00,UFU GRIERSON,3,10,10,2,1,13,11,2,11,2,0,0,0,5,6,1,1,0,0,6,4,1,11
20200630,30JUN2020:00:00:00,UFU GUTIERREZ,21,11,22,10,0,32,32,0,32,0,3,5,0,9,6,3,6,0,0,1,26,4,32
20200630,30JUN2020:00:00:00,UFU MUÑIZ,36,33,49,20,0,69,43,26,45,24,2,7,13,10,15,14,7,1,0,8,27,8,43
20200630,30JUN2020:00:00:00,UFU PENNA,9,7,14,2,0,16,2,14,12,4,0,0,6,1,4,2,1,2,0,1,1,0,2
20200630,30JUN2020:00:00:00,UFU PIROVANO,14,8,13,9,0,22,22,0,22,0,0,0,5,5,6,6,0,0,0,5,11,4,22
20200630,30JUN2020:00:00:00,UFU PIÑERO,37,21,45,9,4,58,22,36,22,36,2,3,14,13,22,2,0,2,0,10,6,6,22
20200630,30JUN2020:00:00:00,UFU RAMOS MEJIA,32,49,64,13,4,81,59,22,61,20,0,3,23,16,17,15,5,2,0,20,24,15,59
20200630,30JUN2020:00:00:00,UFU RIVADAVIA,17,22,18,16,5,39,23,16,23,16,0,0,13,10,8,6,2,0,0,4,12,4,23
20200630,30JUN2020:00:00:00,UFU SANTOJANNI,27,12,25,13,1,39,25,14,33,6,3,0,8,12,4,6,5,1,0,12,12,1,25
20200630,30JUN2020:00:00:00,UFU TORNU,25,19,34,10,0,44,38,6,42,2,1,0,5,17,7,10,4,0,0,12,18,8,38
20200630,30JUN2020:00:00:00,UFU VELEZ SARSFIELD,21,12,25,7,1,33,21,12,25,8,0,0,6,2,12,4,7,2,0,10,7,4,21
20200630,30JUN2020:00:00:00,UFU ZUBIZARRETA,13,6,7,8,4,19,3,16,5,14,0,0,2,3,4,5,5,0,0,3,0,0,3
20200701,01JUL2020:00:00:00,UFU ALVAREZ,24,21,32,11,2,45,35,10,41,4,7,2,13,7,6,7,3,0,0,18,13,4,35
20200701,01JUL2020:00:00:00,UFU ARGERICH,26,33,45,8,6,59,53,6,55,4,2,2,14,22,8,1,7,3,0,13,19,21,53
20200701,01JUL2020:00:00:00,UFU BORDA-MOYANO,38,3,36,5,0,41,41,0,41,0,0,1,0,2,1,7,7,23,0,0,27,14,41
20200701,01JUL2020:00:00:00,UFU DURAND,25,11,29,7,0,36,34,2,34,2,2,0,6,9,10,3,4,2,0,14,15,5,34
20200701,01JUL2020:00:00:00,UFU ELIZALDE,8,16,16,8,0,24,0,24,16,8,8,14,0,2,0,0,0,0,0,0,0,0,0
20200701,01JUL2020:00:00:00,UFU FERNANDEZ,16,16,24,8,0,32,28,4,30,2,0,3,7,12,7,2,1,0,0,8,8,9,28
20200701,01JUL2020:00:00:00,UFU FERRER,27,29,34,20,2,56,30,26,30,26,0,0,14,10,21,8,3,0,0,4,12,14,30
20200701,01JUL2020:00:00:00,UFU GRIERSON,13,13,23,2,1,26,16,10,16,10,0,1,16,2,4,1,2,0,0,8,6,2,16
20200701,01JUL2020:00:00:00,UFU GUTIERREZ,16,17,21,8,4,33,29,4,29,4,8,5,2,10,3,3,2,0,0,1,21,7,29
20200701,01JUL2020:00:00:00,UFU MUÑIZ,44,41,55,29,1,85,51,34,57,28,0,2,23,17,23,13,3,4,0,13,34,4,51
20200701,01JUL2020:00:00:00,UFU PENNA,11,9,15,1,4,20,16,4,18,2,0,0,2,7,2,3,4,2,0,10,3,3,16
20200701,01JUL2020:00:00:00,UFU PIROVANO,11,3,11,3,0,14,14,0,14,0,1,0,4,6,2,1,0,0,0,8,5,1,14
20200701,01JUL2020:00:00:00,UFU PIÑERO,50,62,90,18,4,112,48,64,50,62,9,5,31,28,14,16,8,1,0,15,26,7,48
20200701,01JUL2020:00:00:00,UFU RAMOS MEJIA,28,21,47,2,0,49,47,2,47,2,0,0,14,16,7,5,4,3,0,20,11,16,47
20200701,01JUL2020:00:00:00,UFU RIVADAVIA,14,18,14,8,10,32,10,22,10,22,0,0,7,5,12,4,4,0,0,3,7,0,10
20200701,01JUL2020:00:00:00,UFU SANTOJANNI,30,18,28,15,5,48,42,6,46,2,1,2,7,12,9,9,7,1,0,20,22,0,42
20200701,01JUL2020:00:00:00,UFU TORNU,21,27,43,5,0,48,40,8,42,6,2,0,8,14,8,11,5,0,0,15,16,9,40
20200701,01JUL2020:00:00:00,UFU VELEZ SARSFIELD,15,18,23,8,2,33,19,14,29,4,0,0,6,9,10,4,3,1,0,11,8,0,19
20200701,01JUL2020:00:00:00,UFU ZUBIZARRETA,22,9,17,12,2,31,11,20,17,14,0,0,8,13,4,4,2,0,0,1,7,3,11
20200702,02JUL2020:00:00:00,UFU ALVAREZ,25,26,35,13,3,51,35,16,37,14,1,2,8,16,12,7,5,0,0,15,15,5,35
20200702,02JUL2020:00:00:00,UFU ARGERICH,52,38,79,11,0,90,54,36,54,36,4,8,17,16,16,14,10,5,0,14,15,25,54
20200702,02JUL2020:00:00:00,UFU BORDA-MOYANO,6,8,12,2,0,14,14,0,14,0,0,1,2,3,3,3,0,2,0,0,11,3,14
20200702,02JUL2020:00:00:00,UFU DURAND,26,37,57,6,0,63,45,18,47,16,3,12,8,10,18,7,4,1,0,24,11,10,45
20200702,02JUL2020:00:00:00,UFU ELIZALDE,12,8,13,6,1,20,10,10,14,6,12,7,0,1,0,0,0,0,0,2,2,6,10
20200702,02JUL2020:00:00:00,UFU FERNANDEZ,16,21,33,4,0,37,35,2,35,2,0,2,10,13,5,5,1,1,0,13,8,12,35
20200702,02JUL2020:00:00:00,UFU FERRER,13,12,19,6,0,25,23,2,23,2,0,0,2,7,5,5,6,0,0,7,5,11,23
20200702,02JUL2020:00:00:00,UFU GRIERSON,10,12,18,4,0,22,20,2,20,2,0,0,7,5,2,5,1,2,0,12,4,4,20
20200702,02JUL2020:00:00:00,UFU GUTIERREZ,11,9,11,9,0,20,18,2,18,2,2,1,4,2,5,6,0,0,0,0,11,6,18
20200702,02JUL2020:00:00:00,UFU MUÑIZ,63,82,80,61,4,145,69,76,73,72,4,3,32,39,37,21,8,1,0,23,33,13,69
20200702,02JUL2020:00:00:00,UFU PENNA,11,12,18,3,2,23,9,14,15,8,0,0,1,7,7,3,3,2,0,5,3,1,9
20200702,02JUL2020:00:00:00,UFU PIROVANO,13,12,15,9,1,25,23,2,23,2,0,0,5,6,8,5,1,0,0,3,16,3,23
20200702,02JUL2020:00:00:00,UFU PIÑERO,36,37,62,9,2,73,59,14,59,14,13,6,9,14,18,8,4,1,0,31,25,3,59
20200702,02JUL2020:00:00:00,UFU RAMOS MEJIA,27,22,43,5,1,49,35,14,35,14,0,0,14,13,12,8,2,0,0,13,12,10,35
20200702,02JUL2020:00:00:00,UFU RIVADAVIA,19,15,22,7,5,34,26,8,26,8,0,0,14,9,6,1,4,0,0,7,13,5,26
20200702,02JUL2020:00:00:00,UFU SANTOJANNI,28,21,32,17,0,49,43,6,45,4,1,2,14,12,10,7,3,0,0,22,17,4,43
20200702,02JUL2020:00:00:00,UFU TORNU,38,25,51,11,1,63,55,8,57,6,3,6,12,19,13,7,3,0,0,13,26,16,55
20200702,02JUL2020:00:00:00,UFU VELEZ SARSFIELD,24,10,22,10,2,34,20,14,26,8,0,0,6,8,9,5,4,2,0,7,10,3,20
20200702,02JUL2020:00:00:00,UFU ZUBIZARRETA,19,16,15,12,8,35,13,22,19,16,0,2,3,5,11,9,5,0,0,2,9,2,13
20200703,03JUL2020:00:00:00,UFU ALVAREZ,16,19,29,3,3,35,29,6,29,6,0,5,9,8,10,1,2,0,0,10,13,6,29
20200703,03JUL2020:00:00:00,UFU ARGERICH,40,29,54,11,4,69,39,30,53,16,5,5,11,14,15,13,2,4,0,24,6,9,39
20200703,03JUL2020:00:00:00,UFU BORDA-MOYANO,8,40,31,9,8,48,36,12,36,12,0,0,4,18,13,8,2,3,0,5,20,11,36
20200703,03JUL2020:00:00:00,UFU DURAND,37,24,42,17,2,61,57,4,59,2,0,5,11,17,11,14,3,0,0,25,23,9,57
20200703,03JUL2020:00:00:00,UFU ELIZALDE,8,16,18,6,0,24,4,20,12,12,8,10,0,0,2,2,2,0,0,2,1,1,4
20200703,03JUL2020:00:00:00,UFU FERNANDEZ,10,11,21,0,0,21,19,2,19,2,0,1,3,8,4,3,0,2,0,6,5,7,19
20200703,03JUL2020:00:00:00,UFU FERRER,20,38,44,13,1,58,40,18,40,18,0,2,15,19,11,9,2,0,0,19,9,12,40
20200703,03JUL2020:00:00:00,UFU GRIERSON,17,9,22,4,0,26,20,6,22,4,0,0,3,6,6,8,2,1,0,13,2,5,20
20200703,03JUL2020:00:00:00,UFU GUTIERREZ,15,5,14,6,0,20,18,2,18,2,2,0,0,6,4,6,2,0,0,2,4,4,18
20200703,03JUL2020:00:00:00,UFU MUÑIZ,46,46,66,24,2,92,56,36,62,30,2,4,20,31,11,13,10,1,0,21,28,7,56
20200703,03JUL2020:00:00:00,UFU PENNA,15,16,28,1,2,31,25,6,27,4,0,1,5,10,6,3,5,1,0,15,5,5,25
20200703,03JUL2020:00:00:00,UFU PIROVANO,10,12,16,6,0,22,18,4,18,4,0,4,3,7,4,4,0,0,0,5,7,6,18
20200703,03JUL2020:00:00:00,UFU PIÑERO,36,75,87,18,6,111,32,79,34,77,7,10,23,30,23,11,3,4,0,14,10,8,32
20200703,03JUL2020:00:00:00,UFU RAMOS MEJIA,45,28,64,7,2,73,69,4,69,4,0,1,18,21,15,10,6,2,0,20,36,13,69
20200703,03JUL2020:00:00:00,UFU RIVADAVIA,16,23,22,12,5,39,13,26,13,26,0,0,5,12,4,10,7,1,0,7,4,2,13
20200703,03JUL2020:00:00:00,UFU SANTOJANNI,31,26,50,5,2,57,19,38,51,6,13,2,11,10,11,9,1,0,0,12,4,3,19
20200703,03JUL2020:00:00:00,UFU TORNU,29,29,46,11,1,58,32,26,32,26,0,0,13,13,21,7,2,2,0,6,17,9,32
20200703,03JUL2020:00:00:00,UFU VELEZ SARSFIELD,17,16,21,12,0,33,11,22,13,20,0,0,8,10,11,1,3,0,0,5,5,1,11
20200703,03JUL2020:00:00:00,UFU ZUBIZARRETA,12,6,8,10,0,18,8,10,8,10,0,0,4,4,7,3,0,0,0,1,5,2,8
20200704,04JUL2020:00:00:00,UFU ALVAREZ,18,15,29,2,2,33,25,8,25,8,4,4,3,12,7,3,0,0,0,13,7,5,25
20200704,04JUL2020:00:00:00,UFU ARGERICH,20,19,26,11,2,39,15,24,15,24,2,4,5,15,5,4,4,0,0,1,2,12,15
20200704,04JUL2020:00:00:00,UFU BORDA-MOYANO,5,9,4,8,2,14,4,10,4,10,0,0,1,3,6,3,1,0,0,2,2,0,4
20200704,04JUL2020:00:00:00,UFU DURAND,21,15,25,9,2,36,34,2,34,2,5,4,3,9,7,5,2,1,0,13,17,4,34
20200704,04JUL2020:00:00:00,UFU ELIZALDE,3,9,3,9,0,12,6,6,10,2,9,3,0,0,0,0,0,0,0,2,2,2,6
20200704,04JUL2020:00:00:00,UFU FERNANDEZ,9,19,18,10,0,28,20,8,20,8,0,0,5,11,3,8,1,0,0,8,8,4,20
20200704,04JUL2020:00:00:00,UFU FERRER,11,20,13,13,5,31,13,18,13,18,0,1,14,5,9,2,0,0,0,4,5,4,13
20200704,04JUL2020:00:00:00,UFU GRIERSON,8,5,6,5,2,13,9,4,9,4,0,0,3,10,0,0,0,0,0,4,3,2,9
20200704,04JUL2020:00:00:00,UFU GUTIERREZ,18,13,20,11,0,31,19,12,19,12,6,3,1,7,8,6,0,0,0,1,14,3,19
20200704,04JUL2020:00:00:00,UFU MUÑIZ,30,30,44,16,0,60,54,6,60,0,3,0,13,18,11,8,6,1,0,16,20,18,54
20200704,04JUL2020:00:00:00,UFU PENNA,21,14,24,11,0,35,33,2,33,2,0,0,4,16,6,8,1,0,0,14,10,9,33
20200704,04JUL2020:00:00:00,UFU PIROVANO,5,3,3,2,3,8,6,2,8,0,2,0,1,1,2,2,0,0,0,1,3,2,6
20200704,04JUL2020:00:00:00,UFU PIÑERO,44,38,70,8,4,82,34,48,34,48,7,9,14,15,24,11,2,0,0,20,12,2,34
20200704,04JUL2020:00:00:00,UFU RAMOS MEJIA,22,24,39,5,2,46,40,6,40,6,0,0,15,11,12,4,2,2,0,15,14,11,40
20200704,04JUL2020:00:00:00,UFU RIVADAVIA,17,23,27,6,7,40,24,16,24,16,0,0,8,11,9,6,6,0,0,11,5,8,24
20200704,04JUL2020:00:00:00,UFU SANTOJANNI,17,20,16,19,2,37,31,6,31,6,5,1,13,9,6,2,1,0,0,14,13,4,31
20200704,04JUL2020:00:00:00,UFU TORNU,24,9,16,6,11,33,25,8,29,4,2,10,1,5,12,3,0,0,0,11,3,10,25
20200704,04JUL2020:00:00:00,UFU VELEZ SARSFIELD,19,13,26,6,0,32,22,10,24,8,0,2,5,7,14,3,1,0,0,14,6,2,22
20200704,04JUL2020:00:00:00,UFU ZUBIZARRETA,16,12,12,14,2,28,14,14,22,6,0,0,6,12,3,2,3,2,0,5,6,3,14
20200705,05JUL2020:00:00:00,UFU ALVAREZ,12,8,18,2,0,20,14,6,14,6,0,2,4,7,5,1,1,0,0,6,6,2,14
20200705,05JUL2020:00:00:00,UFU ARGERICH,12,18,26,4,0,30,18,12,18,12,1,0,6,9,5,3,6,0,0,3,8,7,18
20200705,05JUL2020:00:00:00,UFU BORDA-MOYANO,1,2,2,1,0,3,3,0,3,0,0,0,0,0,0,3,0,0,0,0,3,0,3
20200705,05JUL2020:00:00:00,UFU DURAND,19,9,20,4,4,28,28,0,28,0,1,0,4,7,7,9,0,0,0,6,20,2,28
20200705,05JUL2020:00:00:00,UFU ELIZALDE,6,10,8,8,0,16,6,10,16,0,12,4,0,0,0,0,0,0,0,0,3,3,6
20200705,05JUL2020:00:00:00,UFU FERNANDEZ,11,14,18,7,0,25,25,0,25,0,0,0,4,13,3,2,1,2,0,8,5,11,25
20200705,05JUL2020:00:00:00,UFU FERRER,9,13,11,4,7,22,14,8,14,8,0,0,9,6,5,2,0,0,0,5,5,4,14
20200705,05JUL2020:00:00:00,UFU GRIERSON,3,4,4,2,1,7,7,0,7,0,0,0,2,4,0,1,0,0,0,2,5,0,7
20200705,05JUL2020:00:00:00,UFU GUTIERREZ,8,3,7,4,0,11,11,0,11,0,3,3,0,2,3,0,0,0,0,0,8,2,11
20200705,05JUL2020:00:00:00,UFU MUÑIZ,15,31,29,12,5,46,20,26,22,24,0,3,8,11,7,8,8,1,0,3,13,4,20
20200705,05JUL2020:00:00:00,UFU PENNA,15,11,18,8,0,26,22,4,22,4,0,0,6,9,5,5,1,0,0,13,6,3,22
20200705,05JUL2020:00:00:00,UFU PIROVANO,13,3,11,3,2,16,14,2,14,2,0,0,2,5,1,4,4,0,0,4,4,5,14
20200705,05JUL2020:00:00:00,UFU PIÑERO,44,33,66,8,3,77,51,26,51,26,5,6,16,27,14,6,2,1,0,19,27,5,51
20200705,05JUL2020:00:00:00,UFU RAMOS MEJIA,24,29,45,8,0,53,37,16,37,16,0,0,21,8,7,9,8,0,0,18,13,6,37
20200705,05JUL2020:00:00:00,UFU RIVADAVIA,7,13,12,3,5,20,14,6,14,6,0,0,3,8,6,3,0,0,0,8,3,3,14
20200705,05JUL2020:00:00:00,UFU SANTOJANNI,13,11,19,4,1,24,24,0,24,0,1,6,2,1,5,7,1,1,0,16,8,0,24
20200705,05JUL2020:00:00:00,UFU TORNU,22,12,18,5,11,34,30,4,30,4,0,2,6,10,7,7,2,0,0,17,5,8,30
20200705,05JUL2020:00:00:00,UFU VELEZ SARSFIELD,7,8,12,3,0,15,11,4,13,2,0,0,0,7,5,2,1,0,0,5,6,0,11
20200705,05JUL2020:00:00:00,UFU ZUBIZARRETA,13,5,15,3,0,18,12,6,16,2,0,0,3,9,4,1,0,1,0,5,2,4,12
20200706,06JUL2020:00:00:00,UFU ALVAREZ,33,26,53,3,3,59,45,14,55,4,4,4,9,13,14,5,10,0,0,20,15,10,45
20200706,06JUL2020:00:00:00,UFU ARGERICH,36,49,63,16,6,85,61,24,61,24,5,9,24,18,16,10,1,2,0,32,17,12,61
20200706,06JUL2020:00:00:00,UFU BORDA-MOYANO,9,23,21,9,2,32,24,8,24,8,0,2,12,4,6,7,1,0,0,2,16,6,24
20200706,06JUL2020:00:00:00,UFU DURAND,19,20,30,9,0,39,26,13,26,13,5,2,3,9,14,3,3,0,0,15,10,1,26
20200706,06JUL2020:00:00:00,UFU ELIZALDE,25,21,17,29,0,46,16,30,28,18,14,13,4,7,6,2,0,0,0,4,8,4,16
20200706,06JUL2020:00:00:00,UFU FERNANDEZ,6,24,30,0,0,30,20,10,24,6,0,0,4,7,9,4,6,0,0,9,5,6,20
20200706,06JUL2020:00:00:00,UFU FERRER,15,15,15,15,0,30,26,4,26,4,0,0,8,3,6,12,1,0,0,11,7,8,26
20200706,06JUL2020:00:00:00,UFU GRIERSON,15,6,18,3,0,21,19,2,19,2,1,2,4,5,4,3,2,0,0,13,3,3,19
20200706,06JUL2020:00:00:00,UFU GUTIERREZ,14,10,13,10,1,24,16,8,20,4,7,2,5,8,2,0,0,0,0,2,12,2,16
20200706,06JUL2020:00:00:00,UFU MUÑIZ,71,59,83,40,7,130,70,60,78,52,6,6,27,38,21,17,10,5,0,29,25,16,70
20200706,06JUL2020:00:00:00,UFU PENNA,21,11,25,5,2,32,22,10,26,6,0,0,4,6,8,11,3,0,0,5,15,2,22
20200706,06JUL2020:00:00:00,UFU PIROVANO,17,5,21,1,0,22,22,0,22,0,0,0,7,5,7,2,0,1,0,10,9,3,22
20200706,06JUL2020:00:00:00,UFU PIÑERO,49,48,81,10,6,97,33,64,33,64,7,5,17,31,18,16,3,0,0,11,21,1,33
20200706,06JUL2020:00:00:00,UFU RAMOS MEJIA,36,31,57,5,5,67,55,12,57,10,0,2,20,16,7,18,4,0,0,32,11,12,55
20200706,06JUL2020:00:00:00,UFU RIVADAVIA,25,16,26,10,5,41,29,12,29,12,0,0,5,14,9,8,3,2,0,7,17,5,29
20200706,06JUL2020:00:00:00,UFU SANTOJANNI,23,22,29,16,0,45,35,10,43,2,2,3,8,13,7,7,5,0,0,22,12,1,35
20200706,06JUL2020:00:00:00,UFU TORNU,23,22,36,7,2,45,35,10,35,10,1,1,8,14,14,4,2,1,0,9,20,6,35
20200706,06JUL2020:00:00:00,UFU VELEZ SARSFIELD,23,31,44,10,0,54,26,28,36,18,0,1,9,13,12,9,8,2,0,12,12,2,26
20200706,06JUL2020:00:00:00,UFU ZUBIZARRETA,26,15,25,10,6,41,17,24,21,20,6,0,4,7,6,16,2,0,0,7,6,3,17
20200707,07JUL2020:00:00:00,UFU ALVAREZ,19,18,24,6,7,37,25,12,25,12,3,1,12,8,6,4,1,2,0,9,10,6,25
20200707,07JUL2020:00:00:00,UFU ARGERICH,31,28,43,15,1,59,49,10,53,6,0,2,13,13,19,6,5,1,0,11,21,17,49
20200707,07JUL2020:00:00:00,UFU BORDA-MOYANO,36,12,25,19,4,48,6,42,6,42,0,0,5,7,22,7,4,3,0,0,4,2,6
20200707,07JUL2020:00:00:00,UFU DURAND,18,22,29,11,0,40,30,10,32,8,0,1,9,13,14,2,1,0,0,15,10,5,30
20200707,07JUL2020:00:00:00,UFU ELIZALDE,15,8,15,6,2,23,1,22,15,8,19,0,0,4,0,0,0,0,0,0,1,0,1
20200707,07JUL2020:00:00:00,UFU FERNANDEZ,14,20,32,2,0,34,30,4,32,2,0,1,6,10,12,3,2,0,0,13,9,7,30
20200707,07JUL2020:00:00:00,UFU FERRER,23,26,34,15,0,49,37,12,37,12,0,0,12,11,19,5,2,0,0,10,15,12,37
20200707,07JUL2020:00:00:00,UFU GRIERSON,13,7,20,0,0,20,16,4,16,4,0,0,4,6,5,4,1,0,0,6,8,2,16
20200707,07JUL2020:00:00:00,UFU GUTIERREZ,21,15,26,9,1,36,30,6,30,6,12,5,4,9,2,3,1,0,0,7,17,5,30
20200707,07JUL2020:00:00:00,UFU MUÑIZ,43,44,44,41,2,87,53,34,57,30,0,4,15,29,18,8,7,6,0,16,30,7,53
20200707,07JUL2020:00:00:00,UFU PENNA,5,3,8,0,0,8,6,2,6,2,0,0,0,3,1,2,2,0,0,3,3,0,6
20200707,07JUL2020:00:00:00,UFU PIROVANO,13,23,25,9,2,36,26,10,34,2,1,2,3,10,10,4,5,1,0,9,10,6,26
20200707,07JUL2020:00:00:00,UFU PIÑERO,27,43,53,8,9,70,30,40,32,38,1,3,18,15,19,6,7,1,0,14,12,3,30
20200707,07JUL2020:00:00:00,UFU RAMOS MEJIA,26,39,52,13,0,65,37,28,37,28,0,2,18,19,10,9,5,2,0,25,3,9,37
20200707,07JUL2020:00:00:00,UFU RIVADAVIA,18,24,29,10,3,42,10,32,10,32,0,0,8,14,9,5,4,2,0,1,6,3,10
20200707,07JUL2020:00:00:00,UFU SANTOJANNI,33,20,39,14,0,53,41,12,49,4,2,4,13,9,15,8,2,0,0,25,13,3,41
20200707,07JUL2020:00:00:00,UFU TORNU,25,26,34,17,0,51,41,10,43,8,2,2,7,12,8,16,3,1,0,16,11,13,41
20200612,12JUN2020:00:00:00,UFU BORDA-MOYANO,32,24,37,14,5,56,54,2,54,2,0,0,2,17,16,13,7,1,0,1,29,24,54
20200612,12JUN2020:00:00:00,UFU DURAND,24,33,48,5,4,57,55,2,57,0,2,6,18,13,10,6,2,0,0,21,7,27,55
20200612,12JUN2020:00:00:00,UFU ELIZALDE,18,10,9,17,2,28,14,14,26,2,12,12,2,0,2,0,0,0,0,3,5,6,14
20200612,12JUN2020:00:00:00,UFU FERNANDEZ,18,20,30,6,2,38,28,10,36,2,0,2,2,20,6,4,0,4,0,8,9,11,28
20200612,12JUN2020:00:00:00,UFU FERRER,19,12,18,13,0,31,23,8,23,8,0,0,8,8,9,6,0,0,0,3,9,11,23
20200612,12JUN2020:00:00:00,UFU GRIERSON,19,12,29,2,0,31,7,24,29,2,0,2,6,12,4,3,4,0,0,2,2,3,7
20200612,12JUN2020:00:00:00,UFU GUTIERREZ,24,7,17,12,2,31,27,4,29,2,7,3,4,12,5,0,0,0,0,2,16,9,27
20200612,12JUN2020:00:00:00,UFU MUÑIZ,36,36,43,21,8,72,54,18,54,18,0,0,10,6,25,14,10,7,0,9,22,23,54
20200612,12JUN2020:00:00:00,UFU PENNA,55,46,79,15,7,101,69,32,81,20,0,0,26,34,22,9,8,2,0,13,28,28,69
20200612,12JUN2020:00:00:00,UFU PIROVANO,21,22,35,4,4,43,39,4,39,4,3,0,20,3,6,5,4,2,0,2,15,21,39
20200612,12JUN2020:00:00:00,UFU PIÑERO,50,39,75,9,5,89,79,10,81,8,12,8,15,21,17,11,5,0,0,30,18,31,79
20200612,12JUN2020:00:00:00,UFU RAMOS MEJIA,52,39,70,19,2,91,73,18,79,12,0,6,17,36,15,9,5,3,0,15,25,33,73
20200612,12JUN2020:00:00:00,UFU RIVADAVIA,28,25,24,17,12,53,53,0,53,0,0,2,10,17,11,6,7,0,0,12,16,25,53
20200612,12JUN2020:00:00:00,UFU SANTOJANNI,19,18,18,19,0,37,27,10,31,6,1,1,2,15,7,5,1,5,0,10,15,2,27
20200612,12JUN2020:00:00:00,UFU TORNU,37,29,56,7,3,66,60,6,60,6,0,2,3,29,9,11,12,0,0,8,23,29,60
20200612,12JUN2020:00:00:00,UFU VELEZ SARSFIELD,14,10,21,1,2,24,8,16,8,16,0,0,5,10,2,5,0,2,0,1,3,4,8
20200612,12JUN2020:00:00:00,UFU ZUBIZARRETA,13,6,11,6,2,19,17,2,17,2,0,0,2,4,3,6,4,0,0,3,3,11,17
20200613,13JUN2020:00:00:00,UFU ALVAREZ,25,24,47,2,0,49,41,8,45,4,3,2,16,9,4,8,5,2,0,8,9,24,41
20200613,13JUN2020:00:00:00,UFU ARGERICH,13,7,16,4,0,20,18,2,18,2,0,2,4,2,4,5,2,1,0,3,5,10,18
20200613,13JUN2020:00:00:00,UFU BORDA-MOYANO,6,8,12,2,0,14,14,0,14,0,0,0,6,0,0,3,3,2,0,0,10,4,14
20200613,13JUN2020:00:00:00,UFU DURAND,21,25,43,3,0,46,32,14,44,2,9,4,4,12,7,5,3,2,0,12,10,10,32
20200613,13JUN2020:00:00:00,UFU ELIZALDE,2,2,2,2,0,4,4,0,4,0,0,4,0,0,0,0,0,0,0,0,2,2,4
20200613,13JUN2020:00:00:00,UFU FERNANDEZ,13,12,23,2,0,25,19,6,25,0,0,0,5,13,5,0,2,0,0,4,3,12,19
20200613,13JUN2020:00:00:00,UFU FERRER,9,11,17,3,0,20,12,8,12,8,0,0,4,8,0,7,1,0,0,1,4,7,12
20200613,13JUN2020:00:00:00,UFU GRIERSON,28,24,46,6,0,52,0,52,42,10,4,6,28,6,4,4,0,0,0,0,0,0,0
20200613,13JUN2020:00:00:00,UFU GUTIERREZ,4,2,6,0,0,6,6,0,6,0,2,0,2,0,2,0,0,0,0,0,2,4,6
20200613,13JUN2020:00:00:00,UFU MUÑIZ,14,26,26,14,0,40,38,2,38,2,0,0,2,12,17,4,2,3,0,9,14,15,38
20200613,13JUN2020:00:00:00,UFU PENNA,34,19,51,2,0,53,43,10,45,8,0,0,11,20,11,4,7,0,0,11,14,18,43
20200613,13JUN2020:00:00:00,UFU PIROVANO,3,15,13,3,2,18,12,6,18,0,0,0,3,5,5,3,2,0,0,4,4,4,12
20200613,13JUN2020:00:00:00,UFU PIÑERO,28,30,50,4,4,58,34,24,44,14,2,3,23,16,6,3,5,0,0,13,8,13,34
20200613,13JUN2020:00:00:00,UFU RAMOS MEJIA,21,33,42,12,0,54,18,36,20,34,0,2,8,18,8,12,6,0,0,3,3,12,18
20200613,13JUN2020:00:00:00,UFU RIVADAVIA,28,13,37,2,2,41,23,18,23,18,0,0,9,13,5,10,4,0,0,6,5,12,23
20200613,13JUN2020:00:00:00,UFU SANTOJANNI,7,16,14,9,0,23,19,4,23,0,0,1,7,6,4,4,1,0,0,8,9,1,19
20200613,13JUN2020:00:00:00,UFU TORNU,33,24,24,10,23,57,55,2,55,2,0,3,12,13,14,10,5,0,0,5,26,20,55
20200613,13JUN2020:00:00:00,UFU VELEZ SARSFIELD,11,26,30,7,0,37,23,14,23,14,2,5,13,4,7,5,1,0,0,8,5,10,23
20200613,13JUN2020:00:00:00,UFU ZUBIZARRETA,9,3,4,8,0,12,10,2,10,2,0,0,2,9,0,0,1,0,0,1,4,5,10
20200614,14JUN2020:00:00:00,UFU ALVAREZ,14,15,24,1,4,29,17,12,25,4,4,6,7,7,3,2,0,0,0,8,6,3,17
20200614,14JUN2020:00:00:00,UFU ARGERICH,9,6,13,2,0,15,11,4,11,4,0,3,3,2,3,2,2,0,0,6,4,1,11
20200614,14JUN2020:00:00:00,UFU BORDA-MOYANO,2,3,2,3,0,5,3,2,5,0,0,0,0,3,1,1,0,0,0,0,3,0,3
20200614,14JUN2020:00:00:00,UFU DURAND,21,23,41,2,1,44,16,28,44,0,2,9,5,6,12,10,0,0,0,11,3,2,16
20200614,14JUN2020:00:00:00,UFU ELIZALDE,15,22,16,21,0,37,9,28,33,4,17,15,2,2,1,0,0,0,0,0,8,1,9
20200614,14JUN2020:00:00:00,UFU FERNANDEZ,9,10,18,1,0,19,19,0,19,0,0,0,7,7,2,2,1,0,0,9,7,3,19
20200614,14JUN2020:00:00:00,UFU FERRER,19,10,23,4,2,29,17,12,17,12,0,0,8,2,2,10,7,0,0,1,8,8,17
20200614,14JUN2020:00:00:00,UFU GRIERSON,12,3,11,1,3,15,9,6,13,2,0,0,3,5,4,3,0,0,0,2,6,1,9
20200614,14JUN2020:00:00:00,UFU GUTIERREZ,10,2,6,6,0,12,0,12,12,0,4,0,0,2,6,0,0,0,0,0,0,0,0
20200614,14JUN2020:00:00:00,UFU MUÑIZ,25,13,30,8,0,38,20,18,30,8,6,2,11,4,9,2,1,3,0,9,8,3,20
20200614,14JUN2020:00:00:00,UFU PENNA,29,25,34,18,2,54,46,8,52,2,0,0,8,25,9,7,5,0,0,9,25,12,46
20200614,14JUN2020:00:00:00,UFU PIROVANO,8,7,13,2,0,15,7,8,11,4,1,1,0,3,9,1,0,0,0,4,3,0,7
20200614,14JUN2020:00:00:00,UFU PIÑERO,31,12,38,3,2,43,35,8,35,8,7,5,12,8,4,4,3,0,0,17,14,4,35
20200614,14JUN2020:00:00:00,UFU RAMOS MEJIA,15,30,43,2,0,45,27,18,27,18,0,0,12,16,8,6,3,0,0,10,7,10,27
20200614,14JUN2020:00:00:00,UFU RIVADAVIA,6,15,17,2,2,21,3,18,3,18,0,0,7,8,2,2,2,0,0,0,3,0,3
20200614,14JUN2020:00:00:00,UFU SANTOJANNI,7,9,9,7,0,16,12,4,14,2,0,0,3,6,3,3,1,0,0,4,8,0,12
20200614,14JUN2020:00:00:00,UFU TORNU,6,11,8,1,8,17,11,6,15,2,0,0,2,6,5,3,1,0,0,3,6,2,11
20200614,14JUN2020:00:00:00,UFU VELEZ SARSFIELD,16,21,34,3,0,37,11,26,33,4,2,2,7,4,7,5,9,1,0,6,1,4,11
20200614,14JUN2020:00:00:00,UFU ZUBIZARRETA,18,4,18,4,0,22,0,22,0,22,2,4,2,2,6,4,0,2,0,0,0,0,0
20200615,15JUN2020:00:00:00,UFU ALVAREZ,13,25,34,2,2,38,24,14,24,14,0,7,6,12,6,6,1,0,0,13,9,2,24
20200615,15JUN2020:00:00:00,UFU ARGERICH,8,10,12,4,2,18,14,4,14,4,0,0,3,4,7,2,2,0,0,6,2,6,14
20200615,15JUN2020:00:00:00,UFU BORDA-MOYANO,2,0,1,1,0,2,2,0,2,0,0,0,0,1,0,1,0,0,0,0,2,0,2
20200615,15JUN2020:00:00:00,UFU DURAND,13,14,22,2,3,27,17,10,21,6,0,0,6,7,5,7,0,2,0,4,8,5,17
20200615,15JUN2020:00:00:00,UFU ELIZALDE,8,8,9,7,0,16,6,10,6,10,9,4,0,0,0,0,3,0,0,0,4,2,6
20200615,15JUN2020:00:00:00,UFU FERNANDEZ,31,12,25,18,0,43,3,40,39,4,0,0,3,15,16,9,0,0,0,1,1,1,3
20200615,15JUN2020:00:00:00,UFU FERRER,17,20,26,5,6,37,8,29,16,21,0,0,12,15,3,5,2,0,0,1,3,4,8
20200615,15JUN2020:00:00:00,UFU GRIERSON,4,12,14,2,0,16,12,4,16,0,0,1,2,1,9,3,0,0,0,9,1,2,12
20200615,15JUN2020:00:00:00,UFU GUTIERREZ,14,6,8,10,2,20,0,20,20,0,2,2,10,4,0,2,0,0,0,0,0,0,0
20200615,15JUN2020:00:00:00,UFU MUÑIZ,7,18,19,4,2,25,17,8,19,6,0,1,3,2,7,10,2,0,0,10,7,0,17
20200615,15JUN2020:00:00:00,UFU PENNA,24,16,29,9,2,40,36,4,36,4,0,0,8,18,4,6,2,2,0,10,16,10,36
20200615,15JUN2020:00:00:00,UFU PIROVANO,4,7,10,0,1,11,7,4,9,2,0,0,4,0,5,0,2,0,0,3,2,2,7
20200615,15JUN2020:00:00:00,UFU PIÑERO,31,36,53,6,8,67,9,58,45,22,3,5,10,23,12,8,3,3,0,4,2,3,9
20200615,15JUN2020:00:00:00,UFU RAMOS MEJIA,31,31,52,10,0,62,48,14,50,12,0,2,14,13,12,15,5,1,0,19,17,12,48
20200615,15JUN2020:00:00:00,UFU RIVADAVIA,15,9,17,7,0,24,10,14,10,14,0,2,6,8,4,0,2,2,0,3,5,2,10
20200615,15JUN2020:00:00:00,UFU SANTOJANNI,13,20,24,7,2,33,25,8,29,4,2,3,10,12,3,3,0,0,0,13,5,6,25
20200615,15JUN2020:00:00:00,UFU TORNU,22,11,22,0,11,33,27,6,33,0,6,2,2,16,2,5,0,0,0,3,3,21,27
20200615,15JUN2020:00:00:00,UFU VELEZ SARSFIELD,12,16,26,2,0,28,2,26,22,6,0,0,4,11,7,2,4,0,0,1,1,0,2
20200616,16JUN2020:00:00:00,UFU ALVAREZ,36,23,46,13,0,59,11,48,53,6,0,2,7,22,18,5,3,2,0,6,5,0,11
20200616,16JUN2020:00:00:00,UFU ARGERICH,49,40,66,23,0,89,42,47,42,47,8,6,16,20,13,15,9,2,0,20,4,18,42
20200616,16JUN2020:00:00:00,UFU BORDA-MOYANO,19,38,39,18,0,57,25,32,25,32,0,0,2,11,5,24,12,3,0,1,22,2,25
20200616,16JUN2020:00:00:00,UFU DURAND,22,31,47,3,3,53,47,6,47,6,7,8,9,12,8,9,0,0,0,19,17,11,47
20200616,16JUN2020:00:00:00,UFU ELIZALDE,34,24,32,24,2,58,0,58,42,16,15,15,5,5,6,11,1,0,0,0,0,0,0
20200616,16JUN2020:00:00:00,UFU FERNANDEZ,13,13,24,1,1,26,20,6,26,0,0,0,5,12,5,2,2,0,0,7,3,9,20
20200616,16JUN2020:00:00:00,UFU FERRER,29,43,54,18,0,72,18,54,42,30,0,0,25,29,9,9,0,0,0,7,5,6,18
20200616,16JUN2020:00:00:00,UFU GRIERSON,16,12,19,7,2,28,16,12,16,12,2,2,4,4,4,8,4,0,0,6,7,3,16
20200616,16JUN2020:00:00:00,UFU GUTIERREZ,48,14,38,24,0,62,0,62,60,2,16,4,12,12,12,4,2,0,0,0,0,0,0
20200616,16JUN2020:00:00:00,UFU MUÑIZ,26,35,42,16,3,61,49,12,55,6,4,0,4,18,18,2,5,10,0,14,10,25,49
20200616,16JUN2020:00:00:00,UFU PENNA,26,30,43,8,5,56,28,28,44,12,0,0,7,17,14,9,6,3,0,11,13,4,28
20200616,16JUN2020:00:00:00,UFU PIROVANO,15,7,16,6,0,22,20,2,22,0,0,0,3,5,9,2,2,1,0,6,11,3,20
20200616,16JUN2020:00:00:00,UFU PIÑERO,58,56,93,4,17,114,37,77,79,35,6,9,22,27,23,17,7,3,0,21,12,4,37
20200616,16JUN2020:00:00:00,UFU RAMOS MEJIA,23,50,67,5,1,73,41,32,49,24,0,0,17,23,17,6,9,1,0,15,18,8,41
20200616,16JUN2020:00:00:00,UFU RIVADAVIA,26,23,18,9,22,49,41,8,43,6,0,0,9,13,10,16,1,0,0,4,25,12,41
20200616,16JUN2020:00:00:00,UFU SANTOJANNI,14,22,19,17,0,36,28,8,30,6,2,1,4,11,8,5,5,0,0,9,16,3,28
20200616,16JUN2020:00:00:00,UFU TORNU,25,22,41,6,0,47,47,0,47,0,3,0,10,18,5,4,7,0,0,3,13,31,47
20200616,16JUN2020:00:00:00,UFU VELEZ SARSFIELD,8,10,16,2,0,18,0,18,12,6,0,0,3,7,6,0,2,0,0,0,0,0,0
20200616,16JUN2020:00:00:00,UFU ZUBIZARRETA,32,9,29,9,3,41,11,30,11,30,4,2,10,3,10,4,5,3,0,1,7,3,11
20200617,17JUN2020:00:00:00,UFU ALVAREZ,26,24,36,5,9,50,40,10,46,4,10,2,8,10,12,6,1,1,0,14,8,18,40
20200617,17JUN2020:00:00:00,UFU ARGERICH,77,71,117,29,2,148,54,94,68,80,6,9,19,36,34,29,10,5,0,27,13,14,54
20200617,17JUN2020:00:00:00,UFU BORDA-MOYANO,61,15,52,21,3,76,74,2,74,2,0,0,6,15,20,14,9,12,0,3,53,18,74
20200617,17JUN2020:00:00:00,UFU DURAND,28,34,54,8,0,62,50,12,50,12,4,6,11,18,10,13,0,0,0,20,17,13,50
20200617,17JUN2020:00:00:00,UFU ELIZALDE,19,20,19,20,0,39,1,38,23,16,27,10,0,2,0,0,0,0,0,0,1,0,1
20200617,17JUN2020:00:00:00,UFU FERNANDEZ,20,14,29,5,0,34,26,8,26,8,0,0,12,11,5,6,0,0,0,10,4,12,26
20200617,17JUN2020:00:00:00,UFU FERRER,34,24,38,18,2,58,34,24,40,18,0,0,7,12,9,18,8,4,0,5,13,16,34
20200617,17JUN2020:00:00:00,UFU GRIERSON,18,9,25,1,1,27,21,6,21,6,0,0,8,11,5,0,3,0,0,11,4,6,21
20200617,17JUN2020:00:00:00,UFU GUTIERREZ,32,8,18,22,0,40,4,36,40,0,13,1,6,12,1,5,2,0,0,3,0,1,4
20200617,17JUN2020:00:00:00,UFU MUÑIZ,36,35,31,35,5,71,46,25,58,13,3,6,5,20,22,9,6,0,0,9,29,8,46
20200617,17JUN2020:00:00:00,UFU PENNA,11,19,18,10,2,30,22,8,26,4,0,0,5,10,6,4,5,0,0,6,10,6,22
20200617,17JUN2020:00:00:00,UFU PIROVANO,15,6,18,3,0,21,15,6,21,0,2,2,7,6,2,2,0,0,0,4,4,7,15
20200617,17JUN2020:00:00:00,UFU PIÑERO,46,45,78,4,9,91,63,28,69,22,9,10,15,25,12,6,9,5,0,25,31,7,63
20200617,17JUN2020:00:00:00,UFU RAMOS MEJIA,33,53,72,12,2,86,46,40,76,10,0,0,17,23,18,25,1,2,0,11,22,13,46
20200617,17JUN2020:00:00:00,UFU RIVADAVIA,63,33,51,27,18,96,32,64,36,60,0,0,18,23,27,20,8,0,0,3,14,15,32
20200617,17JUN2020:00:00:00,UFU SANTOJANNI,26,5,16,15,0,31,29,2,29,2,2,0,7,10,5,5,2,0,0,10,18,1,29
20200617,17JUN2020:00:00:00,UFU TORNU,30,22,43,9,0,52,44,8,44,8,5,6,15,11,4,7,2,2,0,11,13,20,44
20200617,17JUN2020:00:00:00,UFU VELEZ SARSFIELD,28,24,34,16,2,52,0,52,30,22,0,0,16,7,16,7,6,0,0,0,0,0,0
20200617,17JUN2020:00:00:00,UFU ZUBIZARRETA,25,10,20,15,0,35,11,24,13,22,0,0,5,18,5,4,2,1,0,6,2,3,11
20200618,18JUN2020:00:00:00,UFU ALVAREZ,25,30,35,9,11,55,39,16,39,16,1,3,23,12,7,7,2,0,0,12,1,26,39
20200618,18JUN2020:00:00:00,UFU ARGERICH,56,53,71,32,6,109,51,58,53,56,3,11,20,21,24,16,8,6,0,18,12,21,51
20200618,18JUN2020:00:00:00,UFU BORDA-MOYANO,28,40,45,22,1,68,60,8,64,4,0,1,2,14,20,18,8,5,0,6,42,12,60
20200618,18JUN2020:00:00:00,UFU DURAND,24,33,52,5,0,57,41,16,43,14,1,1,8,12,16,10,9,0,0,15,21,5,41
20200618,18JUN2020:00:00:00,UFU ELIZALDE,20,16,20,16,0,36,2,34,26,10,16,10,0,2,2,4,2,0,0,0,2,0,2
20200618,18JUN2020:00:00:00,UFU FERNANDEZ,17,20,36,1,0,37,33,4,33,4,0,1,6,11,9,7,3,0,0,9,11,12,33
20200618,18JUN2020:00:00:00,UFU FERRER,25,39,32,30,2,64,34,30,36,28,0,0,15,14,18,14,3,0,0,6,17,11,34
20200618,18JUN2020:00:00:00,UFU GRIERSON,12,14,26,0,0,26,14,12,14,12,1,0,5,13,1,3,3,0,0,9,1,4,14
20200618,18JUN2020:00:00:00,UFU GUTIERREZ,89,34,77,44,2,123,1,122,113,10,8,10,5,28,14,30,26,2,0,1,0,0,1
20200618,18JUN2020:00:00:00,UFU MUÑIZ,50,41,69,19,3,91,59,32,73,18,4,8,17,29,14,16,2,1,0,13,32,14,59
20200618,18JUN2020:00:00:00,UFU PENNA,14,10,20,0,4,24,12,12,20,4,0,0,7,6,2,3,4,2,0,4,4,4,12
20200618,18JUN2020:00:00:00,UFU PIROVANO,15,19,18,15,1,34,30,4,30,4,0,0,0,6,11,10,7,0,0,9,15,5,30
20200618,18JUN2020:00:00:00,UFU PIÑERO,89,73,123,26,13,162,60,102,60,102,13,10,30,47,28,17,10,7,0,22,26,11,60
20200618,18JUN2020:00:00:00,UFU RAMOS MEJIA,37,30,59,8,0,67,47,20,55,12,0,0,12,19,19,13,4,0,0,19,9,19,47
20200618,18JUN2020:00:00:00,UFU RIVADAVIA,35,22,35,13,9,57,45,12,45,12,0,0,13,7,15,9,9,4,0,4,12,29,45
20200618,18JUN2020:00:00:00,UFU SANTOJANNI,23,22,29,14,2,45,39,6,45,0,1,4,7,12,12,8,1,0,0,13,24,2,39
20200618,18JUN2020:00:00:00,UFU TORNU,64,37,70,30,1,101,87,14,91,10,4,6,12,31,30,12,2,4,0,20,37,30,87
20200618,18JUN2020:00:00:00,UFU VELEZ SARSFIELD,50,26,40,30,6,76,0,76,64,12,0,0,5,23,16,17,14,1,0,0,0,0,0
20200618,18JUN2020:00:00:00,UFU ZUBIZARRETA,36,7,22,11,10,43,7,36,13,30,0,6,4,10,14,8,1,0,0,1,5,1,7
20200619,19JUN2020:00:00:00,UFU ALVAREZ,25,29,37,13,4,54,40,14,52,2,4,0,4,15,16,6,6,3,0,15,6,19,40
20200619,19JUN2020:00:00:00,UFU ARGERICH,52,43,81,12,2,95,61,34,61,34,5,7,21,25,25,5,5,2,0,10,11,40,61
20200619,19JUN2020:00:00:00,UFU BORDA-MOYANO,49,42,76,15,0,91,65,26,79,12,0,1,7,9,15,15,15,29,0,0,51,14,65
20200619,19JUN2020:00:00:00,UFU DURAND,35,40,61,14,0,75,59,16,67,8,1,2,12,19,19,15,7,0,0,24,27,8,59
20200619,19JUN2020:00:00:00,UFU ELIZALDE,18,27,19,26,0,45,1,44,27,18,17,24,0,2,0,0,2,0,0,0,1,0,1
20200619,19JUN2020:00:00:00,UFU FERNANDEZ,22,17,24,13,2,39,27,12,33,6,0,0,14,11,5,5,3,1,0,11,10,6,27
20200619,19JUN2020:00:00:00,UFU FERRER,38,18,33,23,0,56,38,18,38,18,0,2,4,12,15,14,9,0,0,6,18,14,38
20200619,19JUN2020:00:00:00,UFU GRIERSON,9,13,18,2,2,22,16,6,18,4,2,0,1,11,4,0,2,2,0,8,2,6,16
20200619,19JUN2020:00:00:00,UFU GUTIERREZ,104,40,100,44,0,144,0,144,132,12,6,6,15,35,40,27,15,0,0,0,0,0,0
20200619,19JUN2020:00:00:00,UFU MUÑIZ,40,70,64,34,12,110,74,36,90,20,0,10,6,24,33,27,8,2,0,15,42,17,74
20200619,19JUN2020:00:00:00,UFU PENNA,15,36,44,5,2,51,37,14,45,6,0,0,14,9,14,9,1,4,0,16,3,18,37
20200619,19JUN2020:00:00:00,UFU PIROVANO,12,15,18,9,0,27,25,2,25,2,2,0,2,9,3,1,7,3,0,3,13,8,25
20200619,19JUN2020:00:00:00,UFU PIÑERO,70,81,126,10,15,151,27,124,51,100,14,19,29,45,14,12,11,7,0,12,12,3,27
20200619,19JUN2020:00:00:00,UFU RAMOS MEJIA,46,48,70,19,5,94,74,20,78,16,0,2,19,28,18,16,9,2,0,21,33,20,74
20200619,19JUN2020:00:00:00,UFU RIVADAVIA,26,29,30,15,10,55,45,10,45,10,0,0,13,18,15,7,2,0,0,6,7,31,45
20200619,19JUN2020:00:00:00,UFU SANTOJANNI,25,24,37,11,1,49,29,20,43,6,5,3,12,8,8,6,4,3,0,9,17,3,29
20200619,19JUN2020:00:00:00,UFU TORNU,43,39,63,14,5,82,34,48,78,4,0,6,15,17,19,6,18,1,0,10,17,7,34
20200619,19JUN2020:00:00:00,UFU VELEZ SARSFIELD,44,23,58,9,0,67,0,67,52,15,0,2,11,36,4,12,2,0,0,0,0,0,0
20200619,19JUN2020:00:00:00,UFU ZUBIZARRETA,41,20,39,20,2,61,5,56,17,44,0,2,9,17,19,10,2,2,0,1,0,4,5
20200620,20JUN2020:00:00:00,UFU ALVAREZ,29,26,44,10,1,55,29,26,29,26,9,4,8,16,8,6,2,2,0,18,5,6,29
20200620,20JUN2020:00:00:00,UFU ARGERICH,8,14,17,4,1,22,4,18,4,18,0,2,2,7,2,6,3,0,0,1,2,1,4
20200620,20JUN2020:00:00:00,UFU BORDA-MOYANO,67,2,61,8,0,69,11,58,11,58,0,0,4,5,12,15,19,14,0,0,9,2,11
20200620,20JUN2020:00:00:00,UFU DURAND,20,13,26,6,1,33,31,2,33,0,0,1,8,10,11,2,1,0,0,11,17,3,31
20200620,20JUN2020:00:00:00,UFU ELIZALDE,11,10,0,21,0,21,21,0,21,0,2,1,0,5,10,3,0,0,0,1,12,8,21
20200620,20JUN2020:00:00:00,UFU FERNANDEZ,13,11,19,5,0,24,10,14,20,4,0,0,1,5,8,3,5,2,0,1,6,3,10
20200620,20JUN2020:00:00:00,UFU FERRER,17,12,21,5,3,29,23,6,23,6,0,0,4,6,11,4,4,0,0,4,10,9,23
20200620,20JUN2020:00:00:00,UFU GRIERSON,7,3,8,2,0,10,10,0,10,0,0,0,3,4,2,1,0,0,0,5,5,0,10
20200620,20JUN2020:00:00:00,UFU GUTIERREZ,22,17,26,10,3,39,27,12,33,6,6,2,7,7,9,5,3,0,0,4,18,5,27
20200620,20JUN2020:00:00:00,UFU MUÑIZ,33,49,54,19,9,82,68,14,74,8,2,2,10,19,23,9,11,6,0,10,30,28,68
20200620,20JUN2020:00:00:00,UFU PENNA,23,25,37,8,3,48,38,10,42,6,0,0,12,11,14,7,3,1,0,9,22,7,38
20200620,20JUN2020:00:00:00,UFU PIROVANO,16,8,18,6,0,24,22,2,22,2,2,0,7,5,6,4,0,0,0,4,6,12,22
20200620,20JUN2020:00:00:00,UFU PIÑERO,50,49,74,20,5,99,53,46,57,42,3,12,22,34,13,12,2,1,0,18,32,3,53
20200620,20JUN2020:00:00:00,UFU RAMOS MEJIA,22,20,32,9,1,42,32,10,36,6,0,0,5,12,13,8,3,1,0,17,10,5,32
20200620,20JUN2020:00:00:00,UFU RIVADAVIA,27,21,43,5,0,48,30,18,30,18,0,0,10,13,12,7,5,1,0,11,4,12,30
20200620,20JUN2020:00:00:00,UFU SANTOJANNI,21,15,13,23,0,36,20,16,32,4,4,4,8,9,8,3,0,0,0,6,11,3,20
20200620,20JUN2020:00:00:00,UFU TORNU,21,19,26,6,8,40,32,8,32,8,2,6,3,8,19,1,1,0,0,6,14,12,32
20200620,20JUN2020:00:00:00,UFU VELEZ SARSFIELD,26,17,31,10,2,43,13,30,29,14,0,2,13,13,5,8,2,0,0,5,5,3,13
20200620,20JUN2020:00:00:00,UFU ZUBIZARRETA,28,20,28,18,2,48,0,48,0,48,0,0,4,12,20,8,2,2,0,0,0,0,0
20200621,21JUN2020:00:00:00,UFU ALVAREZ,13,16,28,1,0,29,19,10,19,10,2,1,5,14,5,0,2,0,0,10,6,3,19
20200621,21JUN2020:00:00:00,UFU ARGERICH,30,14,28,16,0,44,18,26,18,26,4,4,5,11,10,7,2,1,0,9,8,1,18
20200621,21JUN2020:00:00:00,UFU BORDA-MOYANO,5,4,1,8,0,9,5,4,7,2,0,0,0,0,6,1,2,0,0,0,4,1,5
20200621,21JUN2020:00:00:00,UFU DURAND,11,12,12,6,5,23,23,0,23,0,0,0,4,8,6,4,1,0,0,5,14,4,23
20200621,21JUN2020:00:00:00,UFU ELIZALDE,16,24,8,32,0,40,36,4,38,2,22,18,0,0,0,0,0,0,0,1,18,17,36
20200621,21JUN2020:00:00:00,UFU FERNANDEZ,19,12,20,9,2,31,21,10,27,4,0,0,6,9,10,4,2,0,0,5,8,8,21
20200621,21JUN2020:00:00:00,UFU FERRER,27,21,24,19,5,48,28,20,28,20,6,8,11,11,6,3,3,0,0,7,9,12,28
20200621,21JUN2020:00:00:00,UFU GRIERSON,8,13,15,3,3,21,15,6,17,4,0,0,10,5,3,3,0,0,0,6,4,5,15
20200621,21JUN2020:00:00:00,UFU GUTIERREZ,18,16,24,10,0,34,4,30,30,4,10,10,0,6,8,0,0,0,0,0,2,2,4
20200621,21JUN2020:00:00:00,UFU MUÑIZ,18,19,21,16,0,37,21,16,35,2,0,0,5,11,8,9,4,0,0,8,9,4,21
20200621,21JUN2020:00:00:00,UFU PENNA,30,21,39,11,1,51,33,18,45,6,0,0,7,11,10,6,14,3,0,11,18,4,33
20200621,21JUN2020:00:00:00,UFU PIROVANO,9,8,14,2,1,17,17,0,17,0,0,0,5,2,7,2,1,0,0,4,5,8,17
20200621,21JUN2020:00:00:00,UFU PIÑERO,32,23,43,11,1,55,43,12,43,12,8,8,10,15,5,6,3,0,0,25,11,7,43
20200621,21JUN2020:00:00:00,UFU RAMOS MEJIA,30,20,40,6,4,50,30,20,34,16,0,4,10,17,10,4,4,1,0,19,6,5,30
20200621,21JUN2020:00:00:00,UFU RIVADAVIA,13,15,27,1,0,28,12,16,12,16,0,2,7,4,4,6,5,0,0,5,6,0,12
20200621,21JUN2020:00:00:00,UFU SANTOJANNI,10,3,13,0,0,13,11,2,13,0,0,1,4,3,4,1,0,0,0,5,6,0,11
20200621,21JUN2020:00:00:00,UFU TORNU,9,9,12,4,2,18,12,6,12,6,0,0,4,2,1,7,4,0,0,4,6,2,12
20200621,21JUN2020:00:00:00,UFU VELEZ SARSFIELD,8,17,16,9,0,25,7,18,13,12,0,0,7,6,4,5,3,0,0,2,5,0,7
20200621,21JUN2020:00:00:00,UFU ZUBIZARRETA,11,11,11,11,0,22,16,6,18,4,0,0,1,9,8,4,0,0,0,0,2,14,16
20200622,22JUN2020:00:00:00,UFU ALVAREZ,16,15,24,4,3,31,25,6,25,6,6,2,6,10,1,1,4,1,0,12,7,6,25
20200622,22JUN2020:00:00:00,UFU ARGERICH,25,29,33,19,2,54,42,12,42,12,3,1,10,12,13,9,2,4,0,13,14,15,42
20200622,22JUN2020:00:00:00,UFU BORDA-MOYANO,41,11,32,16,4,52,38,14,38,14,0,2,5,5,10,10,11,9,0,0,30,8,38
20200622,22JUN2020:00:00:00,UFU DURAND,26,31,41,16,0,57,53,4,55,2,2,0,10,27,9,7,1,1,0,20,19,14,53
20200622,22JUN2020:00:00:00,UFU ELIZALDE,9,11,9,10,1,20,14,6,16,4,13,6,0,0,0,1,0,0,0,0,9,5,14
20200622,22JUN2020:00:00:00,UFU FERNANDEZ,27,25,43,9,0,52,36,16,38,14,0,1,15,9,13,14,0,0,0,10,18,7,36
20200622,22JUN2020:00:00:00,UFU FERRER,21,25,22,24,0,46,25,21,25,21,0,0,14,8,7,8,9,0,0,6,11,8,25
20200622,22JUN2020:00:00:00,UFU GRIERSON,13,5,14,3,1,18,14,4,14,4,0,2,8,0,5,1,2,0,0,7,4,3,14
20200622,22JUN2020:00:00:00,UFU GUTIERREZ,21,14,20,13,2,35,23,12,23,12,16,3,3,8,3,2,0,0,0,2,15,6,23
20200622,22JUN2020:00:00:00,UFU MUÑIZ,44,55,69,24,6,99,77,22,77,22,5,3,22,20,20,21,7,1,0,13,37,27,77
20200622,22JUN2020:00:00:00,UFU PENNA,27,16,36,5,2,43,23,20,35,8,0,2,8,8,8,6,9,2,0,10,10,3,23
20200622,22JUN2020:00:00:00,UFU PIROVANO,15,15,28,0,2,30,22,8,28,2,4,0,7,4,4,4,3,4,0,9,5,8,22
20200622,22JUN2020:00:00:00,UFU PIÑERO,65,59,89,11,24,124,34,90,40,84,5,11,27,34,26,13,4,4,0,13,17,4,34
20200622,22JUN2020:00:00:00,UFU RAMOS MEJIA,37,41,68,10,0,78,54,24,54,24,0,2,12,35,18,6,5,0,0,22,20,12,54
20200622,22JUN2020:00:00:00,UFU RIVADAVIA,18,11,24,2,3,29,17,12,17,12,0,0,2,7,11,5,2,2,0,7,7,3,17
20200622,22JUN2020:00:00:00,UFU SANTOJANNI,31,36,54,11,2,67,51,16,63,4,7,2,17,13,13,11,4,0,0,22,24,5,51
20200622,22JUN2020:00:00:00,UFU TORNU,36,23,43,14,2,59,21,38,33,26,0,2,9,24,6,8,9,1,0,9,10,2,21
20200622,22JUN2020:00:00:00,UFU VELEZ SARSFIELD,24,38,38,20,4,62,0,62,48,14,0,0,10,22,11,10,3,6,0,0,0,0,0
20200622,22JUN2020:00:00:00,UFU ZUBIZARRETA,15,8,4,11,8,23,7,16,11,12,0,2,3,6,4,4,4,0,0,1,2,4,7
20200623,23JUN2020:00:00:00,UFU ALVAREZ,46,49,80,8,7,95,83,12,83,12,10,22,18,15,15,9,6,0,0,56,12,15,83
20200623,23JUN2020:00:00:00,UFU ARGERICH,49,54,73,26,4,103,67,36,71,32,2,1,32,28,17,16,5,2,0,23,24,20,67
20200623,23JUN2020:00:00:00,UFU BORDA-MOYANO,14,13,23,2,2,27,9,18,9,18,0,0,0,7,5,6,4,5,0,0,8,1,9
20200623,23JUN2020:00:00:00,UFU DURAND,26,14,33,7,0,40,34,6,34,6,1,2,16,13,4,3,1,0,0,18,14,2,34
20200623,23JUN2020:00:00:00,UFU ELIZALDE,10,12,14,6,2,22,0,22,18,4,10,8,0,0,0,0,4,0,0,0,0,0,0
20200623,23JUN2020:00:00:00,UFU FERNANDEZ,20,14,25,9,0,34,30,4,30,4,0,0,4,15,10,3,2,0,0,7,15,7,30
20200623,23JUN2020:00:00:00,UFU FERRER,38,22,22,36,2,60,32,28,36,24,0,0,7,12,18,15,8,0,0,8,11,13,32
20200623,23JUN2020:00:00:00,UFU GRIERSON,8,13,17,2,2,21,15,6,15,6,0,0,9,5,2,2,2,1,0,7,4,4,15
20200623,23JUN2020:00:00:00,UFU GUTIERREZ,31,12,31,10,2,43,19,24,31,12,19,9,6,5,1,2,1,0,0,2,10,4,19
20200623,23JUN2020:00:00:00,UFU MUÑIZ,36,59,66,22,7,95,84,11,84,11,1,1,11,25,26,20,7,4,0,14,47,23,84
20200623,23JUN2020:00:00:00,UFU PENNA,29,8,29,7,1,37,25,12,29,8,0,0,16,7,5,6,3,0,0,7,13,5,25
20200623,23JUN2020:00:00:00,UFU PIROVANO,16,15,21,10,0,31,25,6,31,0,0,2,4,10,13,2,0,0,0,0,13,10,25
20200623,23JUN2020:00:00:00,UFU PIÑERO,27,29,43,5,8,56,32,24,34,22,1,3,13,18,7,6,8,0,0,13,15,4,32
20200623,23JUN2020:00:00:00,UFU RAMOS MEJIA,37,50,79,7,1,87,51,36,51,36,0,4,26,22,17,11,6,1,0,21,10,20,51
20200623,23JUN2020:00:00:00,UFU RIVADAVIA,11,10,12,4,5,21,15,6,15,6,0,2,3,5,8,3,0,0,0,2,3,9,15
20200623,23JUN2020:00:00:00,UFU SANTOJANNI,18,13,24,3,4,31,27,4,27,4,2,2,8,8,4,2,4,1,0,8,17,2,27
20200623,23JUN2020:00:00:00,UFU TORNU,13,22,20,11,4,35,29,6,31,4,0,2,9,7,8,6,3,0,0,7,16,6,29
20200623,23JUN2020:00:00:00,UFU VELEZ SARSFIELD,10,21,24,6,1,31,17,14,23,8,2,0,5,9,5,4,6,0,0,9,6,2,17
20200623,23JUN2020:00:00:00,UFU ZUBIZARRETA,15,6,11,10,0,21,13,8,15,6,0,0,2,2,6,4,7,0,0,5,5,3,13
20200624,24JUN2020:00:00:00,UFU ALVAREZ,32,27,45,8,6,59,53,6,59,0,4,4,6,14,12,9,10,0,0,21,20,12,53
20200624,24JUN2020:00:00:00,UFU ARGERICH,53,49,73,16,13,102,78,24,78,24,4,8,36,17,23,8,4,2,0,27,15,36,78
20200624,24JUN2020:00:00:00,UFU BORDA-MOYANO,12,30,33,7,2,42,36,6,36,6,0,1,12,8,8,8,5,0,0,8,20,8,36
20200624,24JUN2020:00:00:00,UFU DURAND,38,30,50,18,0,68,56,12,56,12,4,6,11,22,18,2,5,0,0,16,29,11,56
20200624,24JUN2020:00:00:00,UFU ELIZALDE,10,15,10,15,0,25,11,14,23,2,21,3,0,0,0,1,0,0,0,0,7,4,11
20200624,24JUN2020:00:00:00,UFU FERNANDEZ,15,9,18,6,0,24,20,4,20,4,0,0,6,7,3,1,5,2,0,4,9,6,20
20200624,24JUN2020:00:00:00,UFU FERRER,26,39,35,30,0,65,37,28,37,28,0,0,11,17,18,15,4,0,0,6,20,11,37
20200624,24JUN2020:00:00:00,UFU GRIERSON,14,7,13,7,1,21,13,8,13,8,0,0,3,9,3,6,0,0,0,2,9,2,13
20200624,24JUN2020:00:00:00,UFU GUTIERREZ,22,11,21,12,0,33,29,4,33,0,10,3,6,9,4,1,0,0,0,3,24,1,29
20200624,24JUN2020:00:00:00,UFU MUÑIZ,48,53,57,36,8,101,73,28,83,18,0,4,22,23,31,15,4,2,0,17,43,13,73
20200624,24JUN2020:00:00:00,UFU PENNA,28,20,32,9,7,48,32,16,42,6,0,0,13,13,13,5,4,0,0,12,12,8,32
20200624,24JUN2020:00:00:00,UFU PIROVANO,23,10,26,6,1,33,29,4,33,0,3,1,3,8,8,4,5,1,0,7,17,4,29
20200624,24JUN2020:00:00:00,UFU PIÑERO,65,74,107,19,13,139,93,46,101,38,7,4,29,42,21,26,7,3,0,39,37,16,93
20200624,24JUN2020:00:00:00,UFU RAMOS MEJIA,42,42,74,9,1,84,60,24,70,14,0,0,25,17,23,9,9,1,0,25,19,16,60
20200624,24JUN2020:00:00:00,UFU RIVADAVIA,60,30,52,29,9,90,26,64,26,64,0,2,24,20,20,16,8,0,0,7,9,9,26
20200624,24JUN2020:00:00:00,UFU SANTOJANNI,32,28,37,20,3,60,46,14,54,6,10,2,12,11,12,7,6,0,0,30,14,2,46
20200624,24JUN2020:00:00:00,UFU TORNU,28,20,33,13,2,48,38,10,44,4,2,5,12,4,4,10,11,0,0,4,17,17,38
20200624,24JUN2020:00:00:00,UFU VELEZ SARSFIELD,17,18,23,11,1,35,17,18,27,8,0,2,8,10,9,3,3,0,0,8,8,1,17
20200624,24JUN2020:00:00:00,UFU ZUBIZARRETA,11,19,19,8,3,30,12,18,16,14,0,1,5,7,16,1,0,0,0,3,6,3,12
20200625,25JUN2020:00:00:00,UFU ALVAREZ,28,27,47,4,4,55,31,24,33,22,1,1,16,16,11,4,2,4,0,15,8,8,31
20200625,25JUN2020:00:00:00,UFU ARGERICH,30,66,61,18,17,96,66,30,68,28,4,3,22,22,23,16,4,2,0,13,11,42,66
20200625,25JUN2020:00:00:00,UFU BORDA-MOYANO,3,9,8,3,1,12,12,0,12,0,0,0,1,4,0,3,4,0,0,4,7,1,12
20200625,25JUN2020:00:00:00,UFU DURAND,45,40,69,16,0,85,67,18,75,10,4,6,15,17,21,13,8,1,0,32,31,4,67
20200625,25JUN2020:00:00:00,UFU ELIZALDE,10,13,9,14,0,23,1,22,19,4,8,12,1,2,0,0,0,0,0,1,0,0,1
20200625,25JUN2020:00:00:00,UFU FERNANDEZ,21,20,31,9,1,41,39,2,39,2,0,0,10,12,9,7,3,0,0,5,19,15,39
20200625,25JUN2020:00:00:00,UFU FERRER,46,23,36,33,0,69,53,16,53,16,0,0,10,18,16,15,8,2,0,9,15,29,53
20200625,25JUN2020:00:00:00,UFU GRIERSON,9,12,17,2,2,21,15,6,17,4,0,0,2,10,5,4,0,0,0,7,5,3,15
20200625,25JUN2020:00:00:00,UFU GUTIERREZ,28,11,30,9,0,39,25,14,29,10,5,0,3,10,7,5,8,1,0,1,22,2,25
20200625,25JUN2020:00:00:00,UFU MUÑIZ,50,65,77,25,13,115,85,30,87,28,6,7,16,31,29,16,8,2,0,38,29,18,85
20200625,25JUN2020:00:00:00,UFU PENNA,23,11,25,9,0,34,26,8,30,4,0,0,10,11,7,4,2,0,0,11,11,4,26
20200625,25JUN2020:00:00:00,UFU PIROVANO,19,8,19,5,3,27,25,2,25,2,2,2,3,7,7,3,2,1,0,3,17,3,25
20200625,25JUN2020:00:00:00,UFU PIÑERO,39,50,62,21,6,89,63,26,65,24,8,5,21,17,12,12,8,6,0,31,24,8,63
20200625,25JUN2020:00:00:00,UFU RAMOS MEJIA,25,34,49,6,4,59,53,6,53,6,0,3,16,16,10,11,2,1,0,20,17,16,53
20200625,25JUN2020:00:00:00,UFU RIVADAVIA,44,28,45,14,13,72,62,10,62,10,0,0,8,17,17,15,12,3,0,6,41,13,62
20200625,25JUN2020:00:00:00,UFU SANTOJANNI,30,36,43,21,2,66,36,30,58,8,0,6,13,15,16,12,3,1,0,11,21,4,36
20200625,25JUN2020:00:00:00,UFU TORNU,31,14,35,8,2,45,41,4,41,4,0,2,10,14,13,3,2,1,0,7,20,14,41
20200625,25JUN2020:00:00:00,UFU VELEZ SARSFIELD,20,23,34,7,2,43,29,14,35,8,0,0,9,12,12,8,0,2,0,16,7,6,29
20200625,25JUN2020:00:00:00,UFU ZUBIZARRETA,9,25,11,17,6,34,4,30,16,18,2,7,10,3,9,1,2,0,0,0,2,2,4
20200626,26JUN2020:00:00:00,UFU ALVAREZ,35,29,55,6,3,64,52,12,52,12,4,11,6,12,14,10,7,0,0,22,21,9,52
20200626,26JUN2020:00:00:00,UFU ARGERICH,36,29,44,19,2,65,47,18,47,18,2,2,18,8,17,10,4,4,0,14,16,17,47
20200626,26JUN2020:00:00:00,UFU BORDA-MOYANO,50,13,48,12,3,63,57,6,57,6,0,2,9,2,17,13,14,6,0,2,43,12,57
20200626,26JUN2020:00:00:00,UFU DURAND,40,42,68,14,0,82,72,10,72,10,3,7,7,32,16,11,6,0,0,38,25,9,72
20200626,26JUN2020:00:00:00,UFU ELIZALDE,21,20,24,17,0,41,13,28,23,18,25,7,2,2,0,3,2,0,0,1,3,9,13
20200626,26JUN2020:00:00:00,UFU FERNANDEZ,33,22,43,10,2,55,43,12,47,8,0,0,14,23,10,8,0,0,0,14,10,17,43
20200626,26JUN2020:00:00:00,UFU FERRER,28,17,28,17,0,45,41,4,41,4,0,0,9,11,15,8,2,0,0,10,14,17,41
20200626,26JUN2020:00:00:00,UFU GRIERSON,9,17,19,6,1,26,18,8,18,8,0,0,11,7,3,4,1,0,0,4,12,2,18
20200626,26JUN2020:00:00:00,UFU GUTIERREZ,35,15,27,23,0,50,46,4,48,2,3,0,13,11,10,7,6,0,0,1,34,10,46
20200626,26JUN2020:00:00:00,UFU MUÑIZ,78,67,109,28,8,145,63,82,97,48,10,12,19,41,29,22,8,4,0,19,22,22,63
20200626,26JUN2020:00:00:00,UFU PENNA,31,28,47,7,5,59,39,20,47,12,0,2,10,8,14,17,6,2,0,19,14,6,39
20200626,26JUN2020:00:00:00,UFU PIROVANO,14,7,16,5,0,21,15,6,19,2,0,0,1,6,8,6,0,0,0,3,8,3,15
20200626,26JUN2020:00:00:00,UFU PIÑERO,81,78,115,32,12,159,64,95,64,95,9,16,41,28,31,23,11,0,0,22,22,20,64
20200626,26JUN2020:00:00:00,UFU RAMOS MEJIA,24,29,42,11,0,53,45,8,45,8,0,1,14,13,6,9,7,3,0,14,25,6,45
20200626,26JUN2020:00:00:00,UFU RIVADAVIA,39,36,41,20,14,75,39,36,41,34,0,3,13,22,15,20,2,0,0,8,19,10,39
20200626,26JUN2020:00:00:00,UFU SANTOJANNI,35,23,37,19,2,58,42,16,56,2,3,4,8,11,19,10,1,2,0,14,27,1,42
20200718,18JUL2020:00:00:00,UFU TORNU,39,33,42,22,8,72,66,6,68,4,3,3,12,25,6,7,16,0,0,19,31,15,66
20200718,18JUL2020:00:00:00,UFU VELEZ SARSFIELD,17,14,19,11,1,31,29,2,31,0,0,0,8,10,4,7,2,0,0,15,13,1,29
20200718,18JUL2020:00:00:00,UFU ZUBIZARRETA,12,10,8,14,0,22,18,4,18,4,0,2,5,10,4,0,1,0,0,7,4,7,18
20200719,19JUL2020:00:00:00,UFU ALVAREZ,32,28,50,6,4,60,58,2,58,2,8,0,16,21,6,1,6,2,0,18,14,26,58
20200719,19JUL2020:00:00:00,UFU ARGERICH,7,16,16,7,0,23,21,2,21,2,0,4,3,4,9,3,0,0,0,8,5,8,21
20200719,19JUL2020:00:00:00,UFU BORDA-MOYANO,8,1,4,5,0,9,9,0,9,0,0,0,0,3,3,1,1,1,0,1,8,0,9
20200719,19JUL2020:00:00:00,UFU DURAND,28,23,37,13,1,51,43,8,49,2,5,0,6,13,12,13,2,0,0,19,18,6,43
20200719,19JUL2020:00:00:00,UFU ELIZALDE,6,7,5,8,0,13,9,4,13,0,8,5,0,0,0,0,0,0,0,1,6,2,9
20200719,19JUL2020:00:00:00,UFU FERNANDEZ,21,24,32,13,0,45,41,4,45,0,0,0,13,12,9,8,2,1,0,17,10,14,41
20200719,19JUL2020:00:00:00,UFU FERRER,14,17,18,7,6,31,15,16,15,16,0,0,10,6,7,6,2,0,0,7,6,2,15
20200719,19JUL2020:00:00:00,UFU GRIERSON,12,9,18,3,0,21,21,0,21,0,3,0,3,4,9,1,1,0,0,8,11,2,21
20200719,19JUL2020:00:00:00,UFU GUTIERREZ,25,6,19,12,0,31,27,4,27,4,6,8,0,6,6,5,0,0,0,2,19,6,27
20200719,19JUL2020:00:00:00,UFU MUÑIZ,42,70,57,55,0,112,72,40,76,36,1,2,24,39,23,18,4,1,0,28,28,16,72
20200719,19JUL2020:00:00:00,UFU PENNA,15,18,26,7,0,33,23,10,27,6,0,0,6,5,5,6,9,2,0,14,6,3,23
20200719,19JUL2020:00:00:00,UFU PIROVANO,10,43,27,24,2,53,51,2,51,2,0,1,17,12,14,5,3,1,0,19,14,16,51
20200719,19JUL2020:00:00:00,UFU PIÑERO,34,27,50,10,1,61,51,10,53,8,6,3,9,24,8,4,6,1,0,24,20,7,51
20200719,19JUL2020:00:00:00,UFU RAMOS MEJIA,26,25,42,9,0,51,41,10,41,10,0,0,17,10,8,8,7,1,0,23,10,8,41
20200719,19JUL2020:00:00:00,UFU RIVADAVIA,4,8,9,3,0,12,10,2,10,2,0,0,6,4,0,1,0,1,0,4,2,3,10
20200719,19JUL2020:00:00:00,UFU SANTOJANNI,12,5,10,6,1,17,17,0,17,0,1,0,1,3,9,2,1,0,0,11,4,2,17
20200719,19JUL2020:00:00:00,UFU TORNU,45,36,47,25,9,81,79,2,79,2,2,7,6,19,24,14,7,2,0,24,39,16,79
20200719,19JUL2020:00:00:00,UFU VELEZ SARSFIELD,23,13,28,8,0,36,36,0,36,0,0,3,10,9,5,6,2,1,0,17,7,12,36
20200719,19JUL2020:00:00:00,UFU ZUBIZARRETA,19,23,25,17,0,42,34,8,42,0,0,0,10,4,13,9,6,0,0,8,5,21,34
20200720,20JUL2020:00:00:00,UFU ALVAREZ,43,68,66,41,4,111,87,24,103,8,6,3,28,32,21,15,5,1,0,30,22,35,87
20200720,20JUL2020:00:00:00,UFU ARGERICH,37,36,54,17,2,73,57,16,59,14,1,2,20,13,19,11,5,2,0,26,21,10,57
20200720,20JUL2020:00:00:00,UFU BORDA-MOYANO,62,12,53,21,0,74,72,2,72,2,0,0,5,5,7,24,23,10,0,5,53,14,72
20200720,20JUL2020:00:00:00,UFU DURAND,51,29,59,19,2,80,68,12,70,10,0,0,12,31,21,13,3,0,0,21,35,12,68
20200720,20JUL2020:00:00:00,UFU ELIZALDE,35,25,34,26,0,60,22,38,54,6,33,9,1,6,4,4,3,0,0,3,17,2,22
20200720,20JUL2020:00:00:00,UFU FERNANDEZ,27,24,35,14,2,51,47,4,51,0,0,0,10,9,13,9,5,5,0,20,17,10,47
20200720,20JUL2020:00:00:00,UFU FERRER,43,23,42,24,0,66,51,15,51,15,0,0,20,12,17,11,6,0,0,17,27,7,51
20200720,20JUL2020:00:00:00,UFU GRIERSON,8,10,10,8,0,18,18,0,18,0,0,1,4,3,4,2,3,1,0,6,12,0,18
20200720,20JUL2020:00:00:00,UFU GUTIERREZ,12,9,10,11,0,21,19,2,21,0,3,5,4,5,3,0,1,0,0,4,11,4,19
20200720,20JUL2020:00:00:00,UFU MUÑIZ,50,59,66,39,4,109,77,32,93,16,1,0,23,29,26,14,11,5,0,26,29,22,77
20200720,20JUL2020:00:00:00,UFU PENNA,17,13,20,10,0,30,24,6,26,4,2,0,7,10,4,4,3,0,0,11,5,8,24
20200720,20JUL2020:00:00:00,UFU PIROVANO,18,18,21,15,0,36,34,2,36,0,0,0,7,8,14,4,3,0,0,14,16,2,34
20200720,20JUL2020:00:00:00,UFU PIÑERO,49,59,84,17,7,108,78,30,88,20,3,7,27,18,22,20,8,3,0,36,35,7,78
20200720,20JUL2020:00:00:00,UFU RAMOS MEJIA,35,54,75,13,1,89,87,2,87,2,0,0,16,21,26,18,8,0,0,35,30,22,87
20200720,20JUL2020:00:00:00,UFU RIVADAVIA,19,27,24,18,4,46,42,4,42,4,0,0,8,18,11,7,2,0,0,15,14,13,42
20200720,20JUL2020:00:00:00,UFU SANTOJANNI,37,15,29,22,1,52,40,12,50,2,0,1,12,15,16,6,2,0,0,17,21,2,40
20200720,20JUL2020:00:00:00,UFU TORNU,34,27,39,22,0,61,59,2,59,2,1,1,15,16,11,9,6,2,0,22,28,9,59
20200720,20JUL2020:00:00:00,UFU VELEZ SARSFIELD,30,24,31,23,0,54,26,28,54,0,0,0,10,21,8,11,2,2,0,9,7,10,26
20200720,20JUL2020:00:00:00,UFU ZUBIZARRETA,27,19,28,13,5,46,32,14,36,10,2,0,10,5,13,8,7,1,0,9,14,9,32
20200721,21JUL2020:00:00:00,UFU ALVAREZ,54,46,74,22,4,100,90,10,94,6,4,8,18,37,13,14,6,0,0,24,29,37,90
20200721,21JUL2020:00:00:00,UFU ARGERICH,36,55,66,23,2,91,47,44,51,40,0,4,24,28,13,14,6,2,0,22,17,8,47
20200721,21JUL2020:00:00:00,UFU BORDA-MOYANO,18,17,21,14,0,35,3,32,3,32,0,1,5,6,13,6,4,0,0,0,2,1,3
20200721,21JUL2020:00:00:00,UFU DURAND,40,34,52,22,0,74,66,8,66,8,2,2,9,32,9,14,6,0,0,23,35,8,66
20200721,21JUL2020:00:00:00,UFU ELIZALDE,16,17,14,19,0,33,9,24,31,2,22,10,0,0,0,0,1,0,0,4,4,1,9
20200721,21JUL2020:00:00:00,UFU FERNANDEZ,24,24,35,13,0,48,38,10,48,0,0,2,8,14,8,10,5,1,0,15,12,11,38
20200721,21JUL2020:00:00:00,UFU FERRER,29,32,29,32,0,61,39,22,39,22,0,0,11,27,6,16,1,0,0,19,17,3,39
20200721,21JUL2020:00:00:00,UFU GRIERSON,7,5,11,1,0,12,12,0,12,0,0,0,5,5,2,0,0,0,0,1,10,1,12
20200721,21JUL2020:00:00:00,UFU GUTIERREZ,17,10,15,11,1,27,21,6,21,6,12,0,4,4,5,1,1,0,0,2,15,4,21
20200721,21JUL2020:00:00:00,UFU MUÑIZ,52,49,60,40,1,101,81,20,85,16,2,9,26,22,21,10,7,4,0,22,38,21,81
20200721,21JUL2020:00:00:00,UFU PENNA,12,6,15,3,0,18,10,8,16,2,0,0,1,1,8,6,2,0,0,5,3,2,10
20200721,21JUL2020:00:00:00,UFU PIROVANO,14,15,24,5,0,29,25,4,27,2,0,2,9,8,4,5,1,0,0,9,12,4,25
20200721,21JUL2020:00:00:00,UFU PIÑERO,52,53,67,36,2,105,87,18,91,14,5,1,33,26,18,16,5,1,0,26,49,12,87
20200721,21JUL2020:00:00:00,UFU RAMOS MEJIA,51,38,66,21,2,89,73,16,75,14,2,6,13,19,20,24,5,0,0,31,27,15,73
20200721,21JUL2020:00:00:00,UFU RIVADAVIA,22,23,26,17,2,45,41,4,41,4,0,0,12,7,10,11,3,2,0,17,13,9,41
20200721,21JUL2020:00:00:00,UFU SANTOJANNI,39,26,36,27,2,65,51,14,61,4,2,2,11,20,10,14,6,0,0,26,22,3,51
20200721,21JUL2020:00:00:00,UFU TORNU,49,36,62,22,1,85,81,4,83,2,3,4,10,16,25,12,14,1,0,22,37,20,81
20200721,21JUL2020:00:00:00,UFU VELEZ SARSFIELD,26,19,24,21,0,45,37,8,43,2,0,2,9,7,15,8,2,2,0,14,7,16,37
20200721,21JUL2020:00:00:00,UFU ZUBIZARRETA,24,35,40,17,2,59,33,26,47,12,2,0,7,17,19,4,8,2,0,16,8,8,33
20200722,22JUL2020:00:00:00,UFU ALVAREZ,37,50,73,10,4,87,81,6,81,6,1,0,21,26,11,12,14,2,0,28,17,36,81
20200722,22JUL2020:00:00:00,UFU ARGERICH,52,54,76,30,0,106,74,32,82,24,7,4,25,24,21,14,10,1,0,32,28,14,74
20200722,22JUL2020:00:00:00,UFU BORDA-MOYANO,32,15,25,22,0,47,45,2,45,2,0,1,6,13,9,12,6,0,0,7,28,10,45
20200722,22JUL2020:00:00:00,UFU DURAND,57,40,74,23,0,97,75,22,77,20,5,0,18,29,12,23,10,0,0,23,41,11,75
20200722,22JUL2020:00:00:00,UFU ELIZALDE,20,18,22,16,0,38,24,14,36,2,19,10,0,4,3,0,2,0,0,2,15,7,24
20200722,22JUL2020:00:00:00,UFU FERNANDEZ,19,14,24,7,2,33,31,2,31,2,0,2,5,7,6,6,6,1,0,6,21,4,31
20200722,22JUL2020:00:00:00,UFU FERRER,27,26,28,25,0,53,37,16,37,16,0,0,16,13,13,3,8,0,0,17,14,6,37
20200722,22JUL2020:00:00:00,UFU GRIERSON,12,13,19,4,2,25,25,0,25,0,0,2,4,3,6,6,3,1,0,3,17,5,25
20200722,22JUL2020:00:00:00,UFU GUTIERREZ,23,14,21,16,0,37,35,2,37,0,11,5,7,9,2,3,0,0,0,1,29,4,35
20200722,22JUL2020:00:00:00,UFU MUÑIZ,41,58,58,41,0,99,69,30,95,4,0,2,17,29,23,10,10,8,0,23,37,9,69
20200722,22JUL2020:00:00:00,UFU PENNA,14,12,20,6,0,26,16,10,24,2,0,0,4,9,5,6,2,0,0,6,9,1,16
20200722,22JUL2020:00:00:00,UFU PIROVANO,22,18,23,17,0,40,40,0,40,0,0,2,11,10,7,8,2,0,0,18,17,4,40
20200722,22JUL2020:00:00:00,UFU PIÑERO,59,57,97,10,9,116,92,24,96,20,0,11,31,30,22,16,4,2,0,38,37,13,92
20200722,22JUL2020:00:00:00,UFU RAMOS MEJIA,37,32,57,12,0,69,61,8,61,8,0,4,16,21,12,7,7,2,0,29,22,10,61
20200722,22JUL2020:00:00:00,UFU RIVADAVIA,42,37,47,26,6,79,67,12,69,10,0,1,20,21,14,7,12,4,0,19,29,17,67
20200722,22JUL2020:00:00:00,UFU SANTOJANNI,45,21,31,35,0,66,42,24,54,12,3,2,13,16,12,11,7,2,0,18,20,4,42
20200722,22JUL2020:00:00:00,UFU TORNU,48,43,65,26,0,91,79,12,81,10,3,9,18,27,10,14,8,2,0,20,36,22,79
20200722,22JUL2020:00:00:00,UFU VELEZ SARSFIELD,25,8,14,19,0,33,29,4,33,0,0,2,2,9,13,4,3,0,0,9,8,12,29
20200722,22JUL2020:00:00:00,UFU ZUBIZARRETA,60,25,39,46,0,85,55,30,61,24,0,0,7,21,30,20,7,0,0,16,3,36,55
20200723,23JUL2020:00:00:00,UFU ALVAREZ,24,31,48,7,0,55,51,4,51,4,2,8,11,14,6,10,4,0,0,17,12,22,51
20200723,23JUL2020:00:00:00,UFU ARGERICH,64,49,92,19,2,113,77,36,77,36,10,5,25,17,18,13,19,6,0,41,13,23,77
20200723,23JUL2020:00:00:00,UFU BORDA-MOYANO,8,9,10,7,0,17,17,0,17,0,0,0,1,2,6,6,2,0,0,1,13,3,17
20200723,23JUL2020:00:00:00,UFU DURAND,56,33,60,29,0,89,69,20,71,18,1,5,18,27,20,11,5,2,0,27,33,9,69
20200723,23JUL2020:00:00:00,UFU ELIZALDE,24,14,20,18,0,38,28,10,34,4,17,5,0,6,3,7,0,0,0,1,7,20,28
20200723,23JUL2020:00:00:00,UFU FERNANDEZ,26,27,39,14,0,53,47,6,53,0,0,2,12,16,6,12,5,0,0,22,16,8,47
20200723,23JUL2020:00:00:00,UFU FERRER,45,47,39,51,2,92,68,24,68,24,0,2,11,26,29,19,5,0,0,17,26,25,68
20200723,23JUL2020:00:00:00,UFU GRIERSON,6,15,12,9,0,21,17,4,21,0,0,0,4,5,8,4,0,0,0,6,9,2,17
20200723,23JUL2020:00:00:00,UFU GUTIERREZ,18,10,23,5,0,28,28,0,28,0,11,1,3,5,3,4,1,0,0,2,15,9,28
20200723,23JUL2020:00:00:00,UFU MUÑIZ,59,54,77,33,3,113,71,42,93,20,0,1,20,32,28,19,8,5,0,20,42,9,71
20200723,23JUL2020:00:00:00,UFU PENNA,5,10,15,0,0,15,15,0,15,0,0,0,2,5,8,0,0,0,0,4,6,5,15
20200723,23JUL2020:00:00:00,UFU PIROVANO,29,23,40,12,0,52,46,6,50,2,0,5,5,10,21,7,4,0,0,10,24,12,46
20200723,23JUL2020:00:00:00,UFU PIÑERO,43,47,62,21,7,90,38,52,40,50,1,6,28,19,18,10,5,3,0,15,22,1,38
20200723,23JUL2020:00:00:00,UFU RAMOS MEJIA,44,41,64,19,2,85,77,8,77,8,2,0,29,28,10,7,7,2,0,31,34,12,77
20200723,23JUL2020:00:00:00,UFU RIVADAVIA,29,24,27,21,5,53,49,4,49,4,0,0,12,30,5,3,3,0,0,12,26,10,49
20200723,23JUL2020:00:00:00,UFU SANTOJANNI,34,27,36,21,4,61,55,6,55,6,7,3,8,16,11,15,1,0,0,25,24,6,55
20200723,23JUL2020:00:00:00,UFU TORNU,45,28,56,12,5,73,63,10,65,8,1,3,26,16,14,11,1,1,0,31,17,15,63
20200723,23JUL2020:00:00:00,UFU VELEZ SARSFIELD,13,26,28,11,0,39,29,10,37,2,0,0,1,5,12,18,3,0,0,7,13,9,29
20200723,23JUL2020:00:00:00,UFU ZUBIZARRETA,37,25,40,22,0,62,52,10,56,6,0,2,8,18,18,10,4,2,0,12,24,15,52
20200724,24JUL2020:00:00:00,UFU ALVAREZ,27,18,39,6,0,45,41,4,41,4,2,3,7,16,0,10,4,3,0,12,11,18,41
20200724,24JUL2020:00:00:00,UFU ARGERICH,49,44,71,20,2,93,71,22,73,20,6,7,21,22,16,15,4,2,0,31,25,15,71
20200724,24JUL2020:00:00:00,UFU BORDA-MOYANO,60,11,58,11,2,71,65,6,65,6,0,0,2,6,10,19,24,10,0,6,43,16,65
20200724,24JUL2020:00:00:00,UFU DURAND,63,25,70,15,3,88,66,22,68,20,1,0,9,23,27,18,8,2,0,22,39,5,66
20200724,24JUL2020:00:00:00,UFU ELIZALDE,22,31,20,30,3,53,21,32,39,14,26,15,1,5,2,2,2,0,0,2,15,4,21
20200724,24JUL2020:00:00:00,UFU FERNANDEZ,26,20,36,9,1,46,38,8,44,2,0,0,8,14,8,6,9,1,0,18,14,6,38
20200724,24JUL2020:00:00:00,UFU FERRER,32,39,27,44,0,71,49,22,49,22,0,2,16,17,14,10,10,2,0,17,21,11,49
20200724,24JUL2020:00:00:00,UFU GRIERSON,11,13,22,2,0,24,18,6,22,2,2,0,9,3,6,4,0,0,0,6,10,2,18
20200724,24JUL2020:00:00:00,UFU GUTIERREZ,35,15,35,15,0,50,48,2,48,2,9,9,11,14,5,0,2,0,0,6,31,10,48
20200724,24JUL2020:00:00:00,UFU MUÑIZ,48,58,79,26,1,106,68,38,80,26,0,1,21,32,20,16,6,10,0,20,31,17,68
20200724,24JUL2020:00:00:00,UFU PENNA,18,17,29,5,1,35,27,8,33,2,0,1,9,9,8,4,4,0,0,12,9,6,27
20200724,24JUL2020:00:00:00,UFU PIROVANO,13,23,29,5,2,36,34,2,34,2,0,0,9,6,5,11,2,3,0,10,15,8,34
20200724,24JUL2020:00:00:00,UFU PIÑERO,45,32,58,14,5,77,63,14,69,8,2,3,17,26,15,9,3,2,0,32,23,8,63
20200724,24JUL2020:00:00:00,UFU RAMOS MEJIA,38,38,66,10,0,76,72,4,72,4,0,1,21,21,17,8,7,1,0,37,23,12,72
20200724,24JUL2020:00:00:00,UFU RIVADAVIA,35,44,32,34,13,79,69,10,75,4,0,0,21,26,13,16,1,2,0,17,30,20,69
20200724,24JUL2020:00:00:00,UFU SANTOJANNI,29,20,36,11,2,49,45,4,47,2,3,0,7,16,8,5,10,0,0,25,17,3,45
20200724,24JUL2020:00:00:00,UFU TORNU,62,71,103,24,6,133,107,26,111,22,3,13,27,29,35,12,8,6,0,26,50,31,107
20200724,24JUL2020:00:00:00,UFU VELEZ SARSFIELD,24,30,34,20,0,54,44,10,52,2,0,0,9,18,9,7,9,2,0,10,16,18,44
20200724,24JUL2020:00:00:00,UFU ZUBIZARRETA,44,28,30,42,0,72,64,8,64,8,0,0,17,27,16,9,2,1,0,21,19,23,64
20200725,25JUL2020:00:00:00,UFU ALVAREZ,33,15,36,4,8,48,40,8,40,8,4,1,13,15,9,4,2,0,0,9,10,21,40
20200725,25JUL2020:00:00:00,UFU ARGERICH,30,26,36,19,1,56,50,6,50,6,1,7,12,11,6,8,4,7,0,31,5,14,50
20200725,25JUL2020:00:00:00,UFU BORDA-MOYANO,5,0,5,0,0,5,5,0,5,0,0,0,0,2,1,2,0,0,0,1,4,0,5
20200725,25JUL2020:00:00:00,UFU DURAND,37,23,47,13,0,60,56,4,56,4,1,4,11,24,10,4,3,3,0,21,24,11,56
20200725,25JUL2020:00:00:00,UFU ELIZALDE,5,10,11,4,0,15,13,2,15,0,9,6,0,0,0,0,0,0,0,1,8,4,13
20200725,25JUL2020:00:00:00,UFU FERNANDEZ,19,11,26,3,1,30,24,6,24,6,0,2,4,10,11,1,1,1,0,11,10,2,24
20200725,25JUL2020:00:00:00,UFU FERRER,22,26,18,19,11,48,36,12,38,10,0,0,10,18,13,4,2,1,0,12,13,11,36
20200725,25JUL2020:00:00:00,UFU GRIERSON,6,6,5,7,0,12,12,0,12,0,0,0,3,4,3,2,0,0,0,6,6,0,12
20200725,25JUL2020:00:00:00,UFU GUTIERREZ,21,10,20,11,0,31,29,2,29,2,6,2,6,8,4,0,5,0,0,7,17,5,29
20200725,25JUL2020:00:00:00,UFU MUÑIZ,47,50,55,40,2,97,73,24,75,22,1,1,19,21,26,15,12,2,0,27,39,7,73
20200725,25JUL2020:00:00:00,UFU PENNA,22,13,22,10,3,35,33,2,35,0,0,0,2,14,6,10,3,0,0,11,18,4,33
20200725,25JUL2020:00:00:00,UFU PIROVANO,11,26,23,8,6,37,29,8,33,4,0,1,8,11,7,8,2,0,0,7,12,9,29
20200725,25JUL2020:00:00:00,UFU PIÑERO,30,40,46,22,2,70,62,8,62,8,0,1,17,20,19,8,4,1,0,33,25,4,62
20200725,25JUL2020:00:00:00,UFU RAMOS MEJIA,32,27,52,4,3,59,42,17,42,17,6,4,15,12,7,6,8,1,0,26,6,10,42
20200725,25JUL2020:00:00:00,UFU RIVADAVIA,13,13,18,7,1,26,20,6,22,4,0,0,3,8,7,0,8,0,0,6,10,3,20
20200725,25JUL2020:00:00:00,UFU SANTOJANNI,15,7,12,10,0,22,22,0,22,0,1,2,4,4,4,3,4,0,0,11,9,2,22
20200725,25JUL2020:00:00:00,UFU TORNU,27,32,33,24,2,59,59,0,59,0,2,5,24,13,7,8,0,0,0,24,27,8,59
20200725,25JUL2020:00:00:00,UFU VELEZ SARSFIELD,22,24,33,13,0,46,34,12,46,0,0,0,12,8,14,7,1,4,0,8,11,15,34
20200725,25JUL2020:00:00:00,UFU ZUBIZARRETA,14,30,25,15,4,44,26,18,34,10,2,1,3,14,9,9,4,2,0,8,15,3,26
20200726,26JUL2020:00:00:00,UFU ALVAREZ,20,20,33,7,0,40,34,6,34,6,7,4,14,6,2,5,2,0,0,10,12,12,34
20200726,26JUL2020:00:00:00,UFU ARGERICH,23,15,21,17,0,38,32,6,34,4,1,3,11,5,5,3,10,0,0,13,13,6,32
20200726,26JUL2020:00:00:00,UFU BORDA-MOYANO,7,21,14,13,1,28,26,2,26,2,0,0,2,6,7,9,4,0,0,6,18,2,26
20200729,29JUL2020:00:00:00,UFU TORNU,24,35,48,11,0,59,25,34,27,32,1,4,14,18,11,8,1,2,0,7,13,5,25
20200729,29JUL2020:00:00:00,UFU VELEZ SARSFIELD,19,14,24,9,0,33,31,2,33,0,0,0,9,14,6,3,1,0,0,7,12,12,31
20200729,29JUL2020:00:00:00,UFU ZUBIZARRETA,26,22,25,21,2,48,32,16,34,14,3,0,20,3,17,5,0,0,0,2,22,8,32
20200730,30JUL2020:00:00:00,UFU ALVAREZ,33,41,63,9,2,74,68,6,70,4,4,9,14,20,14,8,2,3,0,21,19,28,68
20200730,30JUL2020:00:00:00,UFU ARGERICH,32,36,46,20,2,68,52,16,54,14,5,0,9,28,13,10,0,3,0,16,9,27,52
20200730,30JUL2020:00:00:00,UFU BORDA-MOYANO,57,28,66,18,1,85,69,16,69,16,0,0,10,13,17,11,18,16,0,8,43,18,69
20200730,30JUL2020:00:00:00,UFU DURAND,35,44,65,14,0,79,73,6,75,4,0,2,10,27,17,15,8,0,0,34,24,15,73
20200730,30JUL2020:00:00:00,UFU ELIZALDE,24,21,15,30,0,45,7,38,39,6,21,17,2,2,2,0,1,0,0,0,5,2,7
20200730,30JUL2020:00:00:00,UFU FERNANDEZ,34,37,58,13,0,71,65,6,69,2,2,3,14,30,8,10,4,0,0,17,22,26,65
20200730,30JUL2020:00:00:00,UFU FERRER,39,35,36,34,4,74,58,16,58,16,0,0,15,22,26,8,3,0,0,25,19,14,58
20200730,30JUL2020:00:00:00,UFU GRIERSON,9,7,9,7,0,16,16,0,16,0,0,1,4,4,3,3,1,0,0,5,11,0,16
20200730,30JUL2020:00:00:00,UFU GUTIERREZ,33,15,34,14,0,48,46,2,48,0,10,8,2,11,8,6,3,0,0,13,17,16,46
20200730,30JUL2020:00:00:00,UFU MUÑIZ,61,83,78,64,2,144,78,66,88,56,0,3,31,32,29,29,12,8,0,25,41,12,78
20200730,30JUL2020:00:00:00,UFU PENNA,17,12,20,9,0,29,23,6,27,2,0,0,0,11,11,3,3,1,0,9,11,3,23
20200730,30JUL2020:00:00:00,UFU PIROVANO,16,14,25,5,0,30,24,6,28,2,3,0,4,4,12,4,1,2,0,5,17,2,24
20200730,30JUL2020:00:00:00,UFU PIÑERO,54,93,100,33,14,147,117,30,127,20,13,5,35,34,29,14,12,5,0,44,41,31,117
20200730,30JUL2020:00:00:00,UFU RAMOS MEJIA,47,38,68,16,1,85,73,12,75,10,2,5,20,29,13,11,5,0,0,25,31,17,73
20200730,30JUL2020:00:00:00,UFU RIVADAVIA,37,35,39,30,3,72,62,10,62,10,0,0,15,29,7,13,5,3,0,15,33,14,62
20200730,30JUL2020:00:00:00,UFU SANTOJANNI,32,31,37,25,1,63,51,12,59,4,5,1,13,24,9,6,3,2,0,31,14,6,51
20200730,30JUL2020:00:00:00,UFU TORNU,38,44,64,18,0,82,70,12,72,10,5,3,24,17,12,10,9,2,0,9,37,24,70
20200730,30JUL2020:00:00:00,UFU VELEZ SARSFIELD,29,14,19,24,0,43,41,2,43,0,0,0,13,11,10,9,0,0,0,6,17,18,41
20200730,30JUL2020:00:00:00,UFU ZUBIZARRETA,38,25,31,30,2,63,47,16,49,14,2,2,20,10,15,10,4,0,0,15,16,16,47
20200731,31JUL2020:00:00:00,UFU ALVAREZ,45,42,63,22,2,87,73,14,77,10,9,3,14,14,26,10,9,2,0,38,9,26,73
20200731,31JUL2020:00:00:00,UFU ARGERICH,50,53,68,33,2,103,67,36,69,34,7,6,20,24,22,13,10,1,0,24,22,21,67
20200731,31JUL2020:00:00:00,UFU BORDA-MOYANO,60,9,50,17,2,69,63,6,63,6,0,0,3,11,17,22,12,4,0,3,42,18,63
20200731,31JUL2020:00:00:00,UFU DURAND,51,55,85,21,0,106,100,6,104,2,7,8,19,31,20,13,8,0,0,29,43,28,100
20200731,31JUL2020:00:00:00,UFU ELIZALDE,35,9,17,24,3,44,29,15,35,9,21,10,1,8,2,0,2,0,0,3,16,10,29
20200731,31JUL2020:00:00:00,UFU FERNANDEZ,24,21,34,9,2,45,33,12,45,0,0,0,9,19,14,3,0,0,0,11,10,12,33
20200731,31JUL2020:00:00:00,UFU FERRER,50,35,34,51,0,85,69,16,69,16,1,4,22,11,26,16,4,1,0,23,29,17,69
20200731,31JUL2020:00:00:00,UFU GRIERSON,14,12,18,8,0,26,24,2,26,0,0,2,4,11,2,7,0,0,0,5,19,0,24
20200731,31JUL2020:00:00:00,UFU GUTIERREZ,30,10,25,15,0,40,38,2,40,0,9,2,4,10,7,5,3,0,0,4,28,6,38
20200731,31JUL2020:00:00:00,UFU MUÑIZ,45,62,54,53,0,107,89,18,93,14,0,0,19,36,17,25,7,3,0,31,41,17,89
20200731,31JUL2020:00:00:00,UFU PENNA,26,30,28,22,6,56,52,4,54,2,0,3,13,12,14,9,5,0,0,15,27,10,52
20200731,31JUL2020:00:00:00,UFU PIROVANO,22,18,23,17,0,40,36,4,38,2,0,0,6,11,11,10,0,2,0,6,24,4,36
20200731,31JUL2020:00:00:00,UFU PIÑERO,58,70,93,29,6,128,104,24,114,14,7,13,23,37,28,11,5,4,0,31,48,25,104
20200731,31JUL2020:00:00:00,UFU RAMOS MEJIA,38,49,61,23,3,87,79,8,81,6,0,1,22,21,26,8,5,4,0,22,30,27,79
20200731,31JUL2020:00:00:00,UFU RIVADAVIA,62,45,60,37,10,107,101,6,103,4,4,2,17,46,24,9,2,3,0,19,56,26,101
20200731,31JUL2020:00:00:00,UFU SANTOJANNI,32,29,46,15,0,61,41,20,55,6,5,6,15,18,6,6,3,2,0,18,22,1,41
20200731,31JUL2020:00:00:00,UFU TORNU,46,33,50,18,11,79,69,10,69,10,4,3,15,15,16,18,6,2,0,18,32,19,69
20200731,31JUL2020:00:00:00,UFU VELEZ SARSFIELD,35,28,37,26,0,63,47,16,63,0,0,2,19,13,12,10,5,2,0,16,13,18,47
20200731,31JUL2020:00:00:00,UFU ZUBIZARRETA,33,20,30,23,0,53,29,24,31,22,2,0,12,18,3,9,6,3,0,8,12,9,29
20200801,01AUG2020:00:00:00,UFU ALVAREZ,16,15,27,4,0,31,27,4,27,4,0,4,6,10,2,4,4,1,0,7,10,10,27
20200801,01AUG2020:00:00:00,UFU ARGERICH,25,20,31,12,2,45,33,12,33,12,2,2,13,5,7,10,5,1,0,17,14,2,33
20200801,01AUG2020:00:00:00,UFU BORDA-MOYANO,20,3,10,12,1,23,23,0,23,0,0,0,5,3,5,7,3,0,0,5,14,4,23
20200801,01AUG2020:00:00:00,UFU DURAND,30,17,43,4,0,47,41,6,45,2,2,2,16,12,5,9,1,0,0,23,11,7,41
20200801,01AUG2020:00:00:00,UFU ELIZALDE,7,8,4,11,0,15,13,2,15,0,15,0,0,0,0,0,0,0,0,2,7,4,13
20200801,01AUG2020:00:00:00,UFU FERNANDEZ,19,20,34,5,0,39,39,0,39,0,0,1,13,11,10,4,0,0,0,16,16,7,39
20200801,01AUG2020:00:00:00,UFU FERRER,38,36,40,34,0,74,50,24,50,24,0,0,23,18,22,6,3,2,0,19,24,7,50
20200801,01AUG2020:00:00:00,UFU GRIERSON,8,12,10,10,0,20,18,2,20,0,0,1,6,5,2,2,4,0,0,6,10,2,18
20200801,01AUG2020:00:00:00,UFU GUTIERREZ,10,4,5,9,0,14,14,0,14,0,4,0,4,2,2,2,0,0,0,1,10,3,14
20200801,01AUG2020:00:00:00,UFU MUÑIZ,53,60,64,49,0,113,89,24,91,22,8,1,28,28,26,11,4,7,0,32,34,23,89
20200801,01AUG2020:00:00:00,UFU PENNA,12,15,18,9,0,27,21,6,25,2,0,0,4,11,2,8,0,2,0,6,12,3,21
20200801,01AUG2020:00:00:00,UFU PIROVANO,17,16,26,7,0,33,31,2,31,2,0,1,3,7,14,5,1,2,0,9,14,6,31
20200801,01AUG2020:00:00:00,UFU PIÑERO,30,35,48,15,2,65,61,4,63,2,0,1,9,28,14,7,5,1,0,20,30,11,61
20200801,01AUG2020:00:00:00,UFU RAMOS MEJIA,27,40,54,13,0,67,55,12,55,12,4,7,11,10,12,16,7,0,0,26,19,10,55
20200801,01AUG2020:00:00:00,UFU RIVADAVIA,22,15,23,11,3,37,31,6,31,6,0,0,8,16,7,4,2,0,0,9,20,2,31
20200801,01AUG2020:00:00:00,UFU SANTOJANNI,12,3,11,4,0,15,11,4,15,0,0,5,0,3,2,4,1,0,0,3,8,0,11
20200801,01AUG2020:00:00:00,UFU TORNU,32,21,27,24,2,53,47,6,51,2,5,13,8,13,10,3,1,0,0,27,13,7,47
20200801,01AUG2020:00:00:00,UFU VELEZ SARSFIELD,26,21,35,12,0,47,39,8,47,0,0,0,5,16,13,8,4,1,0,13,7,19,39
20200801,01AUG2020:00:00:00,UFU ZUBIZARRETA,18,15,24,8,1,33,19,14,29,4,3,4,4,9,3,5,5,0,0,13,4,1,19
20200802,02AUG2020:00:00:00,UFU ALVAREZ,19,8,27,0,0,27,17,10,17,10,6,2,8,8,3,0,0,0,0,8,2,7,17
20200802,02AUG2020:00:00:00,UFU ARGERICH,13,31,32,12,0,44,32,12,32,12,0,2,4,9,6,9,8,6,0,17,8,7,32
20200802,02AUG2020:00:00:00,UFU BORDA-MOYANO,2,3,2,3,0,5,5,0,5,0,0,0,1,0,1,1,1,1,0,0,5,0,5
20200802,02AUG2020:00:00:00,UFU DURAND,50,26,65,11,0,76,68,8,74,2,2,2,14,23,12,11,7,5,0,41,20,7,68
20200802,02AUG2020:00:00:00,UFU ELIZALDE,13,10,11,12,0,23,13,10,19,4,15,6,0,2,0,0,0,0,0,3,9,1,13
20200802,02AUG2020:00:00:00,UFU FERNANDEZ,21,27,43,5,0,48,46,2,48,0,0,2,10,13,9,8,4,2,0,19,12,15,46
20200802,02AUG2020:00:00:00,UFU FERRER,22,23,23,22,0,45,43,2,43,2,0,0,18,10,8,4,4,1,0,19,17,7,43
20200802,02AUG2020:00:00:00,UFU GRIERSON,6,6,10,2,0,12,12,0,12,0,0,0,2,5,2,1,2,0,0,6,5,1,12
20200802,02AUG2020:00:00:00,UFU GUTIERREZ,17,10,11,16,0,27,23,4,27,0,6,4,2,11,2,1,1,0,0,2,16,3,23
20200802,02AUG2020:00:00:00,UFU MUÑIZ,32,34,49,17,0,66,34,32,48,18,0,3,5,14,20,17,7,0,0,9,22,3,34
20200802,02AUG2020:00:00:00,UFU PENNA,28,16,32,12,0,44,26,18,40,4,1,2,9,8,8,11,5,0,0,12,12,2,26
20200802,02AUG2020:00:00:00,UFU PIROVANO,10,15,17,8,0,25,15,10,23,2,2,2,1,10,6,2,2,0,0,6,7,2,15
20200802,02AUG2020:00:00:00,UFU PIÑERO,34,33,41,25,1,67,51,16,57,10,3,3,15,20,9,10,7,0,0,16,23,11,51
20200802,02AUG2020:00:00:00,UFU RAMOS MEJIA,18,21,27,12,0,39,35,4,35,4,0,2,6,12,5,3,7,4,0,16,11,8,35
20200802,02AUG2020:00:00:00,UFU RIVADAVIA,33,25,42,15,1,58,56,2,56,2,1,0,16,29,7,2,3,0,0,9,30,16,56
20200802,02AUG2020:00:00:00,UFU SANTOJANNI,16,12,18,8,2,28,18,10,26,2,1,1,5,7,6,7,1,0,0,8,10,0,18
20200802,02AUG2020:00:00:00,UFU TORNU,44,36,37,42,1,80,40,40,80,0,2,5,16,17,16,19,5,0,0,17,16,7,40
20200802,02AUG2020:00:00:00,UFU VELEZ SARSFIELD,23,17,31,9,0,40,34,6,40,0,0,0,10,13,3,5,7,2,0,11,9,14,34
20200802,02AUG2020:00:00:00,UFU ZUBIZARRETA,22,15,16,21,0,37,21,16,29,8,4,0,8,20,3,1,1,0,0,7,7,7,21
20200803,03AUG2020:00:00:00,UFU ALVAREZ,16,32,27,19,2,48,30,18,40,8,0,0,16,9,10,8,5,0,0,5,11,14,30
20200803,03AUG2020:00:00:00,UFU ARGERICH,36,32,40,20,8,68,50,18,50,18,3,1,18,13,17,8,6,2,0,29,17,4,50
20200803,03AUG2020:00:00:00,UFU BORDA-MOYANO,14,34,15,32,1,48,46,2,46,2,0,3,14,10,16,5,0,0,0,9,26,11,46
20200803,03AUG2020:00:00:00,UFU DURAND,47,27,57,17,0,74,68,6,68,6,3,4,13,25,11,10,7,1,0,38,24,6,68
20200803,03AUG2020:00:00:00,UFU ELIZALDE,19,14,22,11,0,33,23,10,27,6,23,3,1,3,2,0,1,0,0,2,17,4,23
20200803,03AUG2020:00:00:00,UFU FERNANDEZ,32,25,35,22,0,57,53,4,57,0,0,0,8,17,10,9,7,6,0,26,17,10,53
20200803,03AUG2020:00:00:00,UFU FERRER,47,31,31,47,0,78,58,20,58,20,0,0,20,18,18,13,7,2,0,21,32,5,58
20200803,03AUG2020:00:00:00,UFU GRIERSON,14,8,11,11,0,22,22,0,22,0,1,1,2,8,7,2,1,0,0,8,12,2,22
20200803,03AUG2020:00:00:00,UFU GUTIERREZ,27,16,26,17,0,43,39,4,43,0,11,9,1,11,7,1,3,0,0,4,25,10,39
20200803,03AUG2020:00:00:00,UFU MUÑIZ,44,63,57,50,0,107,71,36,85,22,1,1,19,32,27,17,7,3,0,28,31,12,71
20200803,03AUG2020:00:00:00,UFU PENNA,22,15,22,15,0,37,31,6,35,2,0,1,5,11,10,6,4,0,0,6,18,7,31
20200803,03AUG2020:00:00:00,UFU PIROVANO,22,10,23,8,1,32,30,2,30,2,1,1,4,13,8,2,2,1,0,8,20,2,30
20200803,03AUG2020:00:00:00,UFU PIÑERO,57,55,74,36,2,112,74,38,90,22,0,11,15,35,22,15,12,2,0,31,34,8,74
20200803,03AUG2020:00:00:00,UFU RAMOS MEJIA,48,38,71,13,2,86,78,8,82,4,1,1,18,25,18,10,10,3,0,45,20,13,78
20200803,03AUG2020:00:00:00,UFU RIVADAVIA,36,53,54,30,5,89,81,8,85,4,0,0,20,18,21,18,6,6,0,28,33,20,81
20200803,03AUG2020:00:00:00,UFU SANTOJANNI,31,37,38,30,0,68,64,4,66,2,1,3,15,13,9,13,13,1,0,37,24,3,64
20200803,03AUG2020:00:00:00,UFU TORNU,59,56,98,16,1,115,103,12,103,12,8,7,28,32,14,20,4,2,0,40,36,27,103
20200803,03AUG2020:00:00:00,UFU VELEZ SARSFIELD,28,19,24,23,0,47,43,4,45,2,0,0,9,10,11,13,4,0,0,18,9,16,43
20200803,03AUG2020:00:00:00,UFU ZUBIZARRETA,31,31,35,23,4,62,48,14,54,8,0,3,13,20,12,5,5,4,0,10,12,25,48
20200804,04AUG2020:00:00:00,UFU ALVAREZ,22,37,49,8,2,59,49,10,53,6,5,5,14,14,11,8,0,2,0,16,17,16,49
20200804,04AUG2020:00:00:00,UFU ARGERICH,31,29,34,26,0,60,38,22,40,20,2,1,7,14,10,16,7,3,0,16,17,5,38
20200804,04AUG2020:00:00:00,UFU BORDA-MOYANO,20,27,28,17,2,47,5,42,5,42,0,0,0,15,12,10,6,4,0,4,1,0,5
20200804,04AUG2020:00:00:00,UFU DURAND,41,23,53,11,0,64,54,10,60,4,3,1,12,20,16,8,3,1,0,20,28,6,54
20200804,04AUG2020:00:00:00,UFU ELIZALDE,26,21,16,31,0,47,15,32,39,8,25,13,0,5,2,0,2,0,0,3,8,4,15
20200804,04AUG2020:00:00:00,UFU FERNANDEZ,23,30,42,11,0,53,49,4,53,0,0,1,17,12,7,6,7,3,0,12,27,10,49
20200804,04AUG2020:00:00:00,UFU FERRER,28,45,33,40,0,73,61,12,61,12,0,0,15,21,25,6,4,2,0,25,28,8,61
20200804,04AUG2020:00:00:00,UFU GRIERSON,13,9,14,8,0,22,22,0,22,0,0,2,3,6,6,5,0,0,0,10,12,0,22
20200804,04AUG2020:00:00:00,UFU GUTIERREZ,24,16,15,25,0,40,32,8,36,4,13,6,6,10,5,0,0,0,0,5,21,5,32
20200804,04AUG2020:00:00:00,UFU MUÑIZ,55,57,69,41,2,112,88,24,92,20,0,3,14,36,24,20,11,4,0,25,44,19,88
20200804,04AUG2020:00:00:00,UFU PENNA,15,13,23,5,0,28,24,4,26,2,0,1,5,7,4,10,1,0,0,8,10,6,24
20200804,04AUG2020:00:00:00,UFU PIROVANO,19,22,34,7,0,41,41,0,41,0,0,1,9,12,8,8,1,2,0,8,23,9,41
20200804,04AUG2020:00:00:00,UFU PIÑERO,33,64,75,19,3,97,77,20,83,14,1,4,16,34,24,11,6,1,0,25,34,18,77
20200804,04AUG2020:00:00:00,UFU RAMOS MEJIA,45,58,73,22,8,103,87,16,87,16,8,8,27,23,12,13,7,5,0,46,22,19,87
20200804,04AUG2020:00:00:00,UFU RIVADAVIA,22,29,27,22,2,51,45,6,45,6,0,0,13,18,4,6,7,3,0,18,18,9,45
20200804,04AUG2020:00:00:00,UFU SANTOJANNI,37,39,35,39,2,76,66,10,74,2,3,3,18,21,12,16,3,0,0,29,31,6,66
20200804,04AUG2020:00:00:00,UFU TORNU,49,47,82,14,0,96,78,18,88,8,6,4,22,16,21,24,1,2,0,30,28,20,78
20200804,04AUG2020:00:00:00,UFU VELEZ SARSFIELD,25,21,22,22,2,46,40,6,46,0,0,0,14,10,15,7,0,0,0,12,12,16,40
20200804,04AUG2020:00:00:00,UFU ZUBIZARRETA,20,15,22,13,0,35,23,12,27,8,2,0,3,6,5,15,4,0,0,5,11,7,23
20200805,05AUG2020:00:00:00,UFU ALVAREZ,30,19,34,12,3,49,43,6,45,4,2,2,15,12,4,7,6,1,0,10,7,26,43
20200805,05AUG2020:00:00:00,UFU ARGERICH,43,37,59,20,1,80,58,22,62,18,3,3,15,26,18,9,2,4,0,29,13,16,58
20200805,05AUG2020:00:00:00,UFU BORDA-MOYANO,38,9,32,15,0,47,29,18,29,18,0,0,6,6,9,12,7,7,0,1,22,6,29
20200805,05AUG2020:00:00:00,UFU DURAND,41,25,49,17,0,66,58,8,60,6,0,0,30,22,7,6,1,0,0,23,33,2,58
20200805,05AUG2020:00:00:00,UFU ELIZALDE,26,24,22,26,2,50,10,40,42,8,26,16,2,1,2,2,1,0,0,0,7,3,10
20200805,05AUG2020:00:00:00,UFU FERNANDEZ,25,28,37,16,0,53,47,6,53,0,0,0,11,15,9,10,8,0,0,18,16,13,47
20200805,05AUG2020:00:00:00,UFU FERRER,29,30,30,28,1,59,52,7,52,7,0,0,12,20,11,11,5,0,0,18,26,8,52
20200805,05AUG2020:00:00:00,UFU GRIERSON,17,21,25,13,0,38,34,4,38,0,0,1,13,11,5,3,3,2,0,7,25,2,34
20200805,05AUG2020:00:00:00,UFU GUTIERREZ,18,12,14,16,0,30,30,0,30,0,4,6,4,8,5,1,2,0,0,4,17,9,30
20200805,05AUG2020:00:00:00,UFU MUÑIZ,70,75,84,56,5,145,97,48,115,30,6,4,30,32,28,27,16,2,0,26,56,15,97
20200805,05AUG2020:00:00:00,UFU PENNA,12,8,19,1,0,20,18,2,20,0,0,0,8,9,1,2,0,0,0,6,7,5,18
20200805,05AUG2020:00:00:00,UFU PIROVANO,23,17,22,17,1,40,38,2,40,0,0,0,7,17,8,7,1,0,0,14,17,6,38
20200805,05AUG2020:00:00:00,UFU PIÑERO,53,57,87,20,3,110,86,24,88,22,5,5,19,21,26,14,11,9,0,31,38,15,86
20200805,05AUG2020:00:00:00,UFU RAMOS MEJIA,31,31,51,9,2,62,62,0,62,0,1,1,15,21,10,9,5,0,0,26,27,9,62
20200805,05AUG2020:00:00:00,UFU RIVADAVIA,32,37,33,33,3,69,63,6,67,2,0,0,21,21,17,9,0,1,0,20,33,10,63
20200805,05AUG2020:00:00:00,UFU SANTOJANNI,45,25,37,33,0,70,50,20,66,4,0,1,17,22,14,9,6,1,0,23,25,2,50
20200805,05AUG2020:00:00:00,UFU TORNU,34,33,54,10,3,67,61,6,61,6,1,4,14,16,8,10,9,5,0,15,29,17,61
20200805,05AUG2020:00:00:00,UFU VELEZ SARSFIELD,16,19,24,11,0,35,31,4,35,0,0,0,4,10,7,11,3,0,0,10,9,12,31
20200805,05AUG2020:00:00:00,UFU ZUBIZARRETA,23,23,32,14,0,46,32,14,42,4,3,0,17,10,8,1,5,2,0,5,16,11,32
20200806,06AUG2020:00:00:00,UFU ALVAREZ,48,25,62,11,0,73,61,12,65,8,5,8,20,16,11,11,2,0,0,20,12,29,61
20200806,06AUG2020:00:00:00,UFU ARGERICH,37,33,44,23,3,70,58,12,62,8,1,7,11,18,14,11,7,1,0,22,22,14,58
20200726,26JUL2020:00:00:00,UFU DURAND,31,21,41,9,2,52,48,4,48,4,1,1,17,11,13,5,3,1,0,22,17,9,48
20200726,26JUL2020:00:00:00,UFU ELIZALDE,14,23,19,18,0,37,21,16,31,6,25,12,0,0,0,0,0,0,0,3,14,4,21
20200726,26JUL2020:00:00:00,UFU FERNANDEZ,18,11,27,2,0,29,25,4,29,0,0,0,10,14,1,3,0,1,0,7,9,9,25
20200726,26JUL2020:00:00:00,UFU FERRER,12,11,15,7,1,23,19,4,19,4,0,0,4,6,7,4,2,0,0,9,5,5,19
20200726,26JUL2020:00:00:00,UFU GRIERSON,11,4,11,3,1,15,11,4,13,2,2,0,7,1,4,1,0,0,0,4,6,1,11
20200726,26JUL2020:00:00:00,UFU GUTIERREZ,9,7,10,6,0,16,14,2,16,0,2,3,4,3,2,2,0,0,0,2,10,2,14
20200726,26JUL2020:00:00:00,UFU MUÑIZ,21,38,33,26,0,59,31,28,33,26,0,0,10,24,9,6,3,7,0,12,13,6,31
20200726,26JUL2020:00:00:00,UFU PENNA,23,10,22,10,1,33,31,2,33,0,0,0,6,16,3,6,2,0,0,10,14,7,31
20200726,26JUL2020:00:00:00,UFU PIROVANO,15,14,14,15,0,29,17,12,25,4,2,0,9,6,5,3,2,2,0,3,11,3,17
20200726,26JUL2020:00:00:00,UFU PIÑERO,21,17,29,7,2,38,32,6,34,4,0,0,10,8,11,7,2,0,0,14,12,6,32
20200726,26JUL2020:00:00:00,UFU RAMOS MEJIA,18,16,31,3,0,34,30,4,30,4,0,2,12,7,8,2,3,0,0,13,11,6,30
20200726,26JUL2020:00:00:00,UFU RIVADAVIA,20,15,24,9,2,35,31,4,31,4,0,0,11,8,14,0,0,2,0,11,10,10,31
20200726,26JUL2020:00:00:00,UFU SANTOJANNI,19,16,17,18,0,35,35,0,35,0,2,5,8,3,7,9,1,0,0,12,20,3,35
20200726,26JUL2020:00:00:00,UFU TORNU,33,26,28,23,8,59,49,10,55,4,6,4,13,17,11,5,3,0,0,20,19,10,49
20200726,26JUL2020:00:00:00,UFU VELEZ SARSFIELD,24,21,27,18,0,45,31,14,45,0,0,0,6,14,11,3,5,6,0,8,14,9,31
20200726,26JUL2020:00:00:00,UFU ZUBIZARRETA,27,19,23,23,0,46,30,16,36,10,0,2,5,7,21,6,3,2,0,13,13,4,30
20200727,27JUL2020:00:00:00,UFU ALVAREZ,38,40,62,16,0,78,68,10,70,8,4,10,14,21,11,14,4,0,0,19,17,32,68
20200727,27JUL2020:00:00:00,UFU ARGERICH,70,55,79,45,1,125,87,38,91,34,8,10,21,24,17,27,11,7,0,27,32,28,87
20200727,27JUL2020:00:00:00,UFU BORDA-MOYANO,64,32,59,34,3,96,86,10,86,10,0,0,16,18,16,19,16,11,0,7,65,14,86
20200727,27JUL2020:00:00:00,UFU DURAND,43,35,69,9,0,78,64,14,66,12,0,1,10,22,27,12,5,1,0,22,33,9,64
20200727,27JUL2020:00:00:00,UFU ELIZALDE,11,27,10,25,3,38,28,10,30,8,16,6,0,3,6,6,1,0,0,4,20,4,28
20200727,27JUL2020:00:00:00,UFU FERNANDEZ,21,34,43,11,1,55,47,8,53,2,0,0,8,22,6,8,6,5,0,18,15,14,47
20200727,27JUL2020:00:00:00,UFU FERRER,45,31,38,38,0,76,50,26,50,26,0,0,11,25,23,12,5,0,0,13,28,9,50
20200727,27JUL2020:00:00:00,UFU GRIERSON,9,8,12,5,0,17,17,0,17,0,0,0,1,7,4,2,1,2,0,9,7,1,17
20200727,27JUL2020:00:00:00,UFU GUTIERREZ,34,18,38,14,0,52,50,2,50,2,9,7,11,9,7,8,1,0,0,6,28,16,50
20200727,27JUL2020:00:00:00,UFU MUÑIZ,51,50,52,47,2,101,67,34,77,24,3,0,28,22,21,15,9,3,0,22,37,8,67
20200727,27JUL2020:00:00:00,UFU PENNA,19,6,21,4,0,25,13,12,19,6,0,0,6,9,2,7,1,0,0,6,6,1,13
20200727,27JUL2020:00:00:00,UFU PIROVANO,25,18,33,10,0,43,41,2,43,0,0,0,2,20,4,11,5,1,0,8,26,7,41
20200727,27JUL2020:00:00:00,UFU PIÑERO,48,51,63,33,3,99,67,32,87,12,1,1,22,31,21,13,9,1,0,33,29,5,67
20200727,27JUL2020:00:00:00,UFU RAMOS MEJIA,38,53,73,16,2,91,85,6,87,4,2,3,16,25,23,18,4,0,0,34,31,20,85
20200727,27JUL2020:00:00:00,UFU RIVADAVIA,35,23,28,28,2,58,50,8,50,8,0,0,10,20,14,8,4,2,0,12,15,22,50
20200727,27JUL2020:00:00:00,UFU SANTOJANNI,32,21,27,26,0,53,51,2,53,0,2,3,13,15,11,7,2,0,0,27,22,2,51
20200727,27JUL2020:00:00:00,UFU TORNU,33,25,44,13,1,58,52,6,56,2,5,1,9,16,18,3,5,1,0,19,20,13,52
20200727,27JUL2020:00:00:00,UFU VELEZ SARSFIELD,35,15,32,18,0,50,14,36,50,0,0,0,10,15,15,3,7,0,0,5,4,5,14
20200727,27JUL2020:00:00:00,UFU ZUBIZARRETA,36,20,29,25,2,56,38,18,44,12,2,6,7,11,5,14,7,4,0,7,17,14,38
20200728,28JUL2020:00:00:00,UFU ALVAREZ,28,41,54,15,0,69,55,14,63,6,3,2,18,18,12,9,5,2,0,13,18,24,55
20200728,28JUL2020:00:00:00,UFU ARGERICH,37,26,43,20,0,63,43,20,43,20,3,4,10,14,17,8,1,6,0,15,22,6,43
20200728,28JUL2020:00:00:00,UFU BORDA-MOYANO,68,54,99,23,0,122,68,54,68,54,0,0,18,13,19,23,22,27,0,12,31,25,68
20200728,28JUL2020:00:00:00,UFU DURAND,50,32,66,16,0,82,80,2,80,2,1,1,18,15,20,20,4,3,0,29,33,18,80
20200728,28JUL2020:00:00:00,UFU ELIZALDE,18,26,21,23,0,44,22,22,38,6,27,12,0,2,2,1,0,0,0,7,10,5,22
20200728,28JUL2020:00:00:00,UFU FERNANDEZ,17,29,36,10,0,46,36,10,46,0,0,2,9,12,6,14,3,0,0,16,11,9,36
20200728,28JUL2020:00:00:00,UFU FERRER,31,37,29,36,3,68,52,16,52,16,0,0,21,18,10,14,4,1,0,14,31,7,52
20200728,28JUL2020:00:00:00,UFU GRIERSON,17,9,15,10,1,26,24,2,24,2,0,1,8,4,6,5,2,0,0,7,17,0,24
20200728,28JUL2020:00:00:00,UFU GUTIERREZ,26,12,18,20,0,38,34,4,34,4,6,10,1,7,9,5,0,0,0,3,20,11,34
20200728,28JUL2020:00:00:00,UFU MUÑIZ,49,54,61,41,1,103,66,37,72,31,0,7,26,25,15,19,11,0,0,15,35,16,66
20200728,28JUL2020:00:00:00,UFU PENNA,16,8,21,3,0,24,20,4,24,0,0,0,3,8,2,4,5,2,0,6,7,7,20
20200728,28JUL2020:00:00:00,UFU PIROVANO,24,19,34,9,0,43,37,6,43,0,1,0,3,19,13,6,1,0,0,5,31,1,37
20200728,28JUL2020:00:00:00,UFU PIÑERO,35,38,48,23,2,73,63,10,71,2,3,0,22,17,18,8,3,2,0,20,33,10,63
20200728,28JUL2020:00:00:00,UFU RAMOS MEJIA,40,34,64,8,2,74,64,10,66,8,4,0,13,28,17,8,4,0,0,22,25,17,64
20200728,28JUL2020:00:00:00,UFU RIVADAVIA,27,30,23,26,8,57,57,0,57,0,0,0,18,12,9,14,3,1,0,14,26,17,57
20200728,28JUL2020:00:00:00,UFU SANTOJANNI,27,35,38,22,2,62,44,18,58,4,4,0,10,25,13,6,4,0,0,13,27,4,44
20200728,28JUL2020:00:00:00,UFU TORNU,47,41,63,25,0,88,82,6,82,6,8,5,15,22,19,7,12,0,0,26,36,20,82
20200728,28JUL2020:00:00:00,UFU VELEZ SARSFIELD,25,20,26,19,0,45,45,0,45,0,0,0,10,14,10,7,2,2,0,11,14,20,45
20200728,28JUL2020:00:00:00,UFU ZUBIZARRETA,13,15,12,16,0,28,18,10,24,4,0,1,5,6,7,4,3,2,0,10,5,2,18
20200729,29JUL2020:00:00:00,UFU ALVAREZ,33,31,39,21,4,64,56,8,58,6,2,4,18,26,10,2,0,2,0,18,14,24,56
20200729,29JUL2020:00:00:00,UFU ARGERICH,43,46,58,29,2,89,69,20,71,18,3,4,20,19,25,13,4,1,0,21,21,27,69
20200729,29JUL2020:00:00:00,UFU BORDA-MOYANO,58,5,60,3,0,63,63,0,63,0,0,0,5,2,3,23,18,12,0,0,44,19,63
20200729,29JUL2020:00:00:00,UFU DURAND,45,41,69,17,0,86,78,8,78,8,2,3,13,30,17,14,5,2,0,25,28,25,78
20200729,29JUL2020:00:00:00,UFU ELIZALDE,22,19,13,26,2,41,19,22,39,2,27,10,0,4,0,0,0,0,0,3,9,7,19
20200729,29JUL2020:00:00:00,UFU FERNANDEZ,52,16,46,22,0,68,48,20,68,0,0,2,9,23,17,7,6,4,0,15,18,15,48
20200729,29JUL2020:00:00:00,UFU FERRER,47,32,40,39,0,79,59,20,59,20,0,0,13,23,26,11,4,2,0,17,22,20,59
20200729,29JUL2020:00:00:00,UFU GRIERSON,7,17,14,10,0,24,24,0,24,0,0,0,8,5,8,3,0,0,0,5,16,3,24
20200729,29JUL2020:00:00:00,UFU GUTIERREZ,37,12,28,21,0,49,47,2,47,2,15,3,9,12,4,4,2,0,0,6,26,12,47
20200729,29JUL2020:00:00:00,UFU MUÑIZ,49,49,52,44,2,98,74,24,84,14,4,2,20,20,26,13,11,2,0,24,39,11,74
20200729,29JUL2020:00:00:00,UFU PENNA,16,16,23,9,0,32,24,8,30,2,0,1,5,13,5,7,1,0,0,9,7,8,24
20200729,29JUL2020:00:00:00,UFU PIROVANO,19,9,21,7,0,28,22,6,28,0,0,0,4,7,7,10,0,0,0,4,12,6,22
20200729,29JUL2020:00:00:00,UFU PIÑERO,70,74,94,46,4,144,112,32,120,24,11,2,36,35,39,12,7,2,0,25,57,30,112
20200729,29JUL2020:00:00:00,UFU RAMOS MEJIA,43,47,73,15,2,90,90,0,90,0,0,0,36,16,11,14,9,4,0,25,33,32,90
20200729,29JUL2020:00:00:00,UFU RIVADAVIA,48,30,50,24,4,78,70,8,72,6,0,0,12,26,19,16,3,2,0,18,38,14,70
20200729,29JUL2020:00:00:00,UFU SANTOJANNI,38,27,32,33,0,65,55,10,65,0,4,2,16,15,15,7,5,1,0,18,29,8,55
20200707,07JUL2020:00:00:00,UFU VELEZ SARSFIELD,22,12,26,8,0,34,16,18,20,14,0,1,5,7,6,9,6,0,0,5,9,2,16
20200707,07JUL2020:00:00:00,UFU ZUBIZARRETA,23,23,19,24,3,46,26,20,34,12,4,3,12,7,9,8,0,3,0,9,7,10,26
20200708,08JUL2020:00:00:00,UFU ALVAREZ,25,31,41,7,8,56,46,10,46,10,4,0,15,15,16,4,2,0,0,22,14,10,46
20200708,08JUL2020:00:00:00,UFU ARGERICH,47,32,60,14,5,79,47,32,53,26,8,4,24,16,15,8,1,3,0,19,14,14,47
20200708,08JUL2020:00:00:00,UFU BORDA-MOYANO,40,23,50,6,7,63,53,10,61,2,0,0,0,11,11,16,20,5,0,2,41,10,53
20200708,08JUL2020:00:00:00,UFU DURAND,19,23,32,10,0,42,38,4,38,4,1,0,3,16,10,9,3,0,0,17,17,4,38
20200708,08JUL2020:00:00:00,UFU ELIZALDE,17,15,24,8,0,32,2,30,24,8,14,12,2,2,0,0,2,0,0,0,2,0,2
20200708,08JUL2020:00:00:00,UFU FERNANDEZ,14,16,24,6,0,30,30,0,30,0,0,0,8,10,5,5,2,0,0,14,8,8,30
20200708,08JUL2020:00:00:00,UFU FERRER,32,20,27,23,2,52,44,8,44,8,0,0,10,9,9,21,2,1,0,13,19,12,44
20200708,08JUL2020:00:00:00,UFU GRIERSON,6,12,15,3,0,18,12,6,12,6,0,0,5,5,4,4,0,0,0,4,6,2,12
20200708,08JUL2020:00:00:00,UFU GUTIERREZ,35,7,27,15,0,42,34,8,38,4,10,3,15,10,3,1,0,0,0,4,22,8,34
20200708,08JUL2020:00:00:00,UFU MUÑIZ,33,42,49,24,2,75,45,30,55,20,1,3,10,22,16,10,9,4,0,24,16,5,45
20200708,08JUL2020:00:00:00,UFU PENNA,14,13,24,1,2,27,23,4,23,4,0,0,3,10,7,2,5,0,0,9,10,4,23
20200708,08JUL2020:00:00:00,UFU PIROVANO,39,35,51,21,2,74,64,10,68,6,0,4,6,36,14,10,4,0,0,7,45,12,64
20200708,08JUL2020:00:00:00,UFU PIÑERO,39,58,64,22,11,97,59,38,69,28,4,2,24,20,26,13,5,3,0,14,31,14,59
20200708,08JUL2020:00:00:00,UFU RAMOS MEJIA,34,46,74,5,1,80,26,54,28,52,0,8,21,19,14,6,10,2,0,14,7,5,26
20200708,08JUL2020:00:00:00,UFU RIVADAVIA,29,21,23,16,11,50,24,26,24,26,0,0,14,18,5,3,6,4,0,8,8,7,24
20200708,08JUL2020:00:00:00,UFU SANTOJANNI,38,42,46,31,3,80,50,30,62,18,8,11,8,22,12,10,8,1,0,32,15,3,50
20200708,08JUL2020:00:00:00,UFU TORNU,11,33,27,15,2,44,34,10,36,8,1,2,10,5,10,9,7,0,0,11,17,6,34
20200708,08JUL2020:00:00:00,UFU VELEZ SARSFIELD,14,7,14,7,0,21,13,8,13,8,0,0,3,9,5,2,2,0,0,3,10,0,13
20200708,08JUL2020:00:00:00,UFU ZUBIZARRETA,37,10,18,19,10,47,17,30,21,26,0,0,10,12,12,8,4,1,0,5,11,1,17
20200709,09JUL2020:00:00:00,UFU ALVAREZ,13,20,27,5,1,33,19,14,21,12,1,4,6,6,9,4,1,2,0,11,8,0,19
20200709,09JUL2020:00:00:00,UFU ARGERICH,28,22,44,6,0,50,4,46,4,46,12,4,16,8,2,2,4,2,0,1,2,1,4
20200709,09JUL2020:00:00:00,UFU BORDA-MOYANO,3,5,5,3,0,8,6,2,6,2,0,0,1,2,5,0,0,0,0,0,4,2,6
20200709,09JUL2020:00:00:00,UFU DURAND,17,9,21,4,1,26,18,8,22,4,0,0,0,10,8,6,2,0,0,4,12,2,18
20200709,09JUL2020:00:00:00,UFU ELIZALDE,6,9,4,9,2,15,5,10,11,4,7,4,0,0,2,0,2,0,0,1,3,1,5
20200709,09JUL2020:00:00:00,UFU FERNANDEZ,18,26,40,4,0,44,40,4,40,4,0,1,9,14,7,9,2,2,0,12,17,9,40
20200709,09JUL2020:00:00:00,UFU FERRER,18,22,24,13,3,40,22,18,22,18,2,0,12,10,7,5,2,2,0,7,6,9,22
20200709,09JUL2020:00:00:00,UFU GRIERSON,4,8,8,2,2,12,10,2,12,0,0,2,2,4,3,1,0,0,0,3,6,1,10
20200709,09JUL2020:00:00:00,UFU GUTIERREZ,10,8,11,5,2,18,12,6,14,4,3,0,6,4,5,0,0,0,0,2,9,1,12
20200709,09JUL2020:00:00:00,UFU MUÑIZ,25,26,28,23,0,51,37,14,43,8,0,3,11,17,9,8,1,2,0,9,23,5,37
20200709,09JUL2020:00:00:00,UFU PENNA,12,14,22,4,0,26,20,6,22,4,0,0,8,10,2,4,2,0,0,10,7,3,20
20200709,09JUL2020:00:00:00,UFU PIROVANO,24,30,32,14,8,54,42,12,44,10,0,0,13,8,23,9,1,0,0,9,29,3,42
20200709,09JUL2020:00:00:00,UFU PIÑERO,32,36,58,8,2,68,48,20,48,20,5,7,13,13,13,9,6,2,0,17,25,6,48
20200709,09JUL2020:00:00:00,UFU RAMOS MEJIA,49,41,68,21,1,90,18,72,18,72,2,3,20,30,21,9,2,3,0,8,7,3,18
20200709,09JUL2020:00:00:00,UFU RIVADAVIA,20,12,25,7,0,32,26,6,26,6,0,1,6,9,10,4,1,1,0,8,10,7,26
20200709,09JUL2020:00:00:00,UFU SANTOJANNI,17,18,21,14,0,35,35,0,35,0,0,0,7,11,8,5,4,0,0,16,14,5,35
20200709,09JUL2020:00:00:00,UFU TORNU,14,19,19,0,14,33,27,6,29,4,0,2,7,8,9,4,3,0,0,11,8,8,27
20200709,09JUL2020:00:00:00,UFU VELEZ SARSFIELD,20,12,25,5,2,32,14,18,26,6,0,0,7,10,9,6,0,0,0,7,6,1,14
20200709,09JUL2020:00:00:00,UFU ZUBIZARRETA,23,10,14,14,5,33,15,18,25,8,0,2,7,10,6,6,2,0,0,3,8,3,15
20200710,10JUL2020:00:00:00,UFU ALVAREZ,23,17,34,6,0,40,36,4,36,4,4,0,9,7,8,7,5,0,0,14,18,4,36
20200710,10JUL2020:00:00:00,UFU ARGERICH,11,14,16,9,0,25,13,12,13,12,2,0,2,8,6,5,0,2,0,2,5,6,13
20200710,10JUL2020:00:00:00,UFU BORDA-MOYANO,4,4,5,3,0,8,6,2,6,2,0,0,0,1,3,0,2,2,0,0,5,1,6
20200710,10JUL2020:00:00:00,UFU DURAND,30,24,35,18,1,54,52,2,52,2,0,0,10,8,18,9,8,1,0,19,24,9,52
20200710,10JUL2020:00:00:00,UFU ELIZALDE,10,16,17,9,0,26,8,18,8,18,11,13,0,2,0,0,0,0,0,1,4,3,8
20200710,10JUL2020:00:00:00,UFU FERNANDEZ,30,14,34,10,0,44,40,4,40,4,0,2,10,11,8,4,4,5,0,18,10,10,40
20200710,10JUL2020:00:00:00,UFU FERRER,25,24,31,18,0,49,39,10,39,10,0,0,14,14,16,5,0,0,0,18,11,10,39
20200710,10JUL2020:00:00:00,UFU GRIERSON,10,4,9,3,2,14,10,4,10,4,0,0,5,5,3,1,0,0,0,1,9,0,10
20200710,10JUL2020:00:00:00,UFU GUTIERREZ,18,8,23,3,0,26,22,4,22,4,3,6,2,8,4,2,1,0,0,2,18,2,22
20200710,10JUL2020:00:00:00,UFU MUÑIZ,27,41,46,22,0,68,56,12,62,6,0,1,6,29,13,12,6,1,0,21,28,7,56
20200710,10JUL2020:00:00:00,UFU PENNA,16,9,24,1,0,25,17,8,23,2,0,0,2,7,4,6,3,3,0,10,7,0,17
20200710,10JUL2020:00:00:00,UFU PIROVANO,20,30,36,14,0,50,46,4,48,2,0,0,2,23,16,7,2,0,0,11,20,14,46
20200710,10JUL2020:00:00:00,UFU PIÑERO,68,52,87,30,3,120,44,76,56,64,1,7,27,37,17,21,7,3,0,20,17,7,44
20200710,10JUL2020:00:00:00,UFU RAMOS MEJIA,31,36,51,12,4,67,61,6,61,6,0,4,16,19,14,8,6,0,0,27,25,9,61
20200710,10JUL2020:00:00:00,UFU RIVADAVIA,31,20,39,10,2,51,21,30,21,30,0,0,9,16,7,12,4,3,0,12,5,4,21
20200710,10JUL2020:00:00:00,UFU SANTOJANNI,24,19,15,28,0,43,43,0,43,0,2,3,12,7,8,8,3,0,0,9,20,12,43
20200710,10JUL2020:00:00:00,UFU TORNU,12,20,18,7,7,32,32,0,32,0,1,2,8,13,5,2,1,0,0,9,14,9,32
20200710,10JUL2020:00:00:00,UFU VELEZ SARSFIELD,13,12,18,7,0,25,11,14,13,12,0,0,8,5,6,5,1,0,0,4,7,0,11
20200710,10JUL2020:00:00:00,UFU ZUBIZARRETA,31,16,33,14,0,47,21,26,21,26,2,5,8,15,9,4,2,2,0,7,4,10,21
20200711,11JUL2020:00:00:00,UFU ALVAREZ,10,19,20,7,2,29,23,6,23,6,3,0,6,10,5,4,0,1,0,13,5,5,23
20200711,11JUL2020:00:00:00,UFU ARGERICH,3,7,10,0,0,10,6,4,6,4,0,0,1,5,1,0,0,3,0,5,0,1,6
20200711,11JUL2020:00:00:00,UFU BORDA-MOYANO,5,18,11,12,0,23,11,12,11,12,0,0,0,9,4,9,1,0,0,1,8,2,11
20200711,11JUL2020:00:00:00,UFU DURAND,28,11,28,11,0,39,31,8,31,8,0,1,4,18,10,4,2,0,0,8,20,3,31
20200711,11JUL2020:00:00:00,UFU ELIZALDE,10,6,14,2,0,16,8,8,12,4,5,0,0,5,5,0,1,0,0,3,3,2,8
20200711,11JUL2020:00:00:00,UFU FERNANDEZ,22,5,19,6,2,27,23,4,23,4,0,0,2,9,7,4,3,2,0,11,6,5,23
20200711,11JUL2020:00:00:00,UFU FERRER,23,20,21,14,8,43,21,22,23,20,0,0,6,16,11,7,3,0,0,8,7,6,21
20200711,11JUL2020:00:00:00,UFU GRIERSON,8,6,14,0,0,14,12,2,12,2,0,0,2,5,4,0,3,0,0,3,8,1,12
20200711,11JUL2020:00:00:00,UFU GUTIERREZ,8,6,10,4,0,14,12,2,12,2,1,2,2,1,6,2,0,0,0,7,2,3,12
20200711,11JUL2020:00:00:00,UFU MUÑIZ,42,32,45,25,4,74,58,16,60,14,3,6,9,15,18,15,7,1,0,29,19,10,58
20200711,11JUL2020:00:00:00,UFU PENNA,16,8,19,4,1,24,16,8,18,6,0,0,4,4,6,4,5,1,0,7,5,4,16
20200711,11JUL2020:00:00:00,UFU PIROVANO,19,19,24,12,2,38,32,6,34,4,0,0,0,15,13,6,4,0,0,6,15,8,32
20200711,11JUL2020:00:00:00,UFU PIÑERO,45,48,78,13,2,93,29,64,31,62,1,9,14,27,18,12,12,0,0,9,15,5,29
20200711,11JUL2020:00:00:00,UFU RAMOS MEJIA,32,26,47,10,1,58,38,20,38,20,4,0,5,18,10,10,11,0,0,15,16,7,38
20200711,11JUL2020:00:00:00,UFU RIVADAVIA,19,18,27,10,0,37,27,10,27,10,0,0,10,14,7,3,3,0,0,12,8,6,27
20200711,11JUL2020:00:00:00,UFU SANTOJANNI,21,13,21,13,0,34,26,8,32,2,0,1,6,6,8,7,6,0,0,9,15,2,26
20200711,11JUL2020:00:00:00,UFU TORNU,37,30,37,5,25,67,61,6,63,4,6,7,8,23,11,4,8,0,0,31,18,12,61
20200711,11JUL2020:00:00:00,UFU VELEZ SARSFIELD,17,14,21,10,0,31,19,12,21,10,0,0,8,5,14,3,0,1,0,7,5,7,19
20200711,11JUL2020:00:00:00,UFU ZUBIZARRETA,19,7,15,11,0,26,14,12,14,12,0,2,2,7,3,6,4,2,0,5,7,2,14
20200712,12JUL2020:00:00:00,UFU ALVAREZ,19,25,36,6,2,44,28,16,28,16,5,4,10,7,5,11,2,0,0,19,8,1,28
20200712,12JUL2020:00:00:00,UFU ARGERICH,5,1,4,2,0,6,4,2,4,2,0,0,3,3,0,0,0,0,0,0,3,1,4
20200712,12JUL2020:00:00:00,UFU BORDA-MOYANO,3,3,5,1,0,6,6,0,6,0,0,0,0,0,3,1,0,2,0,1,4,1,6
20200712,12JUL2020:00:00:00,UFU DURAND,24,14,22,16,0,38,32,6,32,6,2,0,6,13,7,8,2,0,0,7,21,4,32
20200712,12JUL2020:00:00:00,UFU ELIZALDE,9,14,11,12,0,23,13,10,19,4,16,6,0,0,0,0,1,0,0,5,6,2,13
20200712,12JUL2020:00:00:00,UFU FERNANDEZ,8,9,16,1,0,17,15,2,15,2,0,0,4,3,5,4,1,0,0,8,4,3,15
20200712,12JUL2020:00:00:00,UFU FERRER,13,20,12,6,15,33,13,20,13,20,0,4,10,7,9,3,0,0,0,7,2,4,13
20200712,12JUL2020:00:00:00,UFU GRIERSON,6,1,5,2,0,7,7,0,7,0,0,0,0,4,1,0,2,0,0,3,3,1,7
20200712,12JUL2020:00:00:00,UFU GUTIERREZ,15,3,16,2,0,18,16,2,16,2,7,2,2,1,1,5,0,0,0,0,13,3,16
20200712,12JUL2020:00:00:00,UFU MUÑIZ,40,38,54,24,0,78,60,18,66,12,2,3,12,24,23,7,6,1,0,20,36,4,60
20200712,12JUL2020:00:00:00,UFU PENNA,18,21,30,8,1,39,33,6,33,6,2,0,7,11,11,6,2,0,0,13,14,6,33
20200712,12JUL2020:00:00:00,UFU PIROVANO,25,20,33,12,0,45,41,4,43,2,1,0,2,14,9,13,4,2,0,4,21,15,41
20200712,12JUL2020:00:00:00,UFU PIÑERO,36,32,52,13,3,68,40,28,50,18,4,6,6,16,11,18,7,0,0,28,11,1,40
20200712,12JUL2020:00:00:00,UFU RAMOS MEJIA,25,35,37,21,2,60,50,10,50,10,0,3,15,19,9,9,5,0,0,28,14,8,50
20200712,12JUL2020:00:00:00,UFU RIVADAVIA,18,12,19,9,2,30,14,16,14,16,0,0,4,16,6,4,0,0,0,6,4,2,14
20200712,12JUL2020:00:00:00,UFU SANTOJANNI,14,28,23,19,0,42,14,28,42,0,1,1,13,10,6,11,0,0,0,11,3,0,14
20200712,12JUL2020:00:00:00,UFU TORNU,15,7,9,7,6,22,18,4,18,4,0,1,8,4,5,2,2,0,0,4,10,4,18
20200712,12JUL2020:00:00:00,UFU VELEZ SARSFIELD,15,15,16,14,0,30,10,20,10,20,0,0,7,7,4,7,5,0,0,5,5,0,10
20200712,12JUL2020:00:00:00,UFU ZUBIZARRETA,18,14,20,12,0,32,22,10,24,8,0,0,5,10,10,3,2,2,0,7,8,7,22
20200713,13JUL2020:00:00:00,UFU ALVAREZ,25,28,39,12,2,53,45,8,49,4,2,3,18,11,5,9,4,1,0,18,21,6,45
20200713,13JUL2020:00:00:00,UFU ARGERICH,64,66,93,36,1,130,70,60,70,60,9,9,15,27,39,13,12,6,0,36,15,19,70
20200713,13JUL2020:00:00:00,UFU BORDA-MOYANO,61,11,53,14,5,72,64,8,64,8,0,0,3,13,13,17,17,9,0,4,51,9,64
20200713,13JUL2020:00:00:00,UFU DURAND,38,26,50,14,0,64,54,10,60,4,0,3,9,8,16,17,9,2,0,20,28,6,54
20200713,13JUL2020:00:00:00,UFU ELIZALDE,15,14,12,14,3,29,11,18,17,12,17,0,2,0,4,4,2,0,0,0,5,6,11
20200713,13JUL2020:00:00:00,UFU FERNANDEZ,22,13,26,8,1,35,31,4,31,4,0,0,5,20,6,4,0,0,0,21,8,1,31
20200713,13JUL2020:00:00:00,UFU FERRER,24,30,28,24,2,54,48,6,48,6,0,0,5,20,17,9,1,2,0,9,23,16,48
20200713,13JUL2020:00:00:00,UFU GRIERSON,7,8,8,5,2,15,13,2,13,2,0,0,4,5,3,2,1,0,0,7,6,0,13
20200713,13JUL2020:00:00:00,UFU GUTIERREZ,18,6,13,9,2,24,14,10,14,10,4,4,6,4,2,0,4,0,0,1,10,2,14
20200713,13JUL2020:00:00:00,UFU MUÑIZ,31,53,54,24,6,84,56,28,60,24,0,0,21,23,15,12,8,5,0,20,28,8,56
20200713,13JUL2020:00:00:00,UFU PENNA,18,5,17,6,0,23,17,6,19,4,0,0,7,6,3,5,2,0,0,7,6,4,17
20200713,13JUL2020:00:00:00,UFU PIROVANO,35,18,33,18,2,53,45,8,51,2,1,2,5,16,17,10,1,1,0,13,24,8,45
20200713,13JUL2020:00:00:00,UFU PIÑERO,56,53,70,33,6,109,31,78,33,76,5,3,20,19,37,19,6,0,0,13,16,2,31
20200713,13JUL2020:00:00:00,UFU RAMOS MEJIA,36,54,73,16,1,90,40,50,44,46,0,0,29,18,21,13,3,6,0,23,7,10,40
20200713,13JUL2020:00:00:00,UFU RIVADAVIA,25,18,22,16,5,43,29,14,29,14,0,2,7,14,9,5,4,2,0,4,15,10,29
20200713,13JUL2020:00:00:00,UFU SANTOJANNI,35,29,30,30,4,64,46,18,52,12,1,2,11,12,23,10,3,2,0,17,27,2,46
20200713,13JUL2020:00:00:00,UFU TORNU,32,22,40,14,0,54,50,4,52,2,4,7,9,9,9,11,4,1,0,15,24,9,50
20200713,13JUL2020:00:00:00,UFU VELEZ SARSFIELD,13,10,12,8,3,23,9,14,13,10,0,0,9,4,4,4,2,0,0,5,3,1,9
20200713,13JUL2020:00:00:00,UFU ZUBIZARRETA,21,15,23,11,2,36,16,20,22,14,0,0,4,14,8,7,3,0,0,3,9,4,16
20200714,14JUL2020:00:00:00,UFU ALVAREZ,32,24,39,10,7,56,48,8,48,8,2,1,14,19,7,10,3,0,0,25,17,6,48
20200714,14JUL2020:00:00:00,UFU ARGERICH,30,31,47,14,0,61,43,18,43,18,4,4,9,7,20,10,6,1,0,19,13,11,43
20200714,14JUL2020:00:00:00,UFU BORDA-MOYANO,13,11,15,6,3,24,10,14,10,14,0,0,4,10,6,4,0,0,0,2,5,3,10
20200714,14JUL2020:00:00:00,UFU DURAND,41,25,41,23,2,66,54,12,60,6,0,1,9,17,18,14,7,0,0,20,31,3,54
20200714,14JUL2020:00:00:00,UFU ELIZALDE,24,13,24,13,0,37,7,30,19,18,18,6,0,3,3,3,4,0,0,1,4,2,7
20200714,14JUL2020:00:00:00,UFU FERNANDEZ,16,18,27,6,1,34,30,4,30,4,0,0,3,13,9,3,4,2,0,15,11,4,30
20200714,14JUL2020:00:00:00,UFU FERRER,23,23,27,17,2,46,36,10,38,8,0,0,12,17,5,9,3,0,0,11,15,10,36
20200714,14JUL2020:00:00:00,UFU GRIERSON,14,7,8,12,1,21,17,4,17,4,0,0,5,6,7,2,1,0,0,6,10,1,17
20200714,14JUL2020:00:00:00,UFU GUTIERREZ,11,9,12,8,0,20,18,2,18,2,8,7,0,2,3,0,0,0,0,4,8,6,18
20200714,14JUL2020:00:00:00,UFU MUÑIZ,40,41,44,35,2,81,59,22,63,18,0,0,12,29,22,11,4,3,0,11,31,17,59
20200714,14JUL2020:00:00:00,UFU PENNA,8,12,17,3,0,20,14,6,16,4,0,0,4,7,2,3,3,1,0,5,7,2,14
20200714,14JUL2020:00:00:00,UFU PIROVANO,27,17,34,7,3,44,38,6,40,4,0,0,7,9,13,10,5,0,0,8,21,8,38
20200714,14JUL2020:00:00:00,UFU PIÑERO,38,40,57,14,7,78,46,32,48,30,5,4,11,22,17,10,7,2,0,17,21,8,46
20200714,14JUL2020:00:00:00,UFU RAMOS MEJIA,71,42,100,11,2,113,47,66,51,62,6,16,23,32,21,10,5,0,0,27,11,9,47
20200714,14JUL2020:00:00:00,UFU RIVADAVIA,23,15,26,4,8,38,22,16,24,14,0,0,6,11,6,7,8,0,0,8,11,3,22
20200714,14JUL2020:00:00:00,UFU SANTOJANNI,38,16,31,22,1,54,44,10,50,4,2,1,10,13,12,10,4,2,0,12,30,2,44
20200714,14JUL2020:00:00:00,UFU TORNU,34,25,46,11,2,59,51,8,51,8,4,5,11,16,5,13,4,1,0,11,26,13,51
20200714,14JUL2020:00:00:00,UFU VELEZ SARSFIELD,17,17,28,6,0,34,26,8,32,2,0,0,11,10,6,5,2,0,0,9,11,6,26
20200714,14JUL2020:00:00:00,UFU ZUBIZARRETA,51,21,44,28,0,72,38,34,46,26,0,0,0,16,28,18,8,2,0,9,23,6,38
20200715,15JUL2020:00:00:00,UFU ALVAREZ,33,52,64,9,12,85,79,6,79,6,9,4,23,28,10,10,0,1,0,23,23,33,79
20200715,15JUL2020:00:00:00,UFU ARGERICH,41,33,64,10,0,74,48,26,52,22,1,4,22,18,15,4,8,2,0,22,13,13,48
20200715,15JUL2020:00:00:00,UFU BORDA-MOYANO,18,24,23,19,0,42,32,10,32,10,0,1,8,13,1,13,6,0,0,5,16,11,32
20200715,15JUL2020:00:00:00,UFU DURAND,31,37,60,7,1,68,54,14,58,10,3,7,10,19,13,3,7,6,0,20,25,9,54
20200715,15JUL2020:00:00:00,UFU ELIZALDE,30,20,18,30,2,50,6,44,42,8,19,17,0,4,4,4,2,0,0,1,4,1,6
20200715,15JUL2020:00:00:00,UFU FERNANDEZ,21,18,31,6,2,39,39,0,39,0,0,0,10,12,9,4,3,1,0,19,6,14,39
20200715,15JUL2020:00:00:00,UFU FERRER,29,18,26,21,0,47,36,11,36,11,0,0,11,17,10,9,0,0,0,11,14,11,36
20200715,15JUL2020:00:00:00,UFU GRIERSON,9,15,17,7,0,24,20,4,20,4,0,0,6,7,9,1,0,1,0,4,14,2,20
20200715,15JUL2020:00:00:00,UFU GUTIERREZ,22,7,14,10,5,29,17,12,21,8,12,3,3,8,3,0,0,0,0,2,12,2,17
20200715,15JUL2020:00:00:00,UFU MUÑIZ,54,76,70,56,4,130,71,59,73,57,1,2,17,46,24,18,7,15,0,29,31,11,71
20200715,15JUL2020:00:00:00,UFU PENNA,18,6,19,5,0,24,20,4,22,2,0,3,2,5,7,4,3,0,0,11,6,3,20
20200715,15JUL2020:00:00:00,UFU PIROVANO,18,12,24,5,1,30,28,2,28,2,1,1,3,15,5,3,1,1,0,10,14,4,28
20200715,15JUL2020:00:00:00,UFU PIÑERO,57,46,65,35,3,103,39,64,49,54,8,4,21,26,16,15,11,2,0,14,21,4,39
20200715,15JUL2020:00:00:00,UFU RAMOS MEJIA,31,30,48,12,1,61,39,22,39,22,4,0,14,20,14,3,3,3,0,18,11,10,39
20200715,15JUL2020:00:00:00,UFU RIVADAVIA,31,37,46,13,9,68,30,38,30,38,0,0,16,26,16,8,2,0,0,9,15,6,30
20200715,15JUL2020:00:00:00,UFU SANTOJANNI,30,32,36,21,5,62,44,18,54,8,5,4,10,15,14,11,3,0,0,26,13,5,44
20200715,15JUL2020:00:00:00,UFU TORNU,39,38,58,17,2,77,65,12,67,10,4,9,10,23,15,10,5,1,0,21,28,14,65
20200715,15JUL2020:00:00:00,UFU VELEZ SARSFIELD,15,4,11,5,3,19,15,4,17,2,0,0,1,3,6,5,3,1,0,7,8,0,15
20200715,15JUL2020:00:00:00,UFU ZUBIZARRETA,14,19,26,7,0,33,19,14,25,8,0,2,3,8,9,6,3,2,0,3,12,4,19
20200716,16JUL2020:00:00:00,UFU ALVAREZ,41,37,56,20,2,78,50,28,50,28,4,4,20,16,23,6,5,0,0,15,14,21,50
20200716,16JUL2020:00:00:00,UFU ARGERICH,58,44,71,25,6,102,80,22,84,18,6,7,28,23,9,11,9,9,0,40,21,19,80
20200716,16JUL2020:00:00:00,UFU BORDA-MOYANO,4,32,30,2,4,36,34,2,34,2,0,0,0,3,6,15,8,4,0,14,9,11,34
20200716,16JUL2020:00:00:00,UFU DURAND,29,20,27,22,0,49,41,8,43,6,2,2,7,14,15,4,5,0,0,13,26,2,41
20200716,16JUL2020:00:00:00,UFU ELIZALDE,15,15,10,20,0,30,6,24,22,8,11,11,0,4,2,2,0,0,0,4,2,0,6
20200716,16JUL2020:00:00:00,UFU FERNANDEZ,29,28,51,6,0,57,47,10,47,10,0,0,10,22,12,3,5,5,0,13,14,20,47
20200716,16JUL2020:00:00:00,UFU FERRER,27,33,40,19,1,60,38,22,38,22,0,0,12,15,17,12,4,0,0,17,10,11,38
20200716,16JUL2020:00:00:00,UFU GRIERSON,9,9,13,5,0,18,16,2,16,2,0,0,6,5,6,1,0,0,0,10,4,2,16
20200716,16JUL2020:00:00:00,UFU GUTIERREZ,34,17,29,22,0,51,19,32,19,32,11,8,3,9,8,7,5,0,0,3,12,4,19
20200716,16JUL2020:00:00:00,UFU MUÑIZ,40,31,44,25,2,71,49,22,61,10,4,1,12,21,10,19,4,0,0,19,23,7,49
20200716,16JUL2020:00:00:00,UFU PENNA,17,16,24,6,3,33,15,18,19,14,0,1,6,3,12,5,4,2,0,6,4,5,15
20200716,16JUL2020:00:00:00,UFU PIROVANO,23,12,23,12,0,35,35,0,35,0,1,1,8,9,5,9,0,2,0,14,17,4,35
20200716,16JUL2020:00:00:00,UFU PIÑERO,34,40,48,19,7,74,44,30,44,30,4,3,18,16,14,11,4,4,0,16,28,0,44
20200716,16JUL2020:00:00:00,UFU RAMOS MEJIA,50,39,71,17,1,89,53,36,53,36,0,7,15,29,12,14,8,4,0,21,22,10,53
20200716,16JUL2020:00:00:00,UFU RIVADAVIA,26,19,31,5,9,45,41,4,41,4,0,0,11,10,10,10,0,4,0,19,10,12,41
20200716,16JUL2020:00:00:00,UFU SANTOJANNI,30,30,29,31,0,60,54,6,60,0,1,3,10,19,8,15,2,2,0,21,25,8,54
20200716,16JUL2020:00:00:00,UFU TORNU,44,40,57,26,1,84,74,10,78,6,10,7,19,18,17,4,8,1,0,17,37,20,74
20200716,16JUL2020:00:00:00,UFU VELEZ SARSFIELD,21,8,19,7,3,29,25,4,27,2,0,0,5,3,9,6,4,2,0,5,10,10,25
20200716,16JUL2020:00:00:00,UFU ZUBIZARRETA,42,17,32,27,0,59,35,24,35,24,2,1,8,17,14,10,7,0,0,13,12,10,35
20200717,17JUL2020:00:00:00,UFU ALVAREZ,42,32,55,15,4,74,70,4,70,4,3,5,14,31,11,6,4,0,0,26,18,26,70
20200717,17JUL2020:00:00:00,UFU ARGERICH,54,32,62,21,3,86,54,32,74,12,3,1,26,25,9,13,6,3,0,19,30,5,54
20200717,17JUL2020:00:00:00,UFU BORDA-MOYANO,66,3,45,22,2,69,69,0,69,0,0,1,0,12,13,25,13,5,0,1,54,14,69
20200717,17JUL2020:00:00:00,UFU DURAND,37,24,55,5,1,61,57,4,59,2,2,0,17,20,11,7,4,0,0,24,24,9,57
20200717,17JUL2020:00:00:00,UFU ELIZALDE,15,9,12,12,0,24,6,18,20,4,12,5,1,1,3,2,0,0,0,1,5,0,6
20200717,17JUL2020:00:00:00,UFU FERNANDEZ,13,18,26,5,0,31,27,4,31,0,0,1,4,14,6,4,2,0,0,9,15,3,27
20200717,17JUL2020:00:00:00,UFU FERRER,31,15,31,12,3,46,32,14,32,14,0,0,16,12,7,6,3,2,0,9,19,4,32
20200717,17JUL2020:00:00:00,UFU GRIERSON,8,11,13,6,0,19,17,2,19,0,0,0,2,9,4,0,3,1,0,3,13,1,17
20200717,17JUL2020:00:00:00,UFU GUTIERREZ,29,11,23,17,0,40,34,6,40,0,5,9,3,5,11,3,4,0,0,4,24,6,34
20200717,17JUL2020:00:00:00,UFU MUÑIZ,39,48,47,39,1,87,73,14,75,12,5,5,13,23,21,15,5,0,0,33,30,10,73
20200717,17JUL2020:00:00:00,UFU PENNA,18,9,23,3,1,27,25,2,25,2,0,1,10,7,4,2,1,2,0,17,3,5,25
20200717,17JUL2020:00:00:00,UFU PIROVANO,21,18,29,10,0,39,37,2,39,0,0,0,3,14,10,4,7,1,0,17,16,4,37
20200717,17JUL2020:00:00:00,UFU PIÑERO,25,38,46,13,4,63,51,12,55,8,5,3,11,17,13,10,2,2,0,19,28,4,51
20200717,17JUL2020:00:00:00,UFU RAMOS MEJIA,41,30,64,6,1,71,63,8,63,8,0,2,30,17,12,6,1,3,0,25,22,16,63
20200717,17JUL2020:00:00:00,UFU RIVADAVIA,28,26,32,20,2,54,52,2,52,2,0,2,10,17,9,13,2,1,0,17,25,9,52
20200717,17JUL2020:00:00:00,UFU SANTOJANNI,32,11,28,15,0,43,33,10,43,0,3,2,10,6,14,7,0,1,0,18,14,1,33
20200717,17JUL2020:00:00:00,UFU TORNU,31,18,36,10,3,49,45,4,45,4,0,4,4,9,17,12,3,0,0,9,26,10,45
20200717,17JUL2020:00:00:00,UFU VELEZ SARSFIELD,20,6,16,10,0,26,24,2,24,2,0,0,4,9,5,3,5,0,0,3,13,8,24
20200717,17JUL2020:00:00:00,UFU ZUBIZARRETA,28,14,27,13,2,42,34,8,36,6,2,3,2,8,9,11,4,3,0,9,11,14,34
20200718,18JUL2020:00:00:00,UFU ALVAREZ,38,32,58,9,3,70,64,6,66,4,11,4,14,18,15,4,2,2,0,25,10,29,64
20200718,18JUL2020:00:00:00,UFU ARGERICH,8,17,16,9,0,25,23,2,23,2,0,1,9,3,3,4,3,2,0,12,2,9,23
20200718,18JUL2020:00:00:00,UFU BORDA-MOYANO,2,10,3,9,0,12,10,2,10,2,0,1,1,2,1,3,4,0,0,2,6,2,10
20200718,18JUL2020:00:00:00,UFU DURAND,23,18,28,13,0,41,37,4,39,2,0,2,3,18,11,4,3,0,0,17,17,3,37
20200718,18JUL2020:00:00:00,UFU ELIZALDE,2,10,6,6,0,12,8,4,10,2,11,1,0,0,0,0,0,0,0,3,3,2,8
20200718,18JUL2020:00:00:00,UFU FERNANDEZ,14,6,16,4,0,20,20,0,20,0,0,0,2,6,7,4,1,0,0,8,10,1,20
20200718,18JUL2020:00:00:00,UFU FERRER,30,25,28,13,14,55,25,30,27,28,0,1,22,19,4,4,1,4,0,7,10,8,25
20200718,18JUL2020:00:00:00,UFU GRIERSON,8,12,11,7,2,20,16,4,20,0,0,0,6,5,4,5,0,0,0,3,13,0,16
20200718,18JUL2020:00:00:00,UFU GUTIERREZ,19,13,28,4,0,32,32,0,32,0,11,3,5,3,6,4,0,0,0,6,18,8,32
20200718,18JUL2020:00:00:00,UFU MUÑIZ,32,57,42,47,0,89,71,18,81,8,1,0,18,30,14,15,8,3,0,18,38,15,71
20200718,18JUL2020:00:00:00,UFU PENNA,20,17,23,13,1,37,29,8,31,6,0,1,11,10,4,6,5,0,0,13,10,6,29
20200718,18JUL2020:00:00:00,UFU PIROVANO,24,13,37,0,0,37,35,2,35,2,6,7,1,13,4,1,4,1,0,10,18,6,35
20200718,18JUL2020:00:00:00,UFU PIÑERO,41,57,75,20,3,98,84,14,88,10,9,2,24,30,15,11,6,1,0,35,39,10,84
20200718,18JUL2020:00:00:00,UFU RAMOS MEJIA,29,35,48,16,0,64,40,24,46,18,0,7,8,17,22,4,4,2,0,25,11,4,40
20200718,18JUL2020:00:00:00,UFU RIVADAVIA,21,5,20,6,0,26,22,4,24,2,0,0,9,7,6,4,0,0,0,10,6,4,22
20200718,18JUL2020:00:00:00,UFU SANTOJANNI,6,4,7,3,0,10,10,0,10,0,0,0,0,2,1,6,1,0,0,6,4,0,10
20200820,20AUG2020:00:00:00,UFU RIVADAVIA,35,25,34,22,4,60,56,4,56,4,0,0,8,18,14,12,6,2,0,21,27,6,56
20200820,20AUG2020:00:00:00,UFU SANTOJANNI,53,46,49,47,3,99,87,12,93,6,2,7,26,19,22,14,9,0,0,29,50,8,87
20200820,20AUG2020:00:00:00,UFU TORNU,40,40,50,28,2,80,72,8,74,6,2,7,29,13,15,10,4,0,0,18,40,12,72
20200820,20AUG2020:00:00:00,UFU VELEZ SARSFIELD,13,14,15,12,0,27,25,2,27,0,0,0,6,8,8,5,0,0,0,7,5,13,25
20200820,20AUG2020:00:00:00,UFU ZUBIZARRETA,38,36,39,33,2,74,32,42,46,28,3,3,11,20,13,12,10,2,0,5,15,12,32
20200821,21AUG2020:00:00:00,UFU ALVAREZ,15,10,17,8,0,25,23,2,25,0,0,0,4,8,6,4,2,1,0,6,8,9,23
20200821,21AUG2020:00:00:00,UFU ARGERICH,33,29,47,14,1,62,53,9,53,9,5,5,15,19,8,5,1,4,0,18,24,11,53
20200821,21AUG2020:00:00:00,UFU BORDA-MOYANO,10,7,9,7,1,17,17,0,17,0,0,0,1,4,6,3,3,0,0,1,14,2,17
20200821,21AUG2020:00:00:00,UFU DURAND,61,29,76,14,0,90,64,26,70,20,1,7,13,39,10,13,7,0,0,22,32,10,64
20200821,21AUG2020:00:00:00,UFU ELIZALDE,10,21,12,17,2,31,25,6,29,2,17,7,1,1,4,1,0,0,0,5,16,4,25
20200821,21AUG2020:00:00:00,UFU FERNANDEZ,25,25,29,16,5,50,48,2,48,2,0,1,10,11,12,14,1,1,0,21,25,2,48
20200821,21AUG2020:00:00:00,UFU FERRER,24,32,30,26,0,56,36,20,38,18,0,0,12,15,13,16,0,0,0,15,17,4,36
20200821,21AUG2020:00:00:00,UFU GRIERSON,37,27,29,32,3,64,58,6,58,6,0,1,17,16,23,2,4,1,0,20,37,1,58
20200821,21AUG2020:00:00:00,UFU GUTIERREZ,45,28,47,25,1,73,69,4,71,2,17,13,7,12,15,8,1,0,0,7,48,14,69
20200821,21AUG2020:00:00:00,UFU MUÑIZ,97,121,78,135,5,218,134,84,158,60,5,6,43,63,41,38,17,5,0,40,78,16,134
20200821,21AUG2020:00:00:00,UFU PENNA,26,12,28,8,2,38,30,8,36,2,0,0,9,9,8,9,3,0,0,11,14,5,30
20200821,21AUG2020:00:00:00,UFU PIROVANO,19,15,26,8,0,34,30,4,32,2,0,6,6,8,6,4,3,1,0,7,20,3,30
20200821,21AUG2020:00:00:00,UFU PIÑERO,42,34,61,13,2,76,70,6,70,6,3,2,31,14,15,4,6,1,0,20,45,5,70
20200821,21AUG2020:00:00:00,UFU RAMOS MEJIA,52,57,77,27,5,109,99,10,101,8,2,6,21,31,32,9,8,0,0,34,43,22,99
20200821,21AUG2020:00:00:00,UFU RIVADAVIA,43,36,44,29,6,79,69,10,71,8,0,0,16,23,15,16,9,0,0,18,37,11,69
20200821,21AUG2020:00:00:00,UFU SANTOJANNI,40,32,38,34,0,72,62,10,70,2,4,0,12,16,21,10,4,5,0,24,35,3,62
20200821,21AUG2020:00:00:00,UFU TORNU,52,40,57,34,1,92,82,10,84,8,1,4,24,24,17,14,5,3,0,24,37,19,82
20200821,21AUG2020:00:00:00,UFU VELEZ SARSFIELD,19,5,16,8,0,24,22,2,24,0,0,0,7,6,1,4,3,3,0,6,10,6,22
20200821,21AUG2020:00:00:00,UFU ZUBIZARRETA,49,35,33,49,2,84,56,28,56,28,0,10,15,22,22,13,2,0,0,14,13,29,56
20200822,22AUG2020:00:00:00,UFU ALVAREZ,15,10,16,9,0,25,21,4,21,4,0,1,6,0,6,5,6,1,0,9,6,6,21
20200822,22AUG2020:00:00:00,UFU ARGERICH,9,14,15,8,0,23,21,2,21,2,0,2,11,5,2,2,0,1,0,7,6,8,21
20200822,22AUG2020:00:00:00,UFU BORDA-MOYANO,4,3,2,5,0,7,7,0,7,0,0,1,0,2,1,1,2,0,0,1,5,1,7
20200822,22AUG2020:00:00:00,UFU DURAND,27,25,43,9,0,52,50,2,52,0,0,0,12,21,7,6,4,2,0,24,20,6,50
20200822,22AUG2020:00:00:00,UFU ELIZALDE,15,3,10,8,0,18,16,2,16,2,10,5,0,1,0,0,2,0,0,4,7,5,16
20200822,22AUG2020:00:00:00,UFU FERNANDEZ,25,11,33,3,0,36,34,2,36,0,0,0,8,12,12,4,0,0,0,9,18,7,34
20200822,22AUG2020:00:00:00,UFU FERRER,19,22,25,15,1,41,32,9,32,9,0,0,13,13,7,5,3,0,0,13,15,4,32
20200822,22AUG2020:00:00:00,UFU GRIERSON,27,33,44,16,0,60,60,0,60,0,2,3,25,11,9,7,3,0,0,27,26,7,60
20200822,22AUG2020:00:00:00,UFU GUTIERREZ,24,9,14,19,0,33,31,2,33,0,5,4,7,5,6,3,2,1,0,2,23,6,31
20200822,22AUG2020:00:00:00,UFU MUÑIZ,69,58,66,61,0,127,79,48,83,44,0,4,27,32,30,21,8,5,0,24,46,9,79
20200822,22AUG2020:00:00:00,UFU PENNA,14,12,11,15,0,26,26,0,26,0,0,0,4,7,4,5,6,0,0,13,10,3,26
20200822,22AUG2020:00:00:00,UFU PIROVANO,20,28,42,6,0,48,40,8,48,0,0,3,11,17,9,3,3,2,0,11,23,5,40
20200822,22AUG2020:00:00:00,UFU PIÑERO,49,33,53,27,2,82,64,18,66,16,4,10,11,16,19,18,2,2,0,24,30,10,64
20200822,22AUG2020:00:00:00,UFU RAMOS MEJIA,27,36,48,14,1,63,59,4,59,4,0,2,7,21,16,10,5,2,0,25,22,12,59
20200822,22AUG2020:00:00:00,UFU RIVADAVIA,15,13,22,6,0,28,28,0,28,0,0,0,5,5,9,3,4,2,0,9,15,4,28
20200822,22AUG2020:00:00:00,UFU SANTOJANNI,23,21,26,18,0,44,30,14,34,10,0,3,6,9,13,5,7,1,0,16,13,1,30
20200822,22AUG2020:00:00:00,UFU TORNU,51,32,31,48,4,83,73,10,77,6,7,4,15,27,19,6,4,1,0,20,36,17,73
20200822,22AUG2020:00:00:00,UFU VELEZ SARSFIELD,14,16,13,17,0,30,28,2,30,0,0,1,8,8,7,6,0,0,0,12,7,9,28
20200822,22AUG2020:00:00:00,UFU ZUBIZARRETA,37,25,37,21,4,62,50,12,62,0,0,0,15,10,27,9,0,1,0,14,18,18,50
20200823,23AUG2020:00:00:00,UFU ALVAREZ,9,9,18,0,0,18,16,2,16,2,4,4,3,2,3,2,0,0,0,5,7,4,16
20200823,23AUG2020:00:00:00,UFU ARGERICH,5,10,6,9,0,15,15,0,15,0,0,0,5,1,6,2,0,1,0,10,4,1,15
20200823,23AUG2020:00:00:00,UFU BORDA-MOYANO,3,3,6,0,0,6,4,2,4,2,0,0,0,2,0,4,0,0,0,2,1,1,4
20200823,23AUG2020:00:00:00,UFU DURAND,43,35,57,20,1,78,66,12,74,4,5,8,14,23,15,9,4,0,0,26,35,5,66
20200823,23AUG2020:00:00:00,UFU ELIZALDE,15,14,15,14,0,29,27,2,29,0,12,12,0,2,2,0,1,0,0,6,16,5,27
20200823,23AUG2020:00:00:00,UFU FERNANDEZ,9,12,14,7,0,21,19,2,21,0,0,0,7,8,1,4,1,0,0,11,5,3,19
20200823,23AUG2020:00:00:00,UFU FERRER,33,17,25,25,0,50,43,7,43,7,0,0,11,14,14,9,2,0,0,18,21,4,43
20200823,23AUG2020:00:00:00,UFU GRIERSON,25,15,26,14,0,40,36,4,40,0,0,0,11,12,5,4,3,5,0,13,19,4,36
20200823,23AUG2020:00:00:00,UFU GUTIERREZ,34,23,37,20,0,57,47,10,53,4,12,4,15,19,5,1,1,0,0,2,35,10,47
20200823,23AUG2020:00:00:00,UFU MUÑIZ,41,51,51,41,0,92,60,32,66,26,0,0,16,33,18,16,8,1,0,26,30,4,60
20200823,23AUG2020:00:00:00,UFU PENNA,16,9,20,5,0,25,19,6,25,0,0,1,4,9,8,1,2,0,0,8,10,1,19
20200823,23AUG2020:00:00:00,UFU PIROVANO,17,10,19,8,0,27,27,0,27,0,0,0,2,7,5,4,7,2,0,10,15,2,27
20200823,23AUG2020:00:00:00,UFU PIÑERO,26,23,36,13,0,49,45,4,49,0,1,1,13,15,9,5,1,4,0,19,21,5,45
20200823,23AUG2020:00:00:00,UFU RAMOS MEJIA,25,24,41,8,0,49,43,6,43,6,1,3,10,10,14,4,5,2,0,20,16,7,43
20200823,23AUG2020:00:00:00,UFU RIVADAVIA,12,9,13,6,2,21,17,4,17,4,0,0,2,8,4,4,2,1,0,8,5,3,17
20200823,23AUG2020:00:00:00,UFU SANTOJANNI,5,10,9,6,0,15,13,2,15,0,0,0,3,0,7,2,3,0,0,7,6,0,13
20200823,23AUG2020:00:00:00,UFU TORNU,39,39,36,36,6,78,62,16,76,2,6,4,18,17,22,8,0,3,0,26,31,5,62
20200823,23AUG2020:00:00:00,UFU VELEZ SARSFIELD,22,21,34,9,0,43,35,8,39,4,0,0,5,18,8,9,3,0,0,10,11,14,35
20200823,23AUG2020:00:00:00,UFU ZUBIZARRETA,16,11,17,10,0,27,27,0,27,0,2,2,8,5,5,1,4,0,0,11,2,14,27
20200824,24AUG2020:00:00:00,UFU ALVAREZ,12,27,31,6,2,39,37,2,37,2,0,2,2,11,8,5,7,4,0,1,2,34,37
20200824,24AUG2020:00:00:00,UFU ARGERICH,44,26,38,29,3,70,64,6,64,6,3,1,16,20,18,7,5,0,0,21,35,8,64
20200824,24AUG2020:00:00:00,UFU BORDA-MOYANO,12,8,11,9,0,20,20,0,20,0,0,0,4,6,6,2,2,0,0,1,14,5,20
20200824,24AUG2020:00:00:00,UFU DURAND,49,49,68,30,0,98,74,24,86,12,2,1,17,29,33,11,5,0,0,26,38,10,74
20200824,24AUG2020:00:00:00,UFU ELIZALDE,24,18,28,14,0,42,34,8,38,4,14,16,3,4,5,0,0,0,0,7,22,5,34
20200824,24AUG2020:00:00:00,UFU FERNANDEZ,24,44,54,14,0,68,60,8,68,0,0,1,14,20,17,11,3,2,0,25,26,9,60
20200824,24AUG2020:00:00:00,UFU FERRER,45,46,48,42,1,91,71,20,71,20,0,0,22,26,30,11,2,0,0,19,28,24,71
20200824,24AUG2020:00:00:00,UFU GRIERSON,31,12,31,12,0,43,43,0,43,0,3,2,10,10,6,7,3,2,0,12,29,2,43
20200824,24AUG2020:00:00:00,UFU GUTIERREZ,58,21,49,30,0,79,59,20,67,12,19,14,12,13,14,5,1,1,0,5,46,8,59
20200824,24AUG2020:00:00:00,UFU MUÑIZ,113,118,107,118,6,231,151,80,175,56,3,4,35,77,50,36,19,7,0,49,81,21,151
20200824,24AUG2020:00:00:00,UFU PENNA,22,16,25,13,0,38,32,6,32,6,0,2,6,12,9,5,1,3,0,7,18,7,32
20200824,24AUG2020:00:00:00,UFU PIROVANO,26,16,30,12,0,42,38,4,40,2,0,2,4,10,10,8,6,2,0,14,19,5,38
20200824,24AUG2020:00:00:00,UFU PIÑERO,41,47,44,41,3,88,78,10,82,6,1,2,12,16,30,14,8,5,0,33,35,10,78
20200824,24AUG2020:00:00:00,UFU RAMOS MEJIA,44,33,61,15,1,77,75,2,75,2,1,2,12,27,17,15,3,0,0,30,24,21,75
20200824,24AUG2020:00:00:00,UFU RIVADAVIA,31,29,27,27,6,60,48,12,48,12,0,0,15,22,9,11,2,1,0,13,31,4,48
20200824,24AUG2020:00:00:00,UFU SANTOJANNI,38,47,44,41,0,85,71,14,83,2,8,3,17,23,9,15,6,4,0,23,47,1,71
20200824,24AUG2020:00:00:00,UFU TORNU,74,71,93,42,10,145,123,22,123,22,4,5,38,30,33,28,5,2,0,37,50,35,123
20200824,24AUG2020:00:00:00,UFU VELEZ SARSFIELD,34,11,32,13,0,45,37,8,45,0,0,0,5,13,13,3,5,6,0,17,8,12,37
20200824,24AUG2020:00:00:00,UFU ZUBIZARRETA,36,32,38,30,0,68,58,10,66,2,0,2,13,27,14,10,0,2,0,0,0,58,58
20200825,25AUG2020:00:00:00,UFU ALVAREZ,13,15,18,10,0,28,24,4,24,4,1,2,12,3,10,0,0,0,0,8,7,9,24
20200825,25AUG2020:00:00:00,UFU ARGERICH,35,34,51,18,0,69,61,8,61,8,6,3,12,13,10,20,4,1,0,37,9,15,61
20200825,25AUG2020:00:00:00,UFU BORDA-MOYANO,3,11,11,3,0,14,14,0,14,0,0,0,5,4,1,3,1,0,0,2,11,1,14
20200825,25AUG2020:00:00:00,UFU DURAND,50,56,95,11,0,106,76,30,80,26,2,0,23,26,25,17,9,4,0,19,45,12,76
20200825,25AUG2020:00:00:00,UFU ELIZALDE,29,27,25,29,2,56,36,20,54,2,33,14,2,1,3,1,2,0,0,1,29,6,36
20200825,25AUG2020:00:00:00,UFU FERNANDEZ,44,27,57,14,0,71,63,8,69,2,0,1,11,25,13,11,9,1,0,20,20,23,63
20200825,25AUG2020:00:00:00,UFU FERRER,44,37,35,44,2,81,41,40,45,36,0,0,15,29,16,16,5,0,0,18,11,12,41
20200825,25AUG2020:00:00:00,UFU GRIERSON,30,28,34,24,0,58,54,4,54,4,2,5,14,9,13,10,3,2,0,17,35,2,54
20200825,25AUG2020:00:00:00,UFU GUTIERREZ,61,34,32,63,0,95,81,14,95,0,22,16,17,15,17,4,3,1,0,7,55,18,81
20200825,25AUG2020:00:00:00,UFU MUÑIZ,107,117,91,127,6,224,106,118,122,102,2,2,46,67,60,33,12,2,0,31,61,14,106
20200825,25AUG2020:00:00:00,UFU PENNA,20,10,19,10,1,30,28,2,28,2,0,2,9,8,7,2,2,0,0,10,13,5,28
20200825,25AUG2020:00:00:00,UFU PIROVANO,23,10,25,6,2,33,25,8,29,4,4,3,3,11,1,3,7,1,0,8,15,2,25
20200825,25AUG2020:00:00:00,UFU PIÑERO,56,66,74,29,19,122,110,12,112,10,5,9,20,29,29,19,7,4,0,36,39,35,110
20200825,25AUG2020:00:00:00,UFU RAMOS MEJIA,53,46,79,15,5,99,93,6,93,6,6,7,23,25,21,12,5,0,0,38,31,24,93
20200825,25AUG2020:00:00:00,UFU RIVADAVIA,52,27,45,31,3,79,63,16,63,16,0,0,21,16,16,14,4,8,0,26,25,12,63
20200825,25AUG2020:00:00:00,UFU SANTOJANNI,73,48,67,54,0,121,95,26,113,8,7,6,19,32,26,21,5,5,0,49,42,4,95
20200825,25AUG2020:00:00:00,UFU TORNU,75,86,115,35,11,161,115,46,119,42,2,6,44,40,27,29,8,5,0,41,41,29,115
20200825,25AUG2020:00:00:00,UFU VELEZ SARSFIELD,34,17,29,22,0,51,47,4,51,0,0,2,14,12,10,6,3,4,0,14,16,17,47
20200825,25AUG2020:00:00:00,UFU ZUBIZARRETA,48,30,36,40,2,78,60,18,70,8,0,0,15,26,18,14,1,4,0,1,1,58,60
20200826,26AUG2020:00:00:00,UFU ALVAREZ,18,15,25,6,2,33,31,2,31,2,2,0,9,7,7,6,2,0,0,12,11,8,31
20200826,26AUG2020:00:00:00,UFU ARGERICH,60,39,60,37,2,99,79,20,83,16,11,7,22,26,18,10,3,2,0,25,36,18,79
20200826,26AUG2020:00:00:00,UFU BORDA-MOYANO,27,7,23,11,0,34,32,2,32,2,0,0,4,6,7,10,5,2,0,1,23,8,32
20200826,26AUG2020:00:00:00,UFU DURAND,44,37,64,17,0,81,57,24,75,6,1,1,17,29,13,15,4,1,0,18,27,12,57
20200826,26AUG2020:00:00:00,UFU ELIZALDE,7,21,8,18,2,28,22,6,26,2,19,6,1,2,0,0,0,0,0,3,14,5,22
20200826,26AUG2020:00:00:00,UFU FERNANDEZ,34,29,44,16,3,63,55,8,63,0,0,2,22,13,11,7,6,2,0,19,25,11,55
20200826,26AUG2020:00:00:00,UFU FERRER,31,37,23,43,2,68,60,8,62,6,0,0,18,27,13,7,3,0,0,22,33,5,60
20200826,26AUG2020:00:00:00,UFU GRIERSON,25,34,34,25,0,59,55,4,55,4,5,7,12,19,8,5,3,0,0,18,37,0,55
20200826,26AUG2020:00:00:00,UFU GUTIERREZ,39,14,30,22,1,53,33,20,41,12,9,10,7,17,7,2,1,0,0,4,24,5,33
20200826,26AUG2020:00:00:00,UFU MUÑIZ,115,109,107,113,4,224,154,70,178,46,0,4,52,59,44,48,12,5,0,50,79,25,154
20200826,26AUG2020:00:00:00,UFU PENNA,8,7,9,4,2,15,11,4,13,2,0,0,1,5,1,0,6,2,0,2,7,2,11
20200826,26AUG2020:00:00:00,UFU PIROVANO,42,17,37,22,0,59,55,4,57,2,1,0,5,12,20,13,4,4,0,13,34,7,55
20200826,26AUG2020:00:00:00,UFU PIÑERO,36,49,56,27,2,85,63,22,63,22,5,7,17,24,17,13,1,1,0,40,20,3,63
20200826,26AUG2020:00:00:00,UFU RAMOS MEJIA,63,49,70,40,2,112,102,10,104,8,8,9,28,25,19,14,7,2,0,41,37,24,102
20200826,26AUG2020:00:00:00,UFU RIVADAVIA,46,27,43,24,6,73,65,8,67,6,0,0,23,21,13,7,9,0,0,21,30,14,65
20200826,26AUG2020:00:00:00,UFU SANTOJANNI,43,43,46,36,4,86,74,12,80,6,3,4,26,16,16,12,8,1,0,39,30,5,74
20200826,26AUG2020:00:00:00,UFU TORNU,65,56,93,28,0,121,101,20,109,12,7,9,22,33,25,11,8,6,0,28,38,32,101
20200826,26AUG2020:00:00:00,UFU VELEZ SARSFIELD,34,20,28,26,0,54,38,16,52,2,0,0,16,11,8,15,2,2,0,10,10,18,38
20200826,26AUG2020:00:00:00,UFU ZUBIZARRETA,45,16,34,27,0,61,53,8,57,4,0,6,6,11,16,16,6,0,0,8,13,32,53
20200827,27AUG2020:00:00:00,UFU ALVAREZ,24,17,32,7,2,41,39,2,39,2,1,5,8,11,7,7,1,1,0,8,13,18,39
20200827,27AUG2020:00:00:00,UFU ARGERICH,65,41,72,34,0,106,54,52,78,28,2,7,23,22,23,20,7,2,0,26,15,13,54
20200827,27AUG2020:00:00:00,UFU BORDA-MOYANO,15,10,15,9,1,25,25,0,25,0,2,2,6,4,4,3,1,3,0,6,14,5,25
20200827,27AUG2020:00:00:00,UFU DURAND,67,44,82,29,0,111,85,26,105,6,2,4,26,26,18,20,12,3,0,33,37,15,85
20201023,23OCT2020:00:00:00,UFU PENNA,15,7,16,6,0,22,22,0,22,0,0,0,4,5,7,4,2,0,0,5,15,2,22
20200827,27AUG2020:00:00:00,UFU ELIZALDE,40,32,29,41,2,72,44,28,58,14,25,24,8,6,7,2,0,0,0,5,33,6,44
20200827,27AUG2020:00:00:00,UFU FERNANDEZ,37,27,45,19,0,64,56,8,62,2,2,0,13,26,3,16,1,3,0,18,25,13,56
20200827,27AUG2020:00:00:00,UFU FERRER,25,32,27,30,0,57,43,14,43,14,0,0,19,10,13,8,4,3,0,20,20,3,43
20200827,27AUG2020:00:00:00,UFU GRIERSON,35,19,36,18,0,54,54,0,54,0,3,6,15,10,9,8,2,1,0,25,25,4,54
20200827,27AUG2020:00:00:00,UFU GUTIERREZ,35,30,33,32,0,65,53,12,57,8,17,11,7,18,9,2,1,0,0,3,42,8,53
20200827,27AUG2020:00:00:00,UFU MUÑIZ,91,114,94,106,5,205,121,84,137,68,2,0,33,57,58,38,15,2,0,34,74,13,121
20200827,27AUG2020:00:00:00,UFU PENNA,12,12,13,10,1,24,18,6,22,2,0,0,5,4,6,6,3,0,0,11,7,0,18
20200827,27AUG2020:00:00:00,UFU PIROVANO,10,14,20,4,0,24,24,0,24,0,0,0,1,3,9,4,1,6,0,3,16,5,24
20200827,27AUG2020:00:00:00,UFU PIÑERO,58,50,81,23,4,108,88,20,90,18,8,5,20,24,20,15,13,3,0,46,38,4,88
20200827,27AUG2020:00:00:00,UFU RAMOS MEJIA,70,87,136,21,0,157,143,14,147,10,8,16,30,32,27,24,19,1,0,70,45,28,143
20200827,27AUG2020:00:00:00,UFU RIVADAVIA,55,39,45,45,4,94,78,16,78,16,0,0,25,23,24,13,9,0,0,12,45,21,78
20200827,27AUG2020:00:00:00,UFU SANTOJANNI,47,32,44,35,0,79,61,18,77,2,4,3,24,21,13,12,2,0,0,22,38,1,61
20200827,27AUG2020:00:00:00,UFU TORNU,67,51,66,49,3,118,106,12,106,12,4,10,34,26,18,21,2,3,0,35,48,21,106
20200827,27AUG2020:00:00:00,UFU VELEZ SARSFIELD,33,22,31,24,0,55,51,4,55,0,0,2,19,12,10,5,7,0,0,12,16,23,51
20200827,27AUG2020:00:00:00,UFU ZUBIZARRETA,31,27,37,21,0,58,36,22,46,12,2,1,12,20,8,12,3,0,0,7,7,22,36
20200828,28AUG2020:00:00:00,UFU ALVAREZ,13,15,22,6,0,28,28,0,28,0,3,1,7,8,3,4,0,2,0,4,8,16,28
20200828,28AUG2020:00:00:00,UFU ARGERICH,54,39,60,33,0,93,69,24,73,20,5,6,21,18,17,13,6,7,0,30,29,10,69
20200828,28AUG2020:00:00:00,UFU BORDA-MOYANO,6,8,7,7,0,14,14,0,14,0,0,1,1,4,5,0,3,0,0,2,10,2,14
20200828,28AUG2020:00:00:00,UFU DURAND,51,42,77,15,1,93,81,12,91,2,3,3,16,29,17,16,8,1,0,33,39,9,81
20200828,28AUG2020:00:00:00,UFU ELIZALDE,29,23,30,22,0,52,38,14,46,6,15,13,0,13,3,7,1,0,0,5,26,7,38
20200828,28AUG2020:00:00:00,UFU FERNANDEZ,39,34,41,28,4,73,65,8,71,2,0,0,19,25,16,4,6,3,0,21,37,7,65
20200828,28AUG2020:00:00:00,UFU FERRER,41,20,29,30,2,61,49,12,49,12,0,0,15,27,13,4,1,1,0,16,25,8,49
20200828,28AUG2020:00:00:00,UFU GRIERSON,33,22,22,33,0,55,47,8,49,6,1,2,16,14,11,9,0,2,0,20,27,0,47
20200828,28AUG2020:00:00:00,UFU GUTIERREZ,26,12,21,17,0,38,36,2,36,2,3,4,2,16,4,4,4,1,0,5,25,6,36
20200828,28AUG2020:00:00:00,UFU MUÑIZ,109,126,122,109,4,235,139,96,143,92,2,6,59,54,46,32,28,8,0,43,68,28,139
20200828,28AUG2020:00:00:00,UFU PENNA,22,13,23,10,2,35,31,4,35,0,0,2,4,13,5,8,3,0,0,13,14,4,31
20200828,28AUG2020:00:00:00,UFU PIROVANO,30,16,36,8,2,46,42,4,44,2,2,0,9,17,2,8,6,2,0,12,21,9,42
20200828,28AUG2020:00:00:00,UFU PIÑERO,41,49,59,29,2,90,86,4,90,0,1,7,16,14,27,19,6,0,0,29,48,9,86
20200828,28AUG2020:00:00:00,UFU RAMOS MEJIA,68,71,100,37,2,139,131,8,133,6,13,4,43,41,21,10,5,2,0,54,54,23,131
20200828,28AUG2020:00:00:00,UFU RIVADAVIA,63,39,44,45,13,102,98,4,98,4,0,1,24,38,17,11,6,5,0,22,56,19,98
20200828,28AUG2020:00:00:00,UFU SANTOJANNI,30,23,25,28,0,53,49,4,49,4,0,1,19,13,8,7,3,2,0,20,24,5,49
20200828,28AUG2020:00:00:00,UFU TORNU,49,50,74,23,2,99,89,10,95,4,2,15,17,18,19,15,12,1,0,23,50,15,89
20200828,28AUG2020:00:00:00,UFU VELEZ SARSFIELD,26,27,32,21,0,53,48,5,52,1,0,2,14,15,9,6,4,3,0,12,18,18,48
20200828,28AUG2020:00:00:00,UFU ZUBIZARRETA,55,42,52,45,0,97,79,18,91,6,5,4,15,17,27,12,17,0,0,3,8,68,79
20200829,29AUG2020:00:00:00,UFU ALVAREZ,5,13,13,5,0,18,17,1,17,1,0,3,2,9,1,3,0,0,0,1,6,10,17
20200829,29AUG2020:00:00:00,UFU ARGERICH,8,8,10,6,0,16,16,0,16,0,2,2,2,2,1,3,3,1,0,8,5,3,16
20200829,29AUG2020:00:00:00,UFU BORDA-MOYANO,15,4,13,6,0,19,19,0,19,0,0,1,1,2,4,7,4,0,0,2,14,3,19
20200829,29AUG2020:00:00:00,UFU DURAND,29,48,57,20,0,77,67,10,73,4,1,0,27,23,10,11,3,2,0,38,24,5,67
20200829,29AUG2020:00:00:00,UFU ELIZALDE,24,8,16,16,0,32,30,2,30,2,14,8,3,5,2,0,0,0,0,6,15,9,30
20200829,29AUG2020:00:00:00,UFU FERNANDEZ,37,19,42,14,0,56,52,4,56,0,0,1,11,17,6,16,1,4,0,23,22,7,52
20200829,29AUG2020:00:00:00,UFU FERRER,10,10,13,7,0,20,18,2,18,2,0,0,7,6,5,1,1,0,0,4,10,4,18
20200829,29AUG2020:00:00:00,UFU GRIERSON,25,23,35,13,0,48,42,6,48,0,0,2,14,10,7,11,4,0,0,16,22,4,42
20200829,29AUG2020:00:00:00,UFU GUTIERREZ,34,10,35,9,0,44,38,6,40,4,11,2,5,13,6,4,1,2,0,4,26,8,38
20200829,29AUG2020:00:00:00,UFU MUÑIZ,48,81,57,72,0,129,77,52,77,52,0,4,21,52,22,21,7,2,0,19,46,12,77
20200829,29AUG2020:00:00:00,UFU PENNA,13,15,14,14,0,28,26,2,26,2,0,0,8,6,3,6,5,0,0,16,8,2,26
20200829,29AUG2020:00:00:00,UFU PIROVANO,13,15,23,5,0,28,26,2,26,2,0,1,9,10,8,0,0,0,0,11,14,1,26
20200829,29AUG2020:00:00:00,UFU PIÑERO,21,31,36,12,4,52,44,8,50,2,2,2,10,10,14,8,2,4,0,13,19,12,44
20200829,29AUG2020:00:00:00,UFU RAMOS MEJIA,33,36,51,15,3,69,61,8,65,4,2,5,18,17,10,10,5,2,0,29,19,13,61
20200829,29AUG2020:00:00:00,UFU RIVADAVIA,31,19,33,17,0,50,46,4,46,4,0,0,9,24,5,6,5,1,0,15,20,11,46
20200829,29AUG2020:00:00:00,UFU SANTOJANNI,35,37,44,28,0,72,62,10,68,4,5,2,14,26,14,5,5,1,0,25,36,1,62
20200829,29AUG2020:00:00:00,UFU TORNU,34,25,25,30,4,59,51,8,59,0,0,1,17,15,9,15,2,0,0,15,25,11,51
20200829,29AUG2020:00:00:00,UFU VELEZ SARSFIELD,24,17,21,20,0,41,33,8,41,0,0,2,7,10,9,10,3,0,0,10,11,12,33
20200829,29AUG2020:00:00:00,UFU ZUBIZARRETA,17,14,21,10,0,31,21,10,25,6,0,0,5,6,8,9,1,2,0,14,6,1,21
20200830,30AUG2020:00:00:00,UFU ALVAREZ,4,1,5,0,0,5,3,2,3,2,2,0,2,1,0,0,0,0,0,1,0,2,3
20200830,30AUG2020:00:00:00,UFU ARGERICH,6,6,8,4,0,12,8,4,8,4,2,0,3,3,1,1,1,1,0,5,3,0,8
20200830,30AUG2020:00:00:00,UFU BORDA-MOYANO,1,0,1,0,0,1,1,0,1,0,0,0,0,0,0,0,0,1,0,0,1,0,1
20200830,30AUG2020:00:00:00,UFU DURAND,26,21,41,6,0,47,43,4,47,0,0,1,10,17,13,3,3,0,0,25,14,4,43
20200830,30AUG2020:00:00:00,UFU ELIZALDE,9,12,4,17,0,21,19,2,19,2,8,9,0,0,3,1,0,0,0,4,14,1,19
20200830,30AUG2020:00:00:00,UFU FERNANDEZ,19,17,26,10,0,36,32,4,36,0,0,2,4,10,13,4,1,2,0,10,12,10,32
20200830,30AUG2020:00:00:00,UFU FERRER,15,14,18,11,0,29,17,12,17,12,0,0,12,8,7,1,1,0,0,6,9,2,17
20200830,30AUG2020:00:00:00,UFU GRIERSON,29,22,36,15,0,51,43,8,51,0,3,8,12,5,12,6,4,1,0,18,24,1,43
20200830,30AUG2020:00:00:00,UFU GUTIERREZ,25,13,23,15,0,38,36,2,38,0,3,15,1,10,4,2,1,2,0,4,26,6,36
20200830,30AUG2020:00:00:00,UFU MUÑIZ,47,115,52,109,1,162,114,48,120,42,0,5,44,51,23,24,10,5,0,22,79,13,114
20200830,30AUG2020:00:00:00,UFU PENNA,22,12,18,16,0,34,28,6,32,2,0,0,8,10,10,4,2,0,0,8,16,4,28
20200830,30AUG2020:00:00:00,UFU PIROVANO,5,9,10,4,0,14,10,4,12,2,2,0,1,1,4,4,2,0,0,4,6,0,10
20200830,30AUG2020:00:00:00,UFU PIÑERO,26,24,35,14,1,50,46,4,46,4,0,2,7,14,12,7,6,2,0,21,18,7,46
20200830,30AUG2020:00:00:00,UFU RAMOS MEJIA,44,26,52,18,0,70,68,2,70,0,5,3,20,21,6,11,3,1,0,20,32,16,68
20200830,30AUG2020:00:00:00,UFU RIVADAVIA,17,14,25,6,0,31,31,0,31,0,0,0,16,3,6,4,1,1,0,10,11,10,31
20200830,30AUG2020:00:00:00,UFU SANTOJANNI,14,21,22,13,0,35,29,6,31,4,2,2,10,6,7,6,0,2,0,9,15,5,29
20200830,30AUG2020:00:00:00,UFU TORNU,34,14,20,25,3,48,46,2,46,2,0,6,11,13,10,5,1,2,0,17,25,4,46
20200830,30AUG2020:00:00:00,UFU VELEZ SARSFIELD,15,13,20,8,0,28,24,4,28,0,0,0,0,3,11,5,9,0,0,6,10,8,24
20200830,30AUG2020:00:00:00,UFU ZUBIZARRETA,27,14,33,8,0,41,37,4,37,4,0,0,15,9,7,5,4,1,0,13,16,8,37
20200831,31AUG2020:00:00:00,UFU ALVAREZ,9,16,23,2,0,25,19,6,19,6,1,2,6,5,6,5,0,0,0,6,10,3,19
20200831,31AUG2020:00:00:00,UFU ARGERICH,40,31,49,22,0,71,57,14,59,12,4,6,11,20,15,0,12,3,0,17,28,12,57
20200831,31AUG2020:00:00:00,UFU BORDA-MOYANO,12,9,10,11,0,21,21,0,21,0,0,0,2,5,8,3,2,1,0,3,18,0,21
20200831,31AUG2020:00:00:00,UFU DURAND,37,51,67,21,0,88,74,14,82,6,0,2,23,23,22,8,9,1,0,31,33,10,74
20200831,31AUG2020:00:00:00,UFU ELIZALDE,29,28,23,33,1,57,45,12,53,4,34,16,1,4,1,0,0,1,0,4,30,11,45
20200831,31AUG2020:00:00:00,UFU FERNANDEZ,32,24,46,10,0,56,52,4,56,0,0,1,16,8,15,7,5,4,0,21,29,2,52
20200831,31AUG2020:00:00:00,UFU FERRER,42,30,37,35,0,72,58,14,58,14,0,0,27,14,15,9,5,2,0,16,33,9,58
20200831,31AUG2020:00:00:00,UFU GRIERSON,18,29,32,15,0,47,31,16,45,2,0,2,14,11,9,6,5,0,0,12,15,4,31
20200831,31AUG2020:00:00:00,UFU GUTIERREZ,36,20,22,34,0,56,54,2,56,0,17,4,8,14,8,5,0,0,0,4,40,10,54
20200831,31AUG2020:00:00:00,UFU MUÑIZ,118,198,132,179,5,316,138,178,160,156,2,8,85,91,61,42,16,11,0,26,90,22,138
20200831,31AUG2020:00:00:00,UFU PENNA,21,13,21,13,0,34,26,8,30,4,0,0,4,13,7,3,6,1,0,9,15,2,26
20200831,31AUG2020:00:00:00,UFU PIROVANO,16,19,26,9,0,35,29,6,33,2,0,3,8,7,11,2,0,4,0,7,19,3,29
20200831,31AUG2020:00:00:00,UFU PIÑERO,39,28,44,20,3,67,57,10,65,2,0,2,12,22,13,8,10,0,0,22,32,3,57
20200806,06AUG2020:00:00:00,UFU BORDA-MOYANO,7,26,27,6,0,33,31,2,31,2,4,0,1,2,7,12,4,3,0,4,18,9,31
20200806,06AUG2020:00:00:00,UFU DURAND,53,26,42,36,1,79,59,20,63,16,1,0,15,17,20,16,8,2,0,19,30,10,59
20200806,06AUG2020:00:00:00,UFU ELIZALDE,26,22,19,27,2,48,30,18,40,8,21,10,2,5,2,8,0,0,0,4,23,3,30
20200806,06AUG2020:00:00:00,UFU FERNANDEZ,29,21,42,6,2,50,46,4,50,0,0,2,8,13,12,12,3,0,0,17,17,12,46
20200806,06AUG2020:00:00:00,UFU FERRER,36,30,38,28,0,66,56,10,56,10,0,1,16,23,9,10,7,0,0,25,25,6,56
20200806,06AUG2020:00:00:00,UFU GRIERSON,14,13,15,12,0,27,27,0,27,0,0,2,2,11,8,4,0,0,0,12,15,0,27
20200806,06AUG2020:00:00:00,UFU GUTIERREZ,19,4,14,9,0,23,23,0,23,0,4,4,5,3,2,5,0,0,0,2,20,1,23
20200806,06AUG2020:00:00:00,UFU MUÑIZ,64,56,80,40,0,120,96,24,106,14,2,7,16,35,27,18,14,1,0,34,50,12,96
20200806,06AUG2020:00:00:00,UFU PENNA,18,9,23,4,0,27,21,6,25,2,0,0,4,6,5,7,5,0,0,7,10,4,21
20200806,06AUG2020:00:00:00,UFU PIROVANO,15,17,21,11,0,32,30,2,30,2,0,2,6,10,9,3,2,0,0,5,21,4,30
20200806,06AUG2020:00:00:00,UFU PIÑERO,54,53,90,11,6,107,69,38,69,38,4,5,21,25,22,17,12,1,0,29,31,9,69
20200806,06AUG2020:00:00:00,UFU RAMOS MEJIA,30,35,49,16,0,65,59,6,61,4,2,0,20,18,16,4,5,0,0,21,30,8,59
20200806,06AUG2020:00:00:00,UFU RIVADAVIA,29,23,28,21,3,52,48,4,48,4,0,0,11,16,14,8,3,0,0,15,24,8,48
20200806,06AUG2020:00:00:00,UFU SANTOJANNI,54,21,33,40,2,75,55,20,71,4,7,4,15,17,9,16,5,2,0,19,31,5,55
20200806,06AUG2020:00:00:00,UFU TORNU,33,38,55,14,2,71,60,11,64,7,2,3,2,22,26,8,8,0,0,20,23,17,60
20200806,06AUG2020:00:00:00,UFU VELEZ SARSFIELD,23,16,23,16,0,39,33,6,39,0,0,0,8,13,10,8,0,0,0,9,10,14,33
20200806,06AUG2020:00:00:00,UFU ZUBIZARRETA,32,11,26,17,0,43,15,28,25,18,0,0,4,15,6,13,3,2,0,1,6,8,15
20200807,07AUG2020:00:00:00,UFU ALVAREZ,50,19,55,14,0,69,55,14,67,2,2,7,6,22,17,6,7,2,0,14,11,30,55
20200807,07AUG2020:00:00:00,UFU ARGERICH,35,27,45,17,0,62,49,13,49,13,6,1,23,12,14,1,0,5,0,11,26,12,49
20200807,07AUG2020:00:00:00,UFU BORDA-MOYANO,9,12,12,9,0,21,15,6,15,6,0,1,3,6,8,1,0,2,0,3,10,2,15
20200807,07AUG2020:00:00:00,UFU DURAND,34,37,51,18,2,71,61,10,61,10,0,0,9,24,24,13,1,0,0,15,34,12,61
20200807,07AUG2020:00:00:00,UFU ELIZALDE,13,16,6,23,0,29,21,8,27,2,9,12,0,3,1,1,3,0,0,4,14,3,21
20200807,07AUG2020:00:00:00,UFU FERNANDEZ,34,24,45,11,2,58,52,6,58,0,0,0,10,17,9,9,10,3,0,14,24,14,52
20200807,07AUG2020:00:00:00,UFU FERRER,35,26,26,35,0,61,45,16,45,16,0,0,8,27,15,5,4,2,0,17,23,5,45
20200807,07AUG2020:00:00:00,UFU GRIERSON,9,11,17,3,0,20,18,2,20,0,1,3,4,6,4,2,0,0,0,5,11,2,18
20200807,07AUG2020:00:00:00,UFU GUTIERREZ,24,15,19,20,0,39,35,4,35,4,6,4,6,14,4,5,0,0,0,3,22,8,35
20200807,07AUG2020:00:00:00,UFU MUÑIZ,65,47,55,57,0,112,76,36,90,22,4,4,18,26,27,21,3,9,0,17,47,12,76
20200807,07AUG2020:00:00:00,UFU PENNA,28,10,30,7,1,38,30,8,38,0,0,2,7,14,2,8,3,2,0,9,14,7,30
20200807,07AUG2020:00:00:00,UFU PIROVANO,31,19,33,17,0,50,36,14,50,0,0,0,5,20,11,14,0,0,0,6,19,10,36
20200807,07AUG2020:00:00:00,UFU PIÑERO,42,44,64,21,1,86,54,32,56,30,3,0,13,24,21,9,14,2,0,22,27,5,54
20200807,07AUG2020:00:00:00,UFU RAMOS MEJIA,26,33,52,7,0,59,51,8,53,6,5,2,16,19,12,2,2,1,0,21,25,5,51
20200807,07AUG2020:00:00:00,UFU RIVADAVIA,38,36,45,24,5,74,62,12,70,4,0,0,15,25,15,11,8,0,0,9,37,15,62
20200807,07AUG2020:00:00:00,UFU SANTOJANNI,24,24,24,24,0,48,40,8,44,4,4,0,11,12,5,7,5,4,0,16,18,6,40
20200807,07AUG2020:00:00:00,UFU TORNU,30,32,47,15,0,62,44,18,46,16,4,4,10,14,10,18,2,0,0,20,15,8,44
20200807,07AUG2020:00:00:00,UFU VELEZ SARSFIELD,21,18,24,14,1,39,39,0,39,0,0,0,9,13,7,8,2,0,0,18,7,14,39
20200807,07AUG2020:00:00:00,UFU ZUBIZARRETA,39,23,36,26,0,62,28,34,30,32,3,3,4,17,13,22,0,0,0,2,15,11,28
20200808,08AUG2020:00:00:00,UFU ALVAREZ,9,13,18,4,0,22,16,6,16,6,3,0,10,3,3,3,0,0,0,5,3,8,16
20200808,08AUG2020:00:00:00,UFU ARGERICH,13,13,14,12,0,26,22,4,22,4,3,3,1,4,9,2,0,4,0,12,7,3,22
20200808,08AUG2020:00:00:00,UFU BORDA-MOYANO,8,4,10,2,0,12,8,4,8,4,0,0,3,6,1,2,0,0,0,1,5,2,8
20200808,08AUG2020:00:00:00,UFU DURAND,24,24,40,8,0,48,36,12,40,8,5,0,16,14,9,2,2,0,0,15,14,7,36
20200808,08AUG2020:00:00:00,UFU ELIZALDE,10,8,9,9,0,18,14,4,14,4,9,2,1,5,0,0,1,0,0,4,9,1,14
20200808,08AUG2020:00:00:00,UFU FERNANDEZ,19,13,26,6,0,32,18,14,28,4,0,0,8,5,12,3,3,1,0,7,10,1,18
20200808,08AUG2020:00:00:00,UFU FERRER,23,23,16,28,2,46,20,26,20,26,0,0,18,15,7,4,0,2,0,8,11,1,20
20200808,08AUG2020:00:00:00,UFU GRIERSON,10,13,13,7,3,23,15,8,19,4,4,1,5,6,3,4,0,0,0,3,12,0,15
20200808,08AUG2020:00:00:00,UFU GUTIERREZ,17,10,17,10,0,27,23,4,23,4,6,2,7,8,1,3,0,0,0,0,18,4,23
20200808,08AUG2020:00:00:00,UFU MUÑIZ,34,40,39,35,0,74,56,18,64,10,1,0,11,24,18,13,3,4,0,18,20,18,56
20200808,08AUG2020:00:00:00,UFU PENNA,11,13,17,7,0,24,16,8,18,6,0,0,3,9,4,1,5,2,0,9,3,4,16
20200808,08AUG2020:00:00:00,UFU PIROVANO,23,18,31,7,3,41,33,8,37,4,2,0,16,9,7,1,6,0,0,12,9,12,33
20200808,08AUG2020:00:00:00,UFU PIÑERO,39,23,41,19,2,62,50,12,54,8,1,2,13,10,19,12,5,0,0,29,17,4,50
20200808,08AUG2020:00:00:00,UFU RAMOS MEJIA,27,22,46,3,0,49,45,4,47,2,6,2,8,15,6,5,4,3,0,24,10,11,45
20200808,08AUG2020:00:00:00,UFU RIVADAVIA,31,22,37,12,4,53,37,16,41,12,0,1,11,15,18,6,2,0,0,7,24,5,37
20200808,08AUG2020:00:00:00,UFU SANTOJANNI,16,10,17,7,2,26,10,16,24,2,4,0,3,13,2,1,3,0,0,4,5,1,10
20200808,08AUG2020:00:00:00,UFU TORNU,17,24,18,21,2,41,35,6,35,6,1,1,10,13,4,7,2,3,0,16,9,10,35
20200808,08AUG2020:00:00:00,UFU VELEZ SARSFIELD,16,15,22,9,0,31,25,6,31,0,0,0,10,4,8,7,2,0,0,5,9,11,25
20200808,08AUG2020:00:00:00,UFU ZUBIZARRETA,15,12,18,9,0,27,17,10,19,8,0,0,2,13,5,4,2,1,0,6,7,4,17
20200809,09AUG2020:00:00:00,UFU ALVAREZ,17,14,29,0,2,31,19,12,21,10,6,5,8,8,3,0,0,1,0,8,9,2,19
20200809,09AUG2020:00:00:00,UFU ARGERICH,12,12,18,6,0,24,12,12,12,12,0,0,3,11,8,0,1,1,0,5,6,1,12
20200809,09AUG2020:00:00:00,UFU BORDA-MOYANO,3,8,5,6,0,11,11,0,11,0,0,0,1,2,1,7,0,0,0,3,6,2,11
20200809,09AUG2020:00:00:00,UFU DURAND,18,16,31,3,0,34,32,2,32,2,0,0,11,11,4,5,3,0,0,8,20,4,32
20200809,09AUG2020:00:00:00,UFU ELIZALDE,13,15,8,20,0,28,24,4,26,2,13,9,0,5,0,0,1,0,0,4,18,2,24
20200809,09AUG2020:00:00:00,UFU FERNANDEZ,17,3,14,6,0,20,14,6,18,2,0,1,3,5,10,0,0,1,0,8,3,3,14
20200809,09AUG2020:00:00:00,UFU FERRER,20,12,20,12,0,32,22,10,22,10,0,0,10,13,6,3,0,0,0,8,12,2,22
20200809,09AUG2020:00:00:00,UFU GRIERSON,19,7,11,15,0,26,18,8,24,2,6,3,6,5,1,4,1,0,0,9,8,1,18
20200809,09AUG2020:00:00:00,UFU GUTIERREZ,18,7,12,11,2,25,25,0,25,0,5,2,3,12,2,1,0,0,0,0,20,4,25
20200809,09AUG2020:00:00:00,UFU MUÑIZ,38,34,48,24,0,72,50,22,54,18,7,2,11,25,16,3,3,5,0,14,28,8,50
20200809,09AUG2020:00:00:00,UFU PENNA,19,12,26,5,0,31,25,6,27,4,0,1,1,4,11,12,2,0,0,15,6,4,25
20200809,09AUG2020:00:00:00,UFU PIROVANO,13,13,21,5,0,26,24,2,26,0,2,0,6,3,11,4,0,0,0,7,13,4,24
20200809,09AUG2020:00:00:00,UFU PIÑERO,40,23,49,13,1,63,49,14,51,12,0,2,10,24,8,10,5,4,0,22,23,4,49
20200809,09AUG2020:00:00:00,UFU RAMOS MEJIA,23,22,31,14,0,45,37,8,39,6,0,1,5,20,8,8,3,0,0,20,14,3,37
20200809,09AUG2020:00:00:00,UFU RIVADAVIA,16,14,25,5,0,30,24,6,24,6,0,0,4,7,7,9,2,1,0,9,13,2,24
20200809,09AUG2020:00:00:00,UFU SANTOJANNI,1,5,3,3,0,6,6,0,6,0,0,0,2,0,1,1,1,1,0,4,2,0,6
20200809,09AUG2020:00:00:00,UFU TORNU,22,28,27,16,7,50,40,10,46,4,0,3,8,12,10,9,8,0,0,13,16,11,40
20200809,09AUG2020:00:00:00,UFU VELEZ SARSFIELD,27,16,31,10,2,43,37,6,43,0,2,4,14,9,5,9,0,0,0,13,9,15,37
20200809,09AUG2020:00:00:00,UFU ZUBIZARRETA,15,8,15,8,0,23,23,0,23,0,0,2,2,10,6,2,1,0,0,3,10,10,23
20200810,10AUG2020:00:00:00,UFU ALVAREZ,43,21,44,20,0,64,50,14,56,8,5,5,19,9,11,9,6,0,0,17,9,24,50
20200810,10AUG2020:00:00:00,UFU ARGERICH,51,43,45,45,4,94,44,50,74,20,8,1,14,23,27,14,5,2,0,16,19,9,44
20200810,10AUG2020:00:00:00,UFU BORDA-MOYANO,29,9,19,16,3,38,36,2,36,2,0,6,2,9,9,6,6,0,0,5,25,6,36
20200810,10AUG2020:00:00:00,UFU DURAND,44,30,59,15,0,74,66,8,66,8,0,3,17,22,20,7,3,2,0,23,39,4,66
20200810,10AUG2020:00:00:00,UFU ELIZALDE,31,12,12,27,4,43,27,16,35,8,14,9,4,5,9,1,1,0,0,4,21,2,27
20200810,10AUG2020:00:00:00,UFU FERNANDEZ,30,26,34,20,2,56,50,6,52,4,0,0,13,15,6,8,14,0,0,18,17,15,50
20200810,10AUG2020:00:00:00,UFU FERRER,31,23,18,36,0,54,46,8,46,8,0,0,9,26,10,7,2,0,0,7,32,7,46
20200810,10AUG2020:00:00:00,UFU GRIERSON,16,13,20,9,0,29,29,0,29,0,1,0,5,9,9,4,1,0,0,8,18,3,29
20200810,10AUG2020:00:00:00,UFU GUTIERREZ,30,12,19,23,0,42,36,6,42,0,13,9,3,10,4,0,3,0,0,2,28,6,36
20200810,10AUG2020:00:00:00,UFU MUÑIZ,57,59,63,53,0,116,80,36,94,22,3,5,12,27,26,27,14,2,0,21,50,9,80
20200810,10AUG2020:00:00:00,UFU PENNA,10,19,21,8,0,29,23,6,25,4,0,0,4,10,6,8,1,0,0,5,14,4,23
20200810,10AUG2020:00:00:00,UFU PIROVANO,24,19,34,9,0,43,41,2,43,0,0,0,9,15,7,4,8,0,0,9,21,10,41
20200810,10AUG2020:00:00:00,UFU PIÑERO,35,53,61,17,10,88,64,24,74,14,10,2,18,24,10,13,10,1,0,20,35,8,64
20200810,10AUG2020:00:00:00,UFU RAMOS MEJIA,37,48,65,14,6,85,79,6,79,6,1,1,25,22,18,9,7,2,0,33,31,15,79
20200810,10AUG2020:00:00:00,UFU RIVADAVIA,39,35,40,29,5,74,68,6,70,4,0,0,15,23,16,13,3,4,0,16,36,16,68
20200810,10AUG2020:00:00:00,UFU SANTOJANNI,29,31,28,31,1,60,50,10,54,6,3,0,10,21,17,8,1,0,0,20,28,2,50
20200810,10AUG2020:00:00:00,UFU TORNU,35,41,49,22,5,76,60,16,64,12,9,3,16,17,16,12,1,2,0,26,22,12,60
20200810,10AUG2020:00:00:00,UFU VELEZ SARSFIELD,25,32,35,22,0,57,49,8,57,0,0,0,2,14,18,17,4,2,0,15,15,19,49
20200810,10AUG2020:00:00:00,UFU ZUBIZARRETA,20,5,8,17,0,25,15,10,17,8,0,0,5,9,4,4,1,2,0,7,4,4,15
20200811,11AUG2020:00:00:00,UFU ALVAREZ,40,32,55,15,2,72,66,6,68,4,2,2,14,24,14,13,3,0,0,8,12,46,66
20200811,11AUG2020:00:00:00,UFU ARGERICH,34,30,37,27,0,64,50,14,50,14,4,1,20,15,13,5,2,4,0,12,32,6,50
20200811,11AUG2020:00:00:00,UFU BORDA-MOYANO,17,34,25,26,0,51,7,44,7,44,0,0,13,8,13,13,2,2,0,0,6,1,7
20200811,11AUG2020:00:00:00,UFU DURAND,23,30,34,18,1,53,53,0,53,0,0,0,18,16,4,11,2,2,0,16,31,6,53
20200811,11AUG2020:00:00:00,UFU ELIZALDE,15,13,6,22,0,28,24,4,24,4,12,8,1,5,0,0,2,0,0,2,18,4,24
20200811,11AUG2020:00:00:00,UFU FERNANDEZ,19,22,34,7,0,41,41,0,41,0,0,0,8,15,10,4,3,1,0,13,18,10,41
20200811,11AUG2020:00:00:00,UFU FERRER,25,26,23,28,0,51,39,12,39,12,0,1,10,11,18,6,5,0,0,12,22,5,39
20200811,11AUG2020:00:00:00,UFU GRIERSON,19,21,27,13,0,40,40,0,40,0,0,3,9,13,5,8,2,0,0,13,24,3,40
20200811,11AUG2020:00:00:00,UFU GUTIERREZ,44,16,37,23,0,60,60,0,60,0,17,8,13,15,5,2,0,0,0,11,41,8,60
20200811,11AUG2020:00:00:00,UFU MUÑIZ,67,74,87,49,5,141,117,24,119,22,2,2,17,40,39,23,13,5,0,25,72,20,117
20200811,11AUG2020:00:00:00,UFU PENNA,14,13,21,5,1,27,23,4,23,4,0,2,3,9,5,7,1,0,0,11,7,5,23
20200811,11AUG2020:00:00:00,UFU PIROVANO,16,18,20,14,0,34,28,6,30,4,0,3,3,4,3,14,7,0,0,4,22,2,28
20200811,11AUG2020:00:00:00,UFU PIÑERO,28,35,47,14,2,63,45,18,53,10,3,4,12,12,17,5,9,1,0,12,24,9,45
20200811,11AUG2020:00:00:00,UFU RAMOS MEJIA,30,46,53,21,2,76,68,8,68,8,3,0,21,21,14,4,8,5,0,19,43,6,68
20200811,11AUG2020:00:00:00,UFU RIVADAVIA,32,24,30,24,2,56,52,4,52,4,0,0,10,13,11,13,9,0,0,9,32,10,52
20200811,11AUG2020:00:00:00,UFU SANTOJANNI,35,31,36,30,0,66,62,4,66,0,3,2,12,12,19,6,10,2,0,18,44,0,62
20200811,11AUG2020:00:00:00,UFU TORNU,43,50,66,26,1,93,89,4,89,4,3,4,24,23,16,13,6,4,0,20,54,15,89
20200811,11AUG2020:00:00:00,UFU VELEZ SARSFIELD,31,30,33,28,0,61,59,2,61,0,0,4,12,16,8,13,8,0,0,15,20,24,59
20200811,11AUG2020:00:00:00,UFU ZUBIZARRETA,17,9,12,14,0,26,8,18,14,12,0,0,3,9,5,3,4,2,0,3,3,2,8
20200812,12AUG2020:00:00:00,UFU ALVAREZ,48,44,63,27,2,92,76,16,78,14,9,8,33,17,13,3,6,3,0,19,6,51,76
20200812,12AUG2020:00:00:00,UFU ARGERICH,23,42,41,18,6,65,47,18,47,18,2,1,14,18,13,5,9,3,0,19,19,9,47
20200812,12AUG2020:00:00:00,UFU BORDA-MOYANO,14,5,17,2,0,19,19,0,19,0,0,0,5,2,2,7,2,1,0,2,10,7,19
20200812,12AUG2020:00:00:00,UFU DURAND,41,29,52,18,0,70,66,4,68,2,1,0,13,18,18,15,4,1,0,26,30,10,66
20200812,12AUG2020:00:00:00,UFU ELIZALDE,32,26,30,26,2,58,30,28,38,20,34,11,2,6,3,2,0,0,0,10,16,4,30
20200812,12AUG2020:00:00:00,UFU FERNANDEZ,27,23,36,8,6,50,40,10,46,4,2,0,11,17,9,5,4,2,0,12,17,11,40
20200812,12AUG2020:00:00:00,UFU FERRER,42,26,26,42,0,68,60,8,62,6,0,0,21,23,10,10,4,0,0,19,32,9,60
20200812,12AUG2020:00:00:00,UFU GRIERSON,27,31,35,23,0,58,58,0,58,0,1,2,12,22,12,8,1,0,0,9,45,4,58
20200812,12AUG2020:00:00:00,UFU GUTIERREZ,20,6,14,12,0,26,24,2,24,2,4,4,3,10,4,1,0,0,0,4,19,1,24
20200812,12AUG2020:00:00:00,UFU MUÑIZ,42,73,53,57,5,115,65,50,79,36,4,3,20,22,27,22,11,6,0,16,40,9,65
20200812,12AUG2020:00:00:00,UFU PENNA,15,16,20,11,0,31,25,6,29,2,0,0,3,10,8,7,2,1,0,6,18,1,25
20200812,12AUG2020:00:00:00,UFU PIROVANO,24,18,34,8,0,42,38,4,40,2,0,0,6,17,8,5,1,5,0,11,24,3,38
20200812,12AUG2020:00:00:00,UFU PIÑERO,52,35,72,10,5,87,83,4,83,4,0,1,20,24,17,17,7,1,0,23,37,23,83
20200812,12AUG2020:00:00:00,UFU RAMOS MEJIA,39,47,72,13,1,86,82,4,82,4,7,5,20,20,14,11,5,4,0,36,33,13,82
20200812,12AUG2020:00:00:00,UFU RIVADAVIA,36,26,36,22,4,62,62,0,62,0,0,0,15,23,10,10,3,1,0,11,40,10,62
20200812,12AUG2020:00:00:00,UFU SANTOJANNI,23,26,15,31,3,49,33,16,41,8,2,0,5,18,13,9,2,0,0,6,24,3,33
20200812,12AUG2020:00:00:00,UFU TORNU,23,35,40,16,2,58,56,2,56,2,3,2,15,11,10,10,7,0,0,18,24,13,56
20200812,12AUG2020:00:00:00,UFU VELEZ SARSFIELD,22,17,21,18,0,39,33,6,37,2,0,0,8,18,4,6,3,0,0,10,12,11,33
20200812,12AUG2020:00:00:00,UFU ZUBIZARRETA,14,17,19,10,2,31,15,16,27,4,0,0,10,13,3,2,3,0,0,5,7,3,15
20200813,13AUG2020:00:00:00,UFU ALVAREZ,22,21,33,9,1,43,41,2,41,2,2,0,9,14,6,6,5,1,0,10,14,17,41
20200813,13AUG2020:00:00:00,UFU ARGERICH,39,36,45,29,1,75,43,32,59,16,2,2,12,21,18,10,6,4,0,15,21,7,43
20200813,13AUG2020:00:00:00,UFU BORDA-MOYANO,36,14,37,13,0,50,48,2,48,2,0,0,3,6,13,11,7,10,0,5,38,5,48
20200813,13AUG2020:00:00:00,UFU DURAND,47,49,68,28,0,96,94,2,94,2,0,2,25,23,21,13,9,3,0,35,47,12,94
20200813,13AUG2020:00:00:00,UFU ELIZALDE,21,16,24,15,0,39,21,18,31,8,14,16,1,3,1,4,0,0,0,3,15,3,21
20200813,13AUG2020:00:00:00,UFU FERNANDEZ,29,18,34,9,4,47,43,4,45,2,0,0,11,17,7,6,5,1,0,12,22,9,43
20200813,13AUG2020:00:00:00,UFU FERRER,21,28,16,33,0,49,47,2,49,0,0,0,10,11,17,8,3,0,0,15,24,8,47
20200813,13AUG2020:00:00:00,UFU GRIERSON,21,20,20,19,2,41,41,0,41,0,0,0,5,17,11,7,1,0,0,9,28,4,41
20200813,13AUG2020:00:00:00,UFU GUTIERREZ,24,15,23,15,1,39,37,2,39,0,14,1,4,15,4,1,0,0,0,0,28,9,37
20200813,13AUG2020:00:00:00,UFU MUÑIZ,56,67,58,65,0,123,87,36,99,24,3,0,21,41,27,15,9,7,0,28,48,11,87
20200813,13AUG2020:00:00:00,UFU PENNA,19,16,25,10,0,35,29,6,31,4,0,0,8,14,8,4,1,0,0,7,16,6,29
20200813,13AUG2020:00:00:00,UFU PIROVANO,33,19,39,10,3,52,48,4,50,2,3,2,12,14,11,5,5,0,0,6,36,6,48
20200813,13AUG2020:00:00:00,UFU PIÑERO,41,57,56,39,3,98,74,24,82,16,8,5,17,29,18,11,7,3,0,19,42,12,74
20200813,13AUG2020:00:00:00,UFU RAMOS MEJIA,45,37,72,9,1,82,72,10,72,10,4,2,23,21,11,10,8,3,0,21,37,14,72
20200813,13AUG2020:00:00:00,UFU RIVADAVIA,27,35,33,24,5,62,58,4,58,4,0,1,17,26,6,8,4,0,0,14,34,9,58
20200813,13AUG2020:00:00:00,UFU SANTOJANNI,22,39,38,21,2,61,53,8,59,2,3,4,10,14,11,13,6,0,0,12,38,3,53
20200813,13AUG2020:00:00:00,UFU TORNU,37,44,45,34,2,81,71,10,77,4,0,0,13,24,18,12,9,5,0,12,42,16,71
20200813,13AUG2020:00:00:00,UFU VELEZ SARSFIELD,35,13,30,18,0,48,42,6,48,0,0,0,11,15,11,4,7,0,0,3,22,17,42
20200813,13AUG2020:00:00:00,UFU ZUBIZARRETA,21,22,29,12,2,43,27,16,35,8,4,0,13,9,8,6,3,0,0,5,12,10,27
20200814,14AUG2020:00:00:00,UFU ALVAREZ,37,32,49,17,3,69,55,14,65,4,6,0,18,11,15,6,7,6,0,18,27,10,55
20200814,14AUG2020:00:00:00,UFU ARGERICH,38,23,41,20,0,61,49,12,51,10,1,2,12,21,7,4,7,7,0,14,22,13,49
20200814,14AUG2020:00:00:00,UFU BORDA-MOYANO,24,19,36,5,2,43,37,6,39,4,0,0,2,7,11,12,11,0,0,1,25,11,37
20200814,14AUG2020:00:00:00,UFU DURAND,41,47,72,16,0,88,78,10,82,6,2,1,21,33,15,14,1,1,0,26,39,13,78
20200814,14AUG2020:00:00:00,UFU ELIZALDE,38,16,24,30,0,54,32,22,38,16,23,10,0,9,2,5,5,0,0,3,24,5,32
20200814,14AUG2020:00:00:00,UFU FERNANDEZ,19,25,34,8,2,44,42,2,42,2,0,0,7,14,8,9,4,2,0,11,23,8,42
20200814,14AUG2020:00:00:00,UFU FERRER,21,36,26,31,0,57,33,24,33,24,0,0,6,18,13,17,2,1,0,12,15,6,33
20200814,14AUG2020:00:00:00,UFU GRIERSON,20,20,20,20,0,40,40,0,40,0,0,1,7,13,10,8,1,0,0,10,28,2,40
20200814,14AUG2020:00:00:00,UFU GUTIERREZ,33,11,32,12,0,44,44,0,44,0,9,11,9,11,0,3,1,0,0,2,35,7,44
20200814,14AUG2020:00:00:00,UFU MUÑIZ,62,61,80,41,2,123,87,36,103,20,0,1,17,42,31,17,3,12,0,24,48,15,87
20200814,14AUG2020:00:00:00,UFU PENNA,20,9,18,11,0,29,29,0,29,0,0,0,6,12,8,0,2,1,0,6,14,9,29
20200814,14AUG2020:00:00:00,UFU PIROVANO,33,10,25,16,2,43,39,4,39,4,0,1,6,13,6,11,5,1,0,3,30,5,39
20200814,14AUG2020:00:00:00,UFU PIÑERO,47,36,61,19,3,83,67,16,73,10,3,10,19,21,7,11,7,5,0,20,40,7,67
20200814,14AUG2020:00:00:00,UFU RAMOS MEJIA,46,29,55,17,3,75,69,6,69,6,0,0,13,20,22,13,6,1,0,19,37,13,69
20200814,14AUG2020:00:00:00,UFU RIVADAVIA,36,35,46,21,4,71,69,2,71,0,0,1,13,21,13,15,8,0,0,25,38,6,69
20200814,14AUG2020:00:00:00,UFU SANTOJANNI,27,25,32,20,0,52,38,14,52,0,9,2,7,12,9,8,4,1,0,13,25,0,38
20200814,14AUG2020:00:00:00,UFU TORNU,40,33,56,15,2,73,63,10,67,6,2,7,12,30,10,11,1,0,0,23,27,12,63
20200814,14AUG2020:00:00:00,UFU VELEZ SARSFIELD,31,14,27,18,0,45,35,10,43,2,0,0,8,10,10,7,10,0,0,10,11,14,35
20200814,14AUG2020:00:00:00,UFU ZUBIZARRETA,52,26,48,30,0,78,64,14,68,10,2,0,7,20,27,12,5,5,0,6,23,35,64
20200815,15AUG2020:00:00:00,UFU ALVAREZ,22,35,47,10,0,57,53,4,53,4,3,4,13,19,4,10,3,1,0,9,8,36,53
20200815,15AUG2020:00:00:00,UFU ARGERICH,36,26,38,20,4,62,24,38,24,38,1,2,1,21,12,14,6,5,0,11,9,4,24
20200815,15AUG2020:00:00:00,UFU BORDA-MOYANO,13,10,12,11,0,23,21,2,21,2,0,2,2,10,2,4,1,2,0,2,12,7,21
20200815,15AUG2020:00:00:00,UFU DURAND,18,19,31,6,0,37,37,0,37,0,1,5,6,5,10,6,4,0,0,19,12,6,37
20200815,15AUG2020:00:00:00,UFU ELIZALDE,9,7,8,8,0,16,14,2,14,2,8,4,0,4,0,0,0,0,0,2,11,1,14
20200815,15AUG2020:00:00:00,UFU FERNANDEZ,28,16,33,11,0,44,44,0,44,0,0,5,5,19,8,4,2,1,0,11,26,7,44
20200815,15AUG2020:00:00:00,UFU FERRER,21,28,21,28,0,49,29,20,29,20,0,0,9,19,11,10,0,0,0,13,16,0,29
20200815,15AUG2020:00:00:00,UFU GRIERSON,20,28,33,13,2,48,36,12,46,2,6,3,16,12,5,3,1,2,0,16,19,1,36
20200815,15AUG2020:00:00:00,UFU GUTIERREZ,16,11,14,13,0,27,23,4,25,2,7,1,5,6,7,0,1,0,0,4,17,1,23
20200815,15AUG2020:00:00:00,UFU MUÑIZ,60,65,66,59,0,125,103,22,111,14,2,4,19,20,38,27,6,9,0,27,57,19,103
20200815,15AUG2020:00:00:00,UFU PENNA,13,16,24,5,0,29,23,6,25,4,0,0,7,6,3,10,3,0,0,11,8,4,23
20200815,15AUG2020:00:00:00,UFU PIROVANO,14,10,17,7,0,24,24,0,24,0,1,0,5,5,9,0,1,3,0,5,16,3,24
20200815,15AUG2020:00:00:00,UFU PIÑERO,29,28,36,18,3,57,51,6,51,6,0,2,6,15,22,9,3,0,0,13,19,19,51
20200815,15AUG2020:00:00:00,UFU RAMOS MEJIA,33,28,52,6,3,61,59,2,61,0,1,1,9,22,9,10,4,5,0,30,19,10,59
20200815,15AUG2020:00:00:00,UFU RIVADAVIA,21,7,18,10,0,28,22,6,24,4,0,0,7,10,3,5,3,0,0,8,11,3,22
20200815,15AUG2020:00:00:00,UFU SANTOJANNI,7,8,5,10,0,15,11,4,13,2,2,0,2,4,5,0,2,0,0,4,7,0,11
20200815,15AUG2020:00:00:00,UFU TORNU,32,30,30,25,7,62,58,4,60,2,0,1,12,13,17,11,7,1,0,21,21,15,58
20200815,15AUG2020:00:00:00,UFU VELEZ SARSFIELD,17,20,19,18,0,37,33,4,35,2,0,0,3,11,13,6,4,0,0,6,15,12,33
20200815,15AUG2020:00:00:00,UFU ZUBIZARRETA,17,9,23,3,0,26,18,8,24,2,0,2,2,7,8,7,0,0,0,5,9,4,18
20200816,16AUG2020:00:00:00,UFU ALVAREZ,15,15,24,6,0,30,26,4,26,4,3,0,9,3,10,5,0,0,0,7,8,11,26
20200816,16AUG2020:00:00:00,UFU ARGERICH,10,6,9,7,0,16,10,6,12,4,0,3,3,5,1,3,1,0,0,8,2,0,10
20200816,16AUG2020:00:00:00,UFU BORDA-MOYANO,3,3,4,2,0,6,6,0,6,0,0,0,0,1,3,1,1,0,0,1,5,0,6
20200816,16AUG2020:00:00:00,UFU DURAND,30,14,34,10,0,44,38,6,38,6,0,1,11,17,7,5,2,1,0,12,21,5,38
20200816,16AUG2020:00:00:00,UFU ELIZALDE,5,7,7,5,0,12,10,2,10,2,7,2,0,0,0,2,1,0,0,3,7,0,10
20200816,16AUG2020:00:00:00,UFU FERNANDEZ,11,13,19,5,0,24,20,4,22,2,0,0,9,8,2,5,0,0,0,9,6,5,20
20200816,16AUG2020:00:00:00,UFU FERRER,13,7,9,11,0,20,20,0,20,0,0,0,4,9,5,2,0,0,0,13,6,1,20
20200816,16AUG2020:00:00:00,UFU GRIERSON,18,16,19,15,0,34,22,12,32,2,2,2,9,12,4,1,1,3,0,9,13,0,22
20200816,16AUG2020:00:00:00,UFU GUTIERREZ,24,12,29,7,0,36,34,2,34,2,7,3,4,8,7,3,2,2,0,4,27,2,34
20200816,16AUG2020:00:00:00,UFU MUÑIZ,39,37,50,26,0,76,50,26,54,22,1,3,3,18,25,22,4,0,0,23,23,4,50
20200816,16AUG2020:00:00:00,UFU PENNA,14,11,11,14,0,25,21,4,21,4,0,0,2,5,11,6,1,0,0,7,8,6,21
20200816,16AUG2020:00:00:00,UFU PIROVANO,18,23,29,12,0,41,37,4,41,0,1,2,12,13,8,3,1,1,0,7,25,5,37
20200816,16AUG2020:00:00:00,UFU PIÑERO,24,16,28,12,0,40,34,6,40,0,1,0,9,11,7,8,2,2,0,13,16,5,34
20200816,16AUG2020:00:00:00,UFU RAMOS MEJIA,31,25,45,9,2,56,46,10,46,10,3,2,9,11,8,14,5,4,0,31,7,8,46
20200816,16AUG2020:00:00:00,UFU RIVADAVIA,19,13,20,12,0,32,28,4,28,4,0,1,7,13,7,3,1,0,0,7,17,2,28
20200816,16AUG2020:00:00:00,UFU SANTOJANNI,22,20,26,16,0,42,24,18,24,18,6,1,7,12,1,11,3,1,0,11,11,2,24
20200816,16AUG2020:00:00:00,UFU TORNU,19,32,25,23,3,51,49,2,51,0,0,3,15,12,13,2,6,0,0,16,26,7,49
20200816,16AUG2020:00:00:00,UFU VELEZ SARSFIELD,35,5,29,9,2,40,36,4,38,2,4,2,11,7,8,6,2,0,0,11,9,16,36
20200816,16AUG2020:00:00:00,UFU ZUBIZARRETA,23,12,32,3,0,35,25,10,31,4,2,0,7,7,9,3,3,4,0,8,3,14,25
20200817,17AUG2020:00:00:00,UFU ALVAREZ,20,17,33,4,0,37,31,6,35,2,1,1,11,8,3,8,5,0,0,6,19,6,31
20200817,17AUG2020:00:00:00,UFU ARGERICH,25,28,41,12,0,53,39,14,41,12,1,2,10,8,6,16,8,2,0,16,9,14,39
20200817,17AUG2020:00:00:00,UFU BORDA-MOYANO,1,17,18,0,0,18,14,4,14,4,0,0,1,2,6,7,1,1,0,0,11,3,14
20200817,17AUG2020:00:00:00,UFU DURAND,38,30,51,15,2,68,60,8,62,6,4,2,11,21,16,9,4,1,0,29,24,7,60
20200817,17AUG2020:00:00:00,UFU ELIZALDE,8,9,8,9,0,17,13,4,13,4,9,1,2,2,1,2,0,0,0,1,8,4,13
20200817,17AUG2020:00:00:00,UFU FERNANDEZ,30,16,32,14,0,46,46,0,46,0,0,0,7,21,5,6,2,5,0,15,22,9,46
20200817,17AUG2020:00:00:00,UFU FERRER,30,32,32,30,0,62,54,8,54,8,0,0,17,17,17,6,4,1,0,21,29,4,54
20200817,17AUG2020:00:00:00,UFU GRIERSON,22,27,28,19,2,49,41,8,47,2,0,3,13,16,9,5,2,1,0,17,24,0,41
20200817,17AUG2020:00:00:00,UFU GUTIERREZ,29,12,23,18,0,41,37,4,41,0,6,6,10,16,1,1,1,0,0,1,30,5,37
20200817,17AUG2020:00:00:00,UFU MUÑIZ,39,44,43,40,0,83,51,32,59,24,0,2,14,24,16,20,4,3,0,18,27,6,51
20200817,17AUG2020:00:00:00,UFU PENNA,15,12,16,11,0,27,23,4,27,0,0,0,3,6,5,9,4,0,0,6,9,8,23
20200817,17AUG2020:00:00:00,UFU PIROVANO,13,14,25,0,2,27,23,4,25,2,0,2,4,13,3,4,0,1,0,7,14,2,23
20200817,17AUG2020:00:00:00,UFU PIÑERO,40,39,55,23,1,79,61,18,71,8,0,5,15,20,15,13,7,4,0,20,35,6,61
20200817,17AUG2020:00:00:00,UFU RAMOS MEJIA,22,25,35,8,4,47,45,2,47,0,0,1,15,16,4,8,2,1,0,17,16,12,45
20200817,17AUG2020:00:00:00,UFU RIVADAVIA,25,21,36,9,1,46,42,4,42,4,0,0,10,15,12,4,4,1,0,18,17,6,42
20200817,17AUG2020:00:00:00,UFU SANTOJANNI,14,8,12,10,0,22,20,2,22,0,0,0,3,9,3,4,1,2,0,7,12,1,20
20200817,17AUG2020:00:00:00,UFU TORNU,35,35,23,43,4,70,64,6,68,2,0,4,17,16,12,14,6,1,0,22,20,22,64
20200817,17AUG2020:00:00:00,UFU VELEZ SARSFIELD,8,10,15,3,0,18,14,4,16,2,0,0,6,5,2,1,0,4,0,3,6,5,14
20200817,17AUG2020:00:00:00,UFU ZUBIZARRETA,34,10,25,19,0,44,34,10,44,0,2,0,8,16,7,5,4,2,0,0,2,32,34
20200818,18AUG2020:00:00:00,UFU ALVAREZ,18,17,30,5,0,35,33,2,33,2,2,0,7,6,10,6,3,1,0,16,6,11,33
20200818,18AUG2020:00:00:00,UFU ARGERICH,33,37,47,23,0,70,45,25,45,25,7,4,7,13,15,12,6,6,0,21,19,5,45
20200818,18AUG2020:00:00:00,UFU BORDA-MOYANO,39,10,29,20,0,49,5,44,5,44,0,2,15,7,12,7,4,2,0,3,1,1,5
20200818,18AUG2020:00:00:00,UFU DURAND,42,32,62,10,2,74,56,18,64,10,2,1,19,18,17,10,4,3,0,30,22,4,56
20200818,18AUG2020:00:00:00,UFU ELIZALDE,20,18,19,17,2,38,18,20,32,6,18,10,0,1,3,4,2,0,0,4,10,4,18
20200818,18AUG2020:00:00:00,UFU FERNANDEZ,24,34,43,15,0,58,52,6,58,0,0,4,11,18,7,10,6,2,0,17,25,10,52
20200818,18AUG2020:00:00:00,UFU FERRER,49,51,47,52,1,100,86,14,86,14,0,0,30,26,21,16,7,0,0,31,42,13,86
20200818,18AUG2020:00:00:00,UFU GRIERSON,50,33,62,21,0,83,73,10,77,6,1,4,19,22,18,14,4,1,0,20,46,7,73
20200818,18AUG2020:00:00:00,UFU GUTIERREZ,43,22,44,21,0,65,57,8,63,2,23,5,9,17,6,3,1,1,0,4,40,13,57
20200818,18AUG2020:00:00:00,UFU MUÑIZ,71,92,82,79,2,163,129,34,131,32,6,5,32,50,32,25,12,1,0,37,68,24,129
20200818,18AUG2020:00:00:00,UFU PENNA,13,14,16,11,0,27,23,4,25,2,0,0,9,1,9,7,0,1,0,7,14,2,23
20200818,18AUG2020:00:00:00,UFU PIROVANO,11,26,29,5,3,37,33,4,35,2,0,1,5,14,5,7,5,0,0,8,20,5,33
20200818,18AUG2020:00:00:00,UFU PIÑERO,29,37,46,19,1,66,56,10,62,4,3,8,17,15,8,10,3,2,0,25,30,1,56
20200818,18AUG2020:00:00:00,UFU RAMOS MEJIA,49,57,87,19,0,106,94,12,94,12,6,3,27,22,21,17,8,2,0,36,43,15,94
20200818,18AUG2020:00:00:00,UFU RIVADAVIA,29,35,39,23,2,64,60,4,60,4,0,0,17,16,8,17,5,1,0,19,26,15,60
20200818,18AUG2020:00:00:00,UFU SANTOJANNI,44,34,54,24,0,78,72,6,78,0,3,6,17,16,15,10,11,0,0,30,40,2,72
20200818,18AUG2020:00:00:00,UFU TORNU,44,30,44,28,2,74,66,8,66,8,2,1,20,23,13,12,3,0,0,19,28,19,66
20200818,18AUG2020:00:00:00,UFU VELEZ SARSFIELD,20,8,18,10,0,28,24,4,28,0,0,0,3,6,8,7,2,2,0,6,10,8,24
20200818,18AUG2020:00:00:00,UFU ZUBIZARRETA,46,11,34,23,0,57,31,26,35,22,1,0,18,8,15,8,5,2,0,11,8,12,31
20200819,19AUG2020:00:00:00,UFU ALVAREZ,11,8,19,0,0,19,19,0,19,0,0,1,4,6,1,3,4,0,0,6,6,7,19
20200819,19AUG2020:00:00:00,UFU ARGERICH,52,49,63,33,5,101,67,34,71,30,5,7,9,33,15,18,8,6,0,29,20,18,67
20200819,19AUG2020:00:00:00,UFU BORDA-MOYANO,9,7,9,7,0,16,12,4,12,4,0,0,1,7,2,2,2,2,0,1,9,2,12
20200819,19AUG2020:00:00:00,UFU DURAND,48,32,60,17,3,80,66,14,72,8,0,1,16,26,12,14,8,3,0,33,22,11,66
20200819,19AUG2020:00:00:00,UFU ELIZALDE,15,25,13,27,0,40,28,12,30,10,25,5,1,2,1,2,2,2,0,2,20,6,28
20200819,19AUG2020:00:00:00,UFU FERNANDEZ,24,16,28,11,1,40,40,0,40,0,0,0,9,16,8,5,2,0,0,14,18,8,40
20200819,19AUG2020:00:00:00,UFU FERRER,32,39,39,32,0,71,55,16,55,16,0,0,25,9,26,8,1,2,0,22,24,9,55
20200819,19AUG2020:00:00:00,UFU GRIERSON,41,41,54,26,2,82,74,8,74,8,0,1,22,25,15,13,6,0,0,26,41,7,74
20200819,19AUG2020:00:00:00,UFU GUTIERREZ,33,17,23,27,0,50,35,15,47,3,13,3,10,11,6,3,2,2,0,5,23,6,35
20200819,19AUG2020:00:00:00,UFU MUÑIZ,91,114,73,130,2,205,131,74,143,62,7,10,49,50,44,31,14,0,0,28,87,16,131
20200819,19AUG2020:00:00:00,UFU PENNA,14,12,19,6,1,26,20,6,22,4,0,0,4,7,7,2,5,1,0,10,9,1,20
20200819,19AUG2020:00:00:00,UFU PIROVANO,16,10,20,6,0,26,24,2,24,2,0,3,4,9,4,1,4,1,0,4,20,0,24
20200819,19AUG2020:00:00:00,UFU PIÑERO,26,35,35,21,5,61,55,6,55,6,1,3,15,13,11,8,7,3,0,16,35,4,55
20200819,19AUG2020:00:00:00,UFU RAMOS MEJIA,45,35,63,14,3,80,76,4,76,4,3,5,18,22,12,10,10,0,0,32,28,16,76
20200819,19AUG2020:00:00:00,UFU RIVADAVIA,36,40,44,30,2,76,66,10,66,10,0,2,17,25,15,12,1,4,0,16,37,12,66
20200819,19AUG2020:00:00:00,UFU SANTOJANNI,39,29,28,38,2,68,60,8,68,0,2,1,6,25,17,11,3,3,0,19,39,2,60
20200819,19AUG2020:00:00:00,UFU TORNU,55,41,56,35,5,96,82,14,86,10,2,6,27,19,22,11,5,4,0,25,42,15,82
20200819,19AUG2020:00:00:00,UFU VELEZ SARSFIELD,21,24,35,10,0,45,45,0,45,0,0,0,9,24,8,4,0,0,0,14,12,19,45
20200819,19AUG2020:00:00:00,UFU ZUBIZARRETA,41,37,46,29,3,78,46,32,52,26,0,1,15,21,19,12,6,4,0,9,16,21,46
20200820,20AUG2020:00:00:00,UFU ALVAREZ,14,15,20,9,0,29,27,2,27,2,0,1,10,11,3,2,2,0,0,2,4,21,27
20200820,20AUG2020:00:00:00,UFU ARGERICH,33,29,40,18,4,62,46,16,52,10,1,1,15,9,15,10,9,2,0,15,17,14,46
20200820,20AUG2020:00:00:00,UFU BORDA-MOYANO,33,7,32,8,0,40,40,0,40,0,0,0,2,3,8,9,10,8,0,2,33,5,40
20200820,20AUG2020:00:00:00,UFU DURAND,63,38,72,29,0,101,61,40,67,34,1,2,15,33,29,13,8,0,0,24,31,6,61
20200820,20AUG2020:00:00:00,UFU ELIZALDE,25,26,29,21,1,51,37,14,45,6,22,16,2,8,1,0,1,1,0,7,16,14,37
20200820,20AUG2020:00:00:00,UFU FERNANDEZ,20,27,41,3,3,47,35,12,41,6,0,0,12,9,11,13,1,1,0,11,17,7,35
20200820,20AUG2020:00:00:00,UFU FERRER,44,42,38,47,1,86,66,20,66,20,0,0,25,31,11,14,3,2,0,20,35,11,66
20200820,20AUG2020:00:00:00,UFU GRIERSON,51,29,33,46,1,80,78,2,78,2,1,4,13,32,16,7,3,4,0,29,43,6,78
20200820,20AUG2020:00:00:00,UFU GUTIERREZ,27,20,20,27,0,47,45,2,47,0,16,7,7,8,9,0,0,0,0,1,30,12,45
20200820,20AUG2020:00:00:00,UFU MUÑIZ,105,157,107,147,8,262,154,108,178,84,1,16,56,71,58,46,11,3,0,46,91,17,154
20200820,20AUG2020:00:00:00,UFU PENNA,23,9,22,9,1,32,30,2,30,2,0,0,1,8,5,15,3,0,0,6,18,6,30
20200820,20AUG2020:00:00:00,UFU PIROVANO,24,24,35,11,2,48,46,2,48,0,2,0,13,14,5,10,4,0,0,5,18,22,46
20200820,20AUG2020:00:00:00,UFU PIÑERO,42,47,58,30,1,89,77,12,81,8,1,2,23,24,20,14,1,4,0,25,45,7,77
20200820,20AUG2020:00:00:00,UFU RAMOS MEJIA,62,48,82,22,6,110,96,14,104,6,2,4,21,32,26,14,9,2,0,35,38,23,96
20200911,11SEP2020:00:00:00,UFU PIROVANO,21,14,28,7,0,35,31,4,33,2,1,0,6,11,6,9,2,0,0,4,24,3,31
20200911,11SEP2020:00:00:00,UFU PIÑERO,44,30,46,19,9,74,58,16,68,6,7,0,17,17,17,9,5,2,0,18,36,3,58
20200911,11SEP2020:00:00:00,UFU RAMOS MEJIA,42,45,58,23,6,87,81,6,83,4,1,3,23,25,21,7,6,1,0,28,46,7,81
20200911,11SEP2020:00:00:00,UFU RIVADAVIA,49,49,61,32,5,98,90,8,94,4,0,1,21,34,15,23,4,0,0,24,53,12,90
20200911,11SEP2020:00:00:00,UFU SANTOJANNI,34,27,28,31,2,61,57,4,59,2,3,2,21,12,11,8,3,1,0,17,36,4,57
20200911,11SEP2020:00:00:00,UFU TORNU,56,58,86,22,6,114,90,24,90,24,6,5,29,27,19,16,4,8,0,20,52,17,90
20200911,11SEP2020:00:00:00,UFU VELEZ SARSFIELD,14,14,23,5,0,28,26,2,28,0,0,3,4,7,4,1,5,4,0,7,18,1,26
20200911,11SEP2020:00:00:00,UFU ZUBIZARRETA,37,48,54,29,2,85,55,30,67,18,0,0,14,25,18,13,15,0,0,17,29,9,55
20200912,12SEP2020:00:00:00,UFU ALVAREZ,7,11,12,3,3,18,10,8,10,8,2,2,6,2,6,0,0,0,0,0,8,2,10
20200912,12SEP2020:00:00:00,UFU ARGERICH,7,9,12,4,0,16,14,2,14,2,0,0,4,2,3,5,0,2,0,4,5,5,14
20200912,12SEP2020:00:00:00,UFU BORDA-MOYANO,29,7,29,7,0,36,28,8,28,8,0,0,3,6,4,12,10,1,0,4,17,7,28
20200912,12SEP2020:00:00:00,UFU DURAND,39,22,49,12,0,61,53,8,55,6,0,1,9,17,17,7,10,0,0,16,28,9,53
20200912,12SEP2020:00:00:00,UFU ELIZALDE,15,12,8,18,1,27,27,0,27,0,20,6,0,1,0,0,0,0,0,6,19,2,27
20200912,12SEP2020:00:00:00,UFU FERNANDEZ,29,19,39,9,0,48,46,2,48,0,0,5,9,7,13,9,5,0,0,10,23,13,46
20200912,12SEP2020:00:00:00,UFU FERRER,26,31,23,24,10,57,45,12,45,12,0,1,15,16,9,9,5,2,0,13,28,4,45
20200912,12SEP2020:00:00:00,UFU GRIERSON,26,20,22,24,0,46,38,8,42,4,0,5,8,14,12,6,1,0,0,16,19,3,38
20200912,12SEP2020:00:00:00,UFU GUTIERREZ,34,18,35,17,0,52,46,6,50,2,8,9,7,16,5,3,3,1,0,3,36,6,46
20200912,12SEP2020:00:00:00,UFU MUÑIZ,98,98,79,107,10,196,98,98,102,94,9,4,57,37,21,42,17,9,0,25,45,28,98
20200912,12SEP2020:00:00:00,UFU PENNA,12,8,12,8,0,20,20,0,20,0,0,0,0,7,5,6,1,1,0,6,12,2,20
20200912,12SEP2020:00:00:00,UFU PIROVANO,27,10,26,11,0,37,33,4,35,2,0,0,8,10,6,8,3,2,0,7,21,5,33
20200912,12SEP2020:00:00:00,UFU PIÑERO,31,34,29,35,1,65,64,1,64,1,0,3,11,26,10,9,6,0,0,12,19,32,64
20200912,12SEP2020:00:00:00,UFU RAMOS MEJIA,59,52,92,14,5,111,107,4,107,4,12,4,25,18,28,17,5,2,0,32,33,42,107
20200912,12SEP2020:00:00:00,UFU RIVADAVIA,37,25,55,7,0,62,54,8,56,6,0,1,12,16,14,11,4,4,0,22,22,9,54
20200912,12SEP2020:00:00:00,UFU SANTOJANNI,30,29,33,24,2,59,47,12,53,6,2,2,14,14,14,7,5,1,0,11,32,4,47
20200912,12SEP2020:00:00:00,UFU TORNU,27,30,27,29,1,57,55,2,57,0,3,9,8,17,8,6,4,2,0,10,30,15,55
20200912,12SEP2020:00:00:00,UFU VELEZ SARSFIELD,22,14,23,13,0,36,36,0,36,0,0,0,3,7,14,9,1,2,0,13,19,4,36
20200912,12SEP2020:00:00:00,UFU ZUBIZARRETA,25,34,38,19,2,59,49,10,55,4,0,1,11,9,13,13,6,6,0,13,25,11,49
20200913,13SEP2020:00:00:00,UFU ALVAREZ,4,2,6,0,0,6,6,0,6,0,1,0,3,0,0,1,1,0,0,3,3,0,6
20200913,13SEP2020:00:00:00,UFU ARGERICH,37,11,30,18,0,48,30,18,30,18,4,3,9,11,13,7,1,0,0,13,10,7,30
20200913,13SEP2020:00:00:00,UFU BORDA-MOYANO,7,0,2,5,0,7,7,0,7,0,0,2,0,1,0,4,0,0,0,0,5,2,7
20200913,13SEP2020:00:00:00,UFU DURAND,39,25,57,4,3,64,56,8,60,4,0,4,11,22,14,4,7,2,0,17,29,10,56
20200913,13SEP2020:00:00:00,UFU ELIZALDE,17,28,24,21,0,45,29,16,41,4,30,3,1,9,1,1,0,0,0,1,23,5,29
20200913,13SEP2020:00:00:00,UFU FERNANDEZ,14,18,19,13,0,32,30,2,32,0,0,0,3,14,5,4,3,3,0,15,10,5,30
20200913,13SEP2020:00:00:00,UFU FERRER,12,10,10,9,3,22,22,0,22,0,0,0,5,12,3,1,1,0,0,4,17,1,22
20200913,13SEP2020:00:00:00,UFU GRIERSON,12,13,10,15,0,25,23,2,25,0,0,0,10,5,5,1,2,2,0,5,17,1,23
20200913,13SEP2020:00:00:00,UFU GUTIERREZ,31,17,37,11,0,48,40,8,42,6,16,7,7,9,4,0,4,1,0,7,22,7,40
20200913,13SEP2020:00:00:00,UFU MUÑIZ,63,73,59,69,8,136,74,62,86,50,6,3,27,33,8,21,27,11,0,34,32,8,74
20200913,13SEP2020:00:00:00,UFU PENNA,11,11,12,10,0,22,12,10,18,4,0,0,7,8,1,3,3,0,0,4,6,2,12
20200913,13SEP2020:00:00:00,UFU PIROVANO,10,14,16,6,2,24,16,8,20,4,0,0,2,7,5,3,6,1,0,6,9,1,16
20200913,13SEP2020:00:00:00,UFU PIÑERO,35,29,39,25,0,64,56,8,60,4,0,4,11,18,16,8,6,1,0,18,26,12,56
20200913,13SEP2020:00:00:00,UFU RAMOS MEJIA,40,27,57,7,3,67,65,2,65,2,0,4,14,14,20,2,7,6,0,33,9,23,65
20200913,13SEP2020:00:00:00,UFU RIVADAVIA,21,17,26,10,2,38,34,4,34,4,0,2,10,12,8,1,3,2,0,7,20,7,34
20200913,13SEP2020:00:00:00,UFU SANTOJANNI,22,30,33,15,4,52,46,6,46,6,4,2,7,16,10,4,7,2,0,12,29,5,46
20200913,13SEP2020:00:00:00,UFU TORNU,25,19,20,23,1,44,40,4,44,0,2,2,13,10,10,2,5,0,0,5,27,8,40
20200913,13SEP2020:00:00:00,UFU VELEZ SARSFIELD,14,11,16,9,0,25,23,2,25,0,0,0,8,7,4,5,1,0,0,5,15,3,23
20200913,13SEP2020:00:00:00,UFU ZUBIZARRETA,31,25,39,17,0,56,44,12,56,0,0,2,12,18,9,5,8,2,0,16,19,9,44
20200914,14SEP2020:00:00:00,UFU ALVAREZ,7,14,18,3,0,21,21,0,21,0,0,0,8,7,4,2,0,0,0,4,12,5,21
20200914,14SEP2020:00:00:00,UFU ARGERICH,44,56,64,32,4,100,78,22,80,20,2,7,25,25,23,11,3,4,0,22,39,17,78
20200914,14SEP2020:00:00:00,UFU BORDA-MOYANO,76,14,65,23,2,90,86,4,86,4,0,2,5,10,20,26,12,15,0,12,54,20,86
20200914,14SEP2020:00:00:00,UFU DURAND,41,41,59,22,1,82,72,10,72,10,0,4,19,24,16,10,7,2,0,30,35,7,72
20200914,14SEP2020:00:00:00,UFU ELIZALDE,36,25,25,36,0,61,51,10,53,8,29,12,4,9,3,1,3,0,0,2,38,11,51
20200914,14SEP2020:00:00:00,UFU FERNANDEZ,31,32,48,15,0,63,63,0,63,0,0,0,15,22,16,3,7,0,0,16,37,10,63
20200914,14SEP2020:00:00:00,UFU FERRER,29,28,26,31,0,57,45,12,45,12,0,0,17,11,14,13,1,1,0,16,22,7,45
20200914,14SEP2020:00:00:00,UFU GRIERSON,27,21,22,26,0,48,46,2,46,2,0,1,11,12,12,3,8,1,0,8,37,1,46
20200914,14SEP2020:00:00:00,UFU GUTIERREZ,62,25,43,44,0,87,79,8,87,0,20,4,16,22,14,6,5,0,0,6,56,14,79
20200914,14SEP2020:00:00:00,UFU MUÑIZ,138,156,113,176,5,294,158,136,172,122,5,4,86,55,74,55,13,2,0,27,102,29,158
20200914,14SEP2020:00:00:00,UFU PENNA,23,7,24,6,0,30,24,6,30,0,0,0,4,12,3,9,2,0,0,9,12,3,24
20200914,14SEP2020:00:00:00,UFU PIROVANO,38,14,32,18,2,52,40,12,44,8,2,2,4,11,15,10,4,4,0,11,22,7,40
20200914,14SEP2020:00:00:00,UFU PIÑERO,32,34,31,17,18,66,44,22,50,16,0,1,12,15,20,8,8,2,0,12,24,8,44
20200914,14SEP2020:00:00:00,UFU RAMOS MEJIA,43,26,48,20,1,69,59,10,61,8,1,6,14,18,12,14,4,0,0,21,29,9,59
20200914,14SEP2020:00:00:00,UFU RIVADAVIA,44,57,53,43,5,101,93,8,97,4,0,2,25,31,19,16,8,0,0,17,55,21,93
20200914,14SEP2020:00:00:00,UFU SANTOJANNI,64,43,42,65,0,107,95,12,105,2,3,4,19,36,25,14,3,3,0,36,57,2,95
20200914,14SEP2020:00:00:00,UFU TORNU,31,47,48,24,6,78,68,10,68,10,4,1,21,22,11,13,1,5,0,17,36,15,68
20200914,14SEP2020:00:00:00,UFU VELEZ SARSFIELD,21,26,34,13,0,47,43,4,47,0,0,4,6,5,16,9,7,0,0,10,30,3,43
20200914,14SEP2020:00:00:00,UFU ZUBIZARRETA,31,23,30,21,3,54,48,6,52,2,0,4,7,10,17,10,4,2,0,12,32,4,48
20200915,15SEP2020:00:00:00,UFU ALVAREZ,9,4,10,3,0,13,11,2,13,0,0,0,3,3,1,5,1,0,0,6,5,0,11
20200915,15SEP2020:00:00:00,UFU ARGERICH,24,38,34,26,2,62,54,8,58,4,4,4,24,11,11,7,0,1,0,21,26,7,54
20200915,15SEP2020:00:00:00,UFU BORDA-MOYANO,30,26,21,25,10,56,8,48,8,48,0,2,8,6,20,14,4,2,0,1,6,1,8
20200915,15SEP2020:00:00:00,UFU DURAND,38,35,60,13,0,73,71,2,71,2,0,6,13,27,8,10,6,3,0,22,40,9,71
20200915,15SEP2020:00:00:00,UFU ELIZALDE,35,21,20,36,0,56,46,10,52,4,18,19,8,8,3,0,0,0,0,6,32,8,46
20200915,15SEP2020:00:00:00,UFU FERNANDEZ,29,19,37,10,1,48,48,0,48,0,0,0,15,13,11,5,4,0,0,14,26,8,48
20200915,15SEP2020:00:00:00,UFU FERRER,39,36,23,52,0,75,60,15,60,15,0,0,17,24,15,5,14,0,0,22,29,9,60
20200915,15SEP2020:00:00:00,UFU GRIERSON,21,20,27,14,0,41,39,2,41,0,1,2,8,12,10,5,2,1,0,15,23,1,39
20200915,15SEP2020:00:00:00,UFU GUTIERREZ,45,22,45,22,0,67,53,14,65,2,18,11,6,12,14,4,2,0,0,3,42,8,53
20200915,15SEP2020:00:00:00,UFU MUÑIZ,120,126,86,158,2,246,178,68,182,64,3,7,63,67,41,42,20,3,0,46,105,27,178
20200915,15SEP2020:00:00:00,UFU PENNA,12,4,11,5,0,16,14,2,16,0,0,0,4,3,7,0,2,0,0,3,10,1,14
20200915,15SEP2020:00:00:00,UFU PIROVANO,18,23,28,11,2,41,31,10,35,6,0,1,9,17,8,4,1,1,0,6,22,3,31
20200915,15SEP2020:00:00:00,UFU PIÑERO,25,28,35,7,11,53,45,8,49,4,2,4,10,12,12,7,4,2,0,12,27,6,45
20200915,15SEP2020:00:00:00,UFU RAMOS MEJIA,47,38,58,27,0,85,79,6,81,4,8,2,21,20,16,11,5,2,0,32,37,10,79
20200915,15SEP2020:00:00:00,UFU RIVADAVIA,42,47,59,23,7,89,79,10,83,6,0,1,18,31,15,13,7,4,0,20,37,20,79
20200915,15SEP2020:00:00:00,UFU SANTOJANNI,50,50,38,62,0,100,72,28,100,0,11,1,19,27,20,17,2,3,0,26,44,2,72
20200915,15SEP2020:00:00:00,UFU TORNU,40,34,55,13,6,74,70,4,72,2,0,5,13,25,17,13,1,0,0,14,47,9,70
20200915,15SEP2020:00:00:00,UFU VELEZ SARSFIELD,21,27,37,9,2,48,44,4,46,2,0,3,11,11,13,8,2,0,0,10,30,4,44
20200915,15SEP2020:00:00:00,UFU ZUBIZARRETA,25,5,19,11,0,30,24,6,30,0,0,1,5,4,10,5,3,2,0,7,16,1,24
20200916,16SEP2020:00:00:00,UFU ALVAREZ,3,8,6,5,0,11,11,0,11,0,0,0,3,0,7,1,0,0,0,2,3,6,11
20200916,16SEP2020:00:00:00,UFU ARGERICH,43,30,45,26,2,73,51,22,55,18,2,6,15,13,14,11,8,4,0,19,20,12,51
20200916,16SEP2020:00:00:00,UFU BORDA-MOYANO,58,12,52,16,2,70,66,4,66,4,0,0,5,5,11,21,19,9,0,4,49,13,66
20200916,16SEP2020:00:00:00,UFU DURAND,36,34,55,15,0,70,70,0,70,0,1,2,15,17,12,15,7,1,0,26,36,8,70
20200916,16SEP2020:00:00:00,UFU ELIZALDE,32,23,20,33,2,55,49,6,51,4,33,7,2,8,3,2,0,0,0,1,40,8,49
20200916,16SEP2020:00:00:00,UFU FERNANDEZ,28,23,45,6,0,51,49,2,51,0,0,0,13,16,7,10,3,2,0,16,25,8,49
20200916,16SEP2020:00:00:00,UFU FERRER,37,38,25,50,0,75,60,15,60,15,0,0,14,27,15,9,8,2,0,21,34,5,60
20200916,16SEP2020:00:00:00,UFU GRIERSON,11,16,17,10,0,27,27,0,27,0,0,0,9,10,4,2,1,1,0,10,17,0,27
20200916,16SEP2020:00:00:00,UFU GUTIERREZ,30,26,34,22,0,56,52,4,52,4,14,8,8,11,7,2,4,2,0,4,37,11,52
20200916,16SEP2020:00:00:00,UFU MUÑIZ,96,147,95,146,2,243,137,106,149,94,4,10,62,72,39,24,24,8,0,42,77,18,137
20200916,16SEP2020:00:00:00,UFU PENNA,12,9,12,7,2,21,17,4,19,2,0,0,3,8,3,5,1,1,0,3,12,2,17
20200916,16SEP2020:00:00:00,UFU PIROVANO,21,10,24,7,0,31,27,4,31,0,0,0,8,12,1,5,3,2,0,2,20,5,27
20200916,16SEP2020:00:00:00,UFU PIÑERO,47,34,40,18,23,81,75,6,75,6,0,1,23,24,9,12,7,5,0,25,41,9,75
20200916,16SEP2020:00:00:00,UFU RAMOS MEJIA,45,34,60,16,3,79,77,2,79,0,7,0,19,22,13,6,5,7,0,25,36,16,77
20200916,16SEP2020:00:00:00,UFU RIVADAVIA,52,48,56,38,6,100,88,12,92,8,0,0,31,36,14,8,6,5,0,15,58,13,88
20200916,16SEP2020:00:00:00,UFU SANTOJANNI,61,55,58,58,0,116,100,16,114,2,4,5,33,23,29,12,9,1,0,20,74,6,100
20200916,16SEP2020:00:00:00,UFU TORNU,61,72,66,62,5,133,129,4,131,2,4,7,33,35,25,23,6,0,0,19,86,24,129
20200916,16SEP2020:00:00:00,UFU VELEZ SARSFIELD,25,39,44,20,0,64,52,12,58,6,0,2,19,18,16,8,1,0,0,7,40,5,52
20200916,16SEP2020:00:00:00,UFU ZUBIZARRETA,21,15,25,10,1,36,34,2,36,0,0,3,4,10,8,8,3,0,0,6,19,9,34
20200917,17SEP2020:00:00:00,UFU ALVAREZ,33,7,29,11,0,40,30,10,30,10,10,0,14,10,4,2,0,0,0,3,12,15,30
20200917,17SEP2020:00:00:00,UFU ARGERICH,32,33,42,21,2,65,43,22,43,22,5,4,10,12,19,9,5,1,0,19,19,5,43
20200917,17SEP2020:00:00:00,UFU BORDA-MOYANO,24,13,19,17,1,37,35,2,35,2,0,1,5,9,13,4,5,0,0,4,25,6,35
20200917,17SEP2020:00:00:00,UFU DURAND,37,27,41,23,0,64,64,0,64,0,5,4,26,10,6,7,4,2,0,15,37,12,64
20200917,17SEP2020:00:00:00,UFU ELIZALDE,31,18,13,36,0,49,45,4,47,2,21,11,3,5,7,2,0,0,0,2,37,6,45
20200917,17SEP2020:00:00:00,UFU FERNANDEZ,40,24,49,14,1,64,62,2,62,2,0,0,16,19,10,9,3,7,0,28,25,9,62
20200917,17SEP2020:00:00:00,UFU FERRER,25,34,26,33,0,59,51,8,53,6,0,0,14,16,15,11,3,0,0,15,27,9,51
20200917,17SEP2020:00:00:00,UFU GRIERSON,24,20,28,16,0,44,42,2,42,2,2,0,9,14,9,5,4,1,0,12,27,3,42
20200917,17SEP2020:00:00:00,UFU GUTIERREZ,21,18,25,14,0,39,39,0,39,0,6,1,6,11,4,3,8,0,0,2,33,3,39
20200917,17SEP2020:00:00:00,UFU MUÑIZ,100,132,77,152,3,232,176,56,194,38,0,8,56,64,53,35,12,4,0,39,118,19,176
20200917,17SEP2020:00:00:00,UFU PENNA,12,3,11,4,0,15,13,2,13,2,0,0,1,6,2,3,0,3,0,1,12,0,13
20200917,17SEP2020:00:00:00,UFU PIROVANO,16,11,22,3,2,27,19,8,25,2,0,2,2,13,4,5,0,1,0,5,12,2,19
20200917,17SEP2020:00:00:00,UFU PIÑERO,43,34,50,8,19,77,65,12,67,10,4,5,13,19,13,9,11,3,0,11,39,15,65
20200917,17SEP2020:00:00:00,UFU RAMOS MEJIA,33,31,49,14,1,64,62,2,62,2,0,1,20,21,14,4,4,0,0,31,20,11,62
20200917,17SEP2020:00:00:00,UFU RIVADAVIA,37,41,40,23,15,78,74,4,74,4,0,2,27,24,12,8,4,1,0,15,46,12,74
20200917,17SEP2020:00:00:00,UFU SANTOJANNI,42,40,46,36,0,82,78,4,80,2,1,6,17,28,16,7,7,0,0,26,49,3,78
20200917,17SEP2020:00:00:00,UFU TORNU,64,49,67,44,2,113,109,4,109,4,4,2,26,26,23,15,14,3,0,19,64,26,109
20200917,17SEP2020:00:00:00,UFU VELEZ SARSFIELD,25,20,29,16,0,45,45,0,45,0,0,0,14,12,11,4,2,2,0,9,32,4,45
20200917,17SEP2020:00:00:00,UFU ZUBIZARRETA,17,28,29,14,2,45,29,16,31,14,0,0,10,9,9,2,11,4,0,10,15,4,29
20200918,18SEP2020:00:00:00,UFU ALVAREZ,4,7,8,3,0,11,11,0,11,0,2,0,3,4,1,1,0,0,0,1,6,4,11
20200918,18SEP2020:00:00:00,UFU ARGERICH,44,39,56,24,3,83,69,14,71,12,2,12,9,29,18,5,7,1,0,22,31,16,69
20200918,18SEP2020:00:00:00,UFU BORDA-MOYANO,19,12,23,8,0,31,29,2,29,2,0,0,6,8,7,3,6,1,0,4,17,8,29
20200918,18SEP2020:00:00:00,UFU DURAND,35,18,38,13,2,53,47,6,47,6,3,1,14,11,13,8,2,1,0,13,25,9,47
20200918,18SEP2020:00:00:00,UFU ELIZALDE,22,20,12,28,2,42,30,12,36,6,18,7,4,5,5,2,1,0,0,4,20,6,30
20200918,18SEP2020:00:00:00,UFU FERNANDEZ,36,15,35,14,2,51,47,4,51,0,0,1,17,13,7,6,3,4,0,10,28,9,47
20200918,18SEP2020:00:00:00,UFU FERRER,15,17,17,15,0,32,26,6,26,6,0,0,6,8,8,5,5,0,0,7,18,1,26
20200918,18SEP2020:00:00:00,UFU GRIERSON,29,20,29,20,0,49,49,0,49,0,6,0,9,15,11,4,3,1,0,10,35,4,49
20200918,18SEP2020:00:00:00,UFU GUTIERREZ,26,15,30,11,0,41,29,12,41,0,13,4,8,5,7,2,2,0,0,1,24,3,29
20200918,18SEP2020:00:00:00,UFU MUÑIZ,111,115,100,117,9,226,134,92,174,52,2,0,40,54,70,42,15,3,0,26,88,20,134
20200918,18SEP2020:00:00:00,UFU PENNA,23,14,22,13,2,37,23,14,29,8,0,3,4,14,8,1,7,0,0,8,12,3,23
20200918,18SEP2020:00:00:00,UFU PIROVANO,25,18,36,6,1,43,39,4,43,0,2,0,14,11,7,8,0,1,0,5,29,5,39
20200918,18SEP2020:00:00:00,UFU PIÑERO,38,32,39,23,8,70,62,8,66,4,0,4,22,11,15,12,3,3,0,16,37,9,62
20200918,18SEP2020:00:00:00,UFU RAMOS MEJIA,42,20,48,12,2,62,58,4,58,4,3,2,19,17,13,4,4,0,0,18,30,10,58
20200918,18SEP2020:00:00:00,UFU RIVADAVIA,49,38,52,27,8,87,75,12,83,4,0,0,29,22,19,11,3,3,0,22,39,13,75
20200918,18SEP2020:00:00:00,UFU SANTOJANNI,43,35,29,47,2,78,42,36,78,0,4,1,20,17,19,12,4,1,0,14,27,1,42
20200922,22SEP2020:00:00:00,UFU PIROVANO,24,10,24,9,1,34,34,0,34,0,2,0,10,7,7,4,4,0,0,15,18,1,34
20200922,22SEP2020:00:00:00,UFU PIÑERO,29,30,26,14,19,59,47,12,55,4,2,3,8,11,14,10,6,5,0,16,27,4,47
20200922,22SEP2020:00:00:00,UFU RAMOS MEJIA,26,17,30,13,0,43,43,0,43,0,1,2,7,7,10,10,4,2,0,17,19,7,43
20200922,22SEP2020:00:00:00,UFU RIVADAVIA,43,22,51,11,3,65,65,0,65,0,0,0,23,11,11,7,6,7,0,10,33,20,65
20200922,22SEP2020:00:00:00,UFU SANTOJANNI,51,46,57,40,0,97,85,12,93,4,6,1,18,26,24,12,10,0,0,30,47,8,85
20200922,22SEP2020:00:00:00,UFU TORNU,33,26,40,15,4,59,51,8,53,6,1,2,13,16,7,13,1,6,0,10,29,12,51
20200922,22SEP2020:00:00:00,UFU VELEZ SARSFIELD,23,23,27,19,0,46,46,0,46,0,0,0,14,10,10,8,2,2,0,13,30,3,46
20200922,22SEP2020:00:00:00,UFU ZUBIZARRETA,31,29,38,22,0,60,34,26,38,22,2,4,13,13,17,6,4,1,0,14,16,4,34
20200923,23SEP2020:00:00:00,UFU ALVAREZ,6,8,12,2,0,14,12,2,12,2,0,0,7,4,0,1,2,0,0,1,9,2,12
20200923,23SEP2020:00:00:00,UFU ARGERICH,28,32,37,23,0,60,50,10,52,8,2,0,8,14,17,9,5,5,0,24,21,5,50
20200923,23SEP2020:00:00:00,UFU BORDA-MOYANO,18,6,17,7,0,24,22,2,22,2,0,0,4,6,5,3,6,0,0,3,14,5,22
20200923,23SEP2020:00:00:00,UFU DURAND,37,25,52,10,0,62,60,2,60,2,6,6,18,14,9,5,2,2,0,26,27,7,60
20200923,23SEP2020:00:00:00,UFU ELIZALDE,29,19,13,34,1,48,38,10,44,4,29,5,3,6,5,0,0,0,0,1,25,12,38
20200923,23SEP2020:00:00:00,UFU FERNANDEZ,16,19,28,7,0,35,33,2,33,2,0,0,14,7,9,4,1,0,0,16,9,8,33
20200923,23SEP2020:00:00:00,UFU FERRER,20,32,30,22,0,52,48,4,48,4,0,1,15,15,11,6,3,1,0,17,29,2,48
20200923,23SEP2020:00:00:00,UFU GRIERSON,41,25,33,33,0,66,66,0,66,0,2,6,15,13,11,13,2,4,0,26,35,5,66
20200923,23SEP2020:00:00:00,UFU GUTIERREZ,52,27,42,37,0,79,71,8,79,0,15,11,15,16,6,11,4,1,0,4,50,14,71
20200923,23SEP2020:00:00:00,UFU MUÑIZ,100,96,97,97,2,196,97,99,107,89,0,3,56,53,36,29,11,8,0,21,65,11,97
20200923,23SEP2020:00:00:00,UFU PENNA,23,11,20,13,1,34,30,4,32,2,0,0,3,9,5,7,7,3,0,7,19,4,30
20200923,23SEP2020:00:00:00,UFU PIROVANO,30,22,41,11,0,52,40,12,48,4,2,3,7,10,9,13,6,2,0,11,25,4,40
20200923,23SEP2020:00:00:00,UFU PIÑERO,27,31,30,20,8,58,52,6,56,2,0,2,12,15,14,12,0,3,0,16,33,3,52
20200923,23SEP2020:00:00:00,UFU RAMOS MEJIA,38,24,47,14,1,62,58,4,60,2,2,11,13,14,13,3,5,1,0,22,26,10,58
20200923,23SEP2020:00:00:00,UFU RIVADAVIA,39,34,45,26,2,73,67,6,71,2,0,0,29,18,12,9,3,2,0,20,35,12,67
20200923,23SEP2020:00:00:00,UFU SANTOJANNI,59,45,58,45,1,104,80,24,96,8,5,10,22,26,15,14,9,3,0,21,52,7,80
20200923,23SEP2020:00:00:00,UFU TORNU,41,43,48,25,11,84,62,22,66,18,4,6,23,19,13,15,4,0,0,12,37,13,62
20200923,23SEP2020:00:00:00,UFU VELEZ SARSFIELD,19,20,34,5,0,39,39,0,39,0,0,0,11,8,6,9,2,3,0,9,30,0,39
20200923,23SEP2020:00:00:00,UFU ZUBIZARRETA,28,32,34,24,2,60,40,20,40,20,2,2,24,5,16,3,6,2,0,16,9,15,40
20200924,24SEP2020:00:00:00,UFU ALVAREZ,1,3,4,0,0,4,4,0,4,0,0,0,1,1,1,0,1,0,0,3,1,0,4
20200924,24SEP2020:00:00:00,UFU ARGERICH,31,28,45,14,0,59,25,34,47,12,0,1,14,20,7,6,5,6,0,6,12,7,25
20200924,24SEP2020:00:00:00,UFU BORDA-MOYANO,22,13,24,11,0,35,33,2,33,2,0,0,2,9,11,5,1,7,0,6,18,9,33
20200924,24SEP2020:00:00:00,UFU DURAND,40,32,56,16,0,72,64,8,70,2,2,2,19,19,13,5,7,5,0,21,36,7,64
20200924,24SEP2020:00:00:00,UFU ELIZALDE,36,29,21,42,2,65,43,22,51,14,42,7,4,1,7,3,1,0,0,4,29,10,43
20200924,24SEP2020:00:00:00,UFU FERNANDEZ,25,20,31,14,0,45,43,2,45,0,0,0,8,5,10,9,7,6,0,17,15,11,43
20200924,24SEP2020:00:00:00,UFU FERRER,22,15,16,21,0,37,37,0,37,0,0,0,9,7,11,5,4,1,0,12,24,1,37
20200924,24SEP2020:00:00:00,UFU GRIERSON,40,16,31,25,0,56,56,0,56,0,6,3,15,13,10,4,2,3,0,14,38,4,56
20200924,24SEP2020:00:00:00,UFU GUTIERREZ,37,26,33,30,0,63,55,8,59,4,11,6,11,14,8,9,4,0,0,4,41,9,55
20200924,24SEP2020:00:00:00,UFU MUÑIZ,93,144,116,112,9,237,139,98,155,82,2,9,34,66,65,28,29,4,0,32,95,12,139
20200924,24SEP2020:00:00:00,UFU PENNA,14,8,10,8,4,22,18,4,20,2,0,0,4,4,7,5,2,0,0,6,11,1,18
20200924,24SEP2020:00:00:00,UFU PIROVANO,23,17,23,15,2,40,32,8,36,4,0,0,7,18,6,6,2,1,0,10,14,8,32
20200924,24SEP2020:00:00:00,UFU PIÑERO,50,34,42,23,19,84,68,16,76,8,3,2,19,24,23,10,3,0,0,14,47,7,68
20200924,24SEP2020:00:00:00,UFU RAMOS MEJIA,54,36,70,20,0,90,84,6,86,4,3,9,19,21,14,12,10,2,0,38,33,13,84
20200924,24SEP2020:00:00:00,UFU RIVADAVIA,63,22,45,32,8,85,77,8,77,8,0,0,34,23,7,12,9,0,0,19,33,22,77
20200924,24SEP2020:00:00:00,UFU SANTOJANNI,57,39,54,40,2,96,86,10,94,2,3,3,24,23,17,17,8,1,0,29,50,7,86
20200924,24SEP2020:00:00:00,UFU TORNU,46,35,50,31,0,81,71,10,75,6,4,4,16,23,15,13,3,3,0,19,34,18,71
20200924,24SEP2020:00:00:00,UFU VELEZ SARSFIELD,35,29,47,17,0,64,60,4,62,2,0,0,16,17,14,12,2,3,0,10,42,8,60
20200924,24SEP2020:00:00:00,UFU ZUBIZARRETA,42,27,40,28,1,69,47,22,55,14,4,6,12,17,14,12,1,3,0,8,37,2,47
20200925,25SEP2020:00:00:00,UFU ALVAREZ,5,2,3,4,0,7,7,0,7,0,0,0,2,3,2,0,0,0,0,2,5,0,7
20200925,25SEP2020:00:00:00,UFU ARGERICH,23,26,26,23,0,49,28,21,40,9,1,5,8,10,11,9,1,4,0,2,23,3,28
20200925,25SEP2020:00:00:00,UFU BORDA-MOYANO,3,4,5,2,0,7,5,2,5,2,0,2,0,0,2,0,2,1,0,1,4,0,5
20200925,25SEP2020:00:00:00,UFU DURAND,40,30,59,11,0,70,70,0,70,0,5,8,18,16,12,6,4,1,0,19,40,11,70
20200925,25SEP2020:00:00:00,UFU ELIZALDE,26,30,28,28,0,56,32,24,42,14,23,11,4,10,4,3,0,1,0,1,28,3,32
20200925,25SEP2020:00:00:00,UFU FERNANDEZ,28,25,33,19,1,53,47,6,49,4,0,0,10,14,14,3,6,6,0,16,23,8,47
20200925,25SEP2020:00:00:00,UFU FERRER,19,20,15,24,0,39,29,10,31,8,0,1,3,16,10,6,3,0,0,8,19,2,29
20200925,25SEP2020:00:00:00,UFU GRIERSON,25,31,33,22,1,56,52,4,52,4,8,0,13,21,6,8,0,0,0,13,33,6,52
20200925,25SEP2020:00:00:00,UFU GUTIERREZ,56,28,51,33,0,84,78,6,82,2,14,10,23,13,7,9,7,1,0,5,54,19,78
20200925,25SEP2020:00:00:00,UFU MUÑIZ,100,129,132,95,2,229,119,110,155,74,3,5,63,70,43,27,14,4,0,15,84,20,119
20200925,25SEP2020:00:00:00,UFU PENNA,18,13,24,5,2,31,31,0,31,0,0,1,7,5,5,6,6,1,0,2,26,3,31
20200925,25SEP2020:00:00:00,UFU PIROVANO,32,30,53,7,2,62,56,6,60,2,0,1,19,15,10,8,3,6,0,14,30,12,56
20200925,25SEP2020:00:00:00,UFU PIÑERO,34,25,30,15,14,59,53,6,55,4,0,3,18,14,13,5,3,3,0,17,30,5,53
20200925,25SEP2020:00:00:00,UFU RAMOS MEJIA,34,20,43,9,2,54,50,4,52,2,0,2,15,15,8,9,4,1,0,21,21,8,50
20200925,25SEP2020:00:00:00,UFU RIVADAVIA,32,26,41,14,3,58,52,6,54,4,0,0,15,19,11,8,3,2,0,9,37,5,52
20200925,25SEP2020:00:00:00,UFU SANTOJANNI,31,46,35,42,0,77,71,6,73,4,1,4,20,17,10,13,10,2,0,28,40,3,71
20200925,25SEP2020:00:00:00,UFU TORNU,38,36,31,26,17,74,68,6,68,6,3,1,13,21,15,15,4,2,0,17,37,14,68
20200925,25SEP2020:00:00:00,UFU VELEZ SARSFIELD,27,26,45,8,0,53,51,2,53,0,0,0,10,16,7,12,5,3,0,9,27,15,51
20200925,25SEP2020:00:00:00,UFU ZUBIZARRETA,22,28,26,20,4,50,38,12,42,8,2,3,6,11,8,12,5,3,0,12,22,4,38
20200926,26SEP2020:00:00:00,UFU ALVAREZ,4,3,7,0,0,7,5,2,5,2,0,0,4,0,0,2,1,0,0,1,4,0,5
20200926,26SEP2020:00:00:00,UFU BORDA-MOYANO,2,1,3,0,0,3,3,0,3,0,0,0,2,1,0,0,0,0,0,0,2,1,3
20200926,26SEP2020:00:00:00,UFU DURAND,19,13,28,4,0,32,32,0,32,0,1,3,12,8,4,2,1,1,0,15,15,2,32
20200926,26SEP2020:00:00:00,UFU ELIZALDE,11,12,10,13,0,23,17,6,19,4,7,8,3,4,0,1,0,0,0,1,14,2,17
20200926,26SEP2020:00:00:00,UFU FERNANDEZ,22,14,27,9,0,36,30,6,36,0,0,2,10,9,8,3,1,3,0,14,11,5,30
20200926,26SEP2020:00:00:00,UFU FERRER,15,11,8,13,5,26,18,8,18,8,0,0,2,8,8,6,2,0,0,8,7,3,18
20200926,26SEP2020:00:00:00,UFU GRIERSON,7,15,11,11,0,22,20,2,22,0,0,2,11,2,2,4,1,0,0,10,10,0,20
20200926,26SEP2020:00:00:00,UFU GUTIERREZ,27,19,36,10,0,46,46,0,46,0,6,11,5,14,8,2,0,0,0,4,24,13,46
20200926,26SEP2020:00:00:00,UFU MUÑIZ,45,109,71,79,4,154,90,64,100,54,2,5,30,34,47,15,19,2,0,28,55,7,90
20200926,26SEP2020:00:00:00,UFU PENNA,15,7,9,13,0,22,18,4,18,4,0,0,7,4,3,7,0,1,0,3,13,2,18
20200926,26SEP2020:00:00:00,UFU PIROVANO,10,10,14,4,2,20,18,2,18,2,0,1,5,5,6,1,2,0,0,5,12,1,18
20200926,26SEP2020:00:00:00,UFU PIÑERO,23,19,23,19,0,42,34,8,34,8,0,1,11,15,8,2,3,2,0,7,15,12,34
20200926,26SEP2020:00:00:00,UFU RAMOS MEJIA,39,30,60,9,0,69,63,6,63,6,9,5,16,17,11,7,2,2,0,28,16,19,63
20200926,26SEP2020:00:00:00,UFU RIVADAVIA,15,12,19,8,0,27,27,0,27,0,0,0,11,5,6,3,1,1,0,4,20,3,27
20200926,26SEP2020:00:00:00,UFU SANTOJANNI,36,29,35,28,2,65,51,14,59,6,1,2,18,16,14,10,3,1,0,12,38,1,51
20200926,26SEP2020:00:00:00,UFU TORNU,12,20,12,17,3,32,32,0,32,0,0,2,3,15,4,7,1,0,0,7,18,7,32
20200926,26SEP2020:00:00:00,UFU VELEZ SARSFIELD,31,26,38,19,0,57,55,2,55,2,0,0,12,8,12,13,12,0,0,8,34,13,55
20200926,26SEP2020:00:00:00,UFU ZUBIZARRETA,32,30,42,18,2,62,48,14,58,4,0,3,24,19,10,3,2,1,0,10,13,25,48
20200927,27SEP2020:00:00:00,UFU ALVAREZ,6,7,7,6,0,13,9,4,9,4,1,0,5,1,1,2,3,0,0,6,3,0,9
20200927,27SEP2020:00:00:00,UFU BORDA-MOYANO,24,3,20,7,0,27,25,2,25,2,0,0,3,8,2,6,8,0,0,0,17,8,25
20200927,27SEP2020:00:00:00,UFU DURAND,28,16,34,8,2,44,44,0,44,0,0,1,6,14,15,3,5,0,0,14,22,8,44
20200927,27SEP2020:00:00:00,UFU ELIZALDE,32,15,17,30,0,47,31,16,41,6,23,6,6,8,3,0,1,0,0,5,20,6,31
20200927,27SEP2020:00:00:00,UFU FERNANDEZ,14,11,14,11,0,25,23,2,23,2,0,0,4,6,7,3,4,1,0,7,10,6,23
20200927,27SEP2020:00:00:00,UFU FERRER,16,11,14,10,3,27,23,4,23,4,0,0,10,9,3,3,2,0,0,12,5,6,23
20200927,27SEP2020:00:00:00,UFU GRIERSON,18,17,24,11,0,35,33,2,35,0,0,1,13,10,5,5,1,0,0,13,18,2,33
20200927,27SEP2020:00:00:00,UFU GUTIERREZ,20,12,26,6,0,32,32,0,32,0,1,6,4,8,5,7,1,0,0,4,20,8,32
20200927,27SEP2020:00:00:00,UFU MUÑIZ,57,70,71,56,0,127,56,71,74,53,1,3,47,30,23,14,5,4,0,10,37,9,56
20200927,27SEP2020:00:00:00,UFU PENNA,14,6,12,8,0,20,12,8,14,6,0,0,2,8,1,1,4,4,0,4,7,1,12
20200927,27SEP2020:00:00:00,UFU PIROVANO,6,10,12,4,0,16,12,4,16,0,0,0,5,2,1,7,0,1,0,4,8,0,12
20200927,27SEP2020:00:00:00,UFU PIÑERO,16,19,23,11,1,35,33,2,33,2,0,0,7,11,7,4,2,4,0,8,19,6,33
20200927,27SEP2020:00:00:00,UFU RAMOS MEJIA,24,29,50,3,0,53,51,2,51,2,4,1,9,16,11,10,0,2,0,21,15,15,51
20200927,27SEP2020:00:00:00,UFU RIVADAVIA,12,10,13,9,0,22,22,0,22,0,0,0,6,7,5,2,2,0,0,9,8,5,22
20200927,27SEP2020:00:00:00,UFU SANTOJANNI,31,15,24,22,0,46,44,2,46,0,2,2,5,14,13,9,1,0,0,12,26,6,44
20200927,27SEP2020:00:00:00,UFU TORNU,22,14,15,13,8,36,36,0,36,0,0,1,3,15,4,9,1,3,0,6,21,9,36
20200927,27SEP2020:00:00:00,UFU VELEZ SARSFIELD,13,18,25,6,0,31,31,0,31,0,0,0,7,5,8,5,5,1,0,3,22,6,31
20200927,27SEP2020:00:00:00,UFU ZUBIZARRETA,28,15,29,14,0,43,35,8,39,4,0,1,8,7,14,11,1,1,0,13,12,10,35
20200928,28SEP2020:00:00:00,UFU ALVAREZ,9,5,14,0,0,14,12,2,12,2,0,3,2,3,2,1,3,0,0,5,1,6,12
20200928,28SEP2020:00:00:00,UFU ARGERICH,47,41,51,35,2,88,66,22,68,20,5,6,16,19,19,15,4,4,0,19,35,12,66
20200928,28SEP2020:00:00:00,UFU BORDA-MOYANO,29,12,26,14,1,41,39,2,39,2,0,0,5,7,4,14,7,4,0,11,18,10,39
20200928,28SEP2020:00:00:00,UFU DURAND,37,37,61,12,1,74,70,4,74,0,5,2,17,16,14,14,3,3,0,28,36,6,70
20200928,28SEP2020:00:00:00,UFU ELIZALDE,28,21,28,21,0,49,35,14,37,12,19,14,2,4,5,5,0,0,0,0,32,3,35
20200928,28SEP2020:00:00:00,UFU FERNANDEZ,25,36,51,7,3,61,57,4,59,2,0,0,15,14,7,13,8,4,0,22,26,9,57
20200928,28SEP2020:00:00:00,UFU FERRER,30,27,27,30,0,57,45,12,45,12,0,2,16,20,7,9,2,1,0,12,27,6,45
20200928,28SEP2020:00:00:00,UFU GRIERSON,16,37,21,32,0,53,49,4,51,2,1,2,10,12,13,10,2,3,0,15,32,2,49
20200928,28SEP2020:00:00:00,UFU GUTIERREZ,28,14,25,17,0,42,40,2,42,0,12,7,8,10,3,0,2,0,0,6,29,5,40
20200928,28SEP2020:00:00:00,UFU MUÑIZ,110,117,99,126,2,227,131,96,159,68,1,5,68,52,46,29,16,10,0,30,87,14,131
20200928,28SEP2020:00:00:00,UFU PENNA,22,8,20,9,1,30,24,6,30,0,0,0,8,2,10,6,2,2,0,5,18,1,24
20200928,28SEP2020:00:00:00,UFU PIROVANO,34,28,42,16,4,62,54,8,56,6,0,0,21,13,10,9,5,4,0,12,35,7,54
20200928,28SEP2020:00:00:00,UFU PIÑERO,32,27,36,17,6,59,45,14,57,2,0,3,16,15,8,8,5,4,0,13,29,3,45
20200928,28SEP2020:00:00:00,UFU RAMOS MEJIA,23,29,41,11,0,52,52,0,52,0,1,2,11,20,11,7,0,0,0,11,32,9,52
20200928,28SEP2020:00:00:00,UFU RIVADAVIA,47,58,44,44,17,105,103,2,105,0,0,1,35,36,15,13,2,3,0,24,51,25,103
20200928,28SEP2020:00:00:00,UFU SANTOJANNI,44,43,50,34,3,87,75,12,81,6,3,7,20,20,14,15,7,1,0,20,52,3,75
20200928,28SEP2020:00:00:00,UFU TORNU,49,46,60,20,15,95,83,12,83,12,4,2,23,17,29,13,4,3,0,23,35,25,83
20200928,28SEP2020:00:00:00,UFU VELEZ SARSFIELD,28,36,54,10,0,64,58,6,62,2,0,1,16,13,8,15,9,2,0,17,25,16,58
20200928,28SEP2020:00:00:00,UFU ZUBIZARRETA,25,21,26,16,4,46,40,6,40,6,4,0,6,16,4,10,2,4,0,13,26,1,40
20200929,29SEP2020:00:00:00,UFU ALVAREZ,12,19,21,9,1,31,25,6,27,4,0,2,9,5,11,3,1,0,0,12,9,4,25
20200929,29SEP2020:00:00:00,UFU ARGERICH,33,24,31,24,2,57,35,22,43,14,0,7,12,19,16,3,0,0,0,10,19,6,35
20200929,29SEP2020:00:00:00,UFU BORDA-MOYANO,20,14,23,9,2,34,24,10,24,10,0,2,7,8,7,4,5,1,0,5,17,2,24
20200929,29SEP2020:00:00:00,UFU DURAND,34,23,51,6,0,57,57,0,57,0,1,2,12,19,12,7,4,0,0,10,40,7,57
20200929,29SEP2020:00:00:00,UFU ELIZALDE,26,15,9,28,4,41,29,12,33,8,18,7,4,6,3,1,2,0,0,1,24,4,29
20200929,29SEP2020:00:00:00,UFU FERNANDEZ,25,21,29,11,6,46,44,2,44,2,0,2,9,15,11,5,2,2,0,13,20,11,44
20200929,29SEP2020:00:00:00,UFU FERRER,19,19,17,21,0,38,30,8,30,8,0,0,8,11,9,6,3,1,0,10,19,1,30
20200929,29SEP2020:00:00:00,UFU GRIERSON,21,30,25,26,0,51,47,4,47,4,1,0,18,10,11,7,2,2,0,19,26,2,47
20200929,29SEP2020:00:00:00,UFU GUTIERREZ,38,27,22,43,0,65,63,2,65,0,11,15,9,12,4,6,7,1,0,4,47,12,63
20200929,29SEP2020:00:00:00,UFU MUÑIZ,109,121,92,134,4,230,124,106,176,54,2,3,37,62,65,18,27,16,0,20,80,24,124
20200929,29SEP2020:00:00:00,UFU PENNA,26,12,16,22,0,38,32,6,36,2,0,3,13,2,6,9,2,3,0,7,16,9,32
20200929,29SEP2020:00:00:00,UFU PIROVANO,22,23,34,11,0,45,39,6,39,6,3,1,8,13,11,4,3,2,0,8,26,5,39
20200929,29SEP2020:00:00:00,UFU PIÑERO,32,34,37,3,26,66,40,26,58,8,0,4,26,16,10,5,3,2,0,9,28,3,40
20200929,29SEP2020:00:00:00,UFU RAMOS MEJIA,37,38,53,19,3,75,71,4,71,4,1,3,19,29,11,6,5,1,0,20,38,13,71
20200929,29SEP2020:00:00:00,UFU RIVADAVIA,33,51,51,25,8,84,82,2,82,2,0,0,29,23,12,12,4,4,0,22,47,13,82
20200929,29SEP2020:00:00:00,UFU SANTOJANNI,51,40,34,57,0,91,75,16,85,6,7,2,19,23,24,11,5,0,0,22,50,3,75
20200929,29SEP2020:00:00:00,UFU TORNU,51,43,42,46,6,94,80,14,80,14,0,5,23,23,19,7,10,7,0,20,41,19,80
20200929,29SEP2020:00:00:00,UFU VELEZ SARSFIELD,54,33,62,25,0,87,79,8,85,2,0,0,19,19,19,7,10,13,0,16,46,17,79
20200918,18SEP2020:00:00:00,UFU TORNU,28,37,48,11,6,65,57,8,57,8,2,4,17,18,9,7,6,2,0,10,35,12,57
20200918,18SEP2020:00:00:00,UFU VELEZ SARSFIELD,16,14,21,9,0,30,28,2,30,0,0,0,10,9,4,1,2,4,0,7,17,4,28
20200918,18SEP2020:00:00:00,UFU ZUBIZARRETA,28,16,21,23,0,44,26,18,32,12,0,1,3,12,11,13,1,3,0,8,16,2,26
20200919,19SEP2020:00:00:00,UFU ALVAREZ,7,5,10,2,0,12,12,0,12,0,2,0,3,2,3,2,0,0,0,1,3,8,12
20200919,19SEP2020:00:00:00,UFU ARGERICH,3,16,12,7,0,19,19,0,19,0,0,0,5,7,2,4,0,1,0,10,6,3,19
20200919,19SEP2020:00:00:00,UFU BORDA-MOYANO,36,7,28,10,5,43,41,2,41,2,0,0,17,5,3,8,4,6,0,3,24,14,41
20200919,19SEP2020:00:00:00,UFU DURAND,32,23,48,7,0,55,53,2,53,2,2,1,11,17,12,7,4,1,0,16,31,6,53
20200919,19SEP2020:00:00:00,UFU ELIZALDE,19,13,9,23,0,32,26,6,32,0,19,4,1,4,3,0,0,1,0,0,22,4,26
20200919,19SEP2020:00:00:00,UFU FERNANDEZ,22,20,30,12,0,42,36,6,40,2,0,0,15,12,5,4,6,0,0,15,16,5,36
20200919,19SEP2020:00:00:00,UFU FERRER,12,22,23,6,5,34,22,12,24,10,0,1,9,5,10,1,8,0,0,10,10,2,22
20200919,19SEP2020:00:00:00,UFU GRIERSON,14,19,21,11,1,33,33,0,33,0,0,1,10,11,8,1,2,0,0,12,19,2,33
20200919,19SEP2020:00:00:00,UFU GUTIERREZ,33,11,29,15,0,44,38,6,40,4,8,9,5,10,7,5,0,0,0,0,33,4,38
20200919,19SEP2020:00:00:00,UFU MUÑIZ,52,60,45,67,0,112,52,60,64,48,2,2,31,26,17,12,13,9,0,11,36,5,52
20200919,19SEP2020:00:00:00,UFU PENNA,12,19,23,8,0,31,25,6,27,4,0,0,4,12,6,5,4,0,0,8,14,3,25
20200919,19SEP2020:00:00:00,UFU PIROVANO,22,20,31,10,1,42,22,20,40,2,4,2,6,12,7,4,6,1,0,7,14,1,22
20200919,19SEP2020:00:00:00,UFU PIÑERO,22,27,38,11,0,49,41,8,43,6,0,3,11,12,9,5,9,0,0,9,25,7,41
20200919,19SEP2020:00:00:00,UFU RAMOS MEJIA,27,27,40,11,3,54,50,4,52,2,1,4,16,10,8,10,3,2,0,17,17,16,50
20200919,19SEP2020:00:00:00,UFU RIVADAVIA,56,33,71,18,0,89,79,10,87,2,0,1,22,18,22,16,7,3,0,24,35,17,79
20200919,19SEP2020:00:00:00,UFU SANTOJANNI,29,19,33,13,2,48,48,0,48,0,0,6,11,10,10,5,6,0,0,22,25,1,48
20200919,19SEP2020:00:00:00,UFU TORNU,38,34,27,37,8,72,64,8,68,4,2,5,13,9,22,11,6,4,0,18,29,17,64
20200919,19SEP2020:00:00:00,UFU VELEZ SARSFIELD,20,17,28,9,0,37,31,6,35,2,0,0,7,9,10,8,3,0,0,8,22,1,31
20200919,19SEP2020:00:00:00,UFU ZUBIZARRETA,22,32,27,27,0,54,42,12,50,4,0,3,11,16,8,8,4,4,0,16,24,2,42
20200920,20SEP2020:00:00:00,UFU ALVAREZ,5,3,8,0,0,8,8,0,8,0,0,0,1,6,1,0,0,0,0,1,5,2,8
20200920,20SEP2020:00:00:00,UFU ARGERICH,8,10,11,7,0,18,18,0,18,0,1,3,5,5,1,3,0,0,0,5,12,1,18
20200920,20SEP2020:00:00:00,UFU BORDA-MOYANO,1,16,15,2,0,17,17,0,17,0,0,0,1,1,4,8,2,1,0,3,11,3,17
20200920,20SEP2020:00:00:00,UFU DURAND,15,12,21,6,0,27,27,0,27,0,0,0,6,11,3,4,3,0,0,4,13,10,27
20200920,20SEP2020:00:00:00,UFU ELIZALDE,16,8,3,21,0,24,22,2,24,0,9,4,4,3,3,1,0,0,0,1,16,5,22
20200920,20SEP2020:00:00:00,UFU FERNANDEZ,9,10,12,7,0,19,19,0,19,0,0,0,1,14,2,1,1,0,0,4,10,5,19
20200920,20SEP2020:00:00:00,UFU FERRER,11,11,12,8,2,22,13,9,13,9,0,0,7,5,8,0,2,0,0,9,4,0,13
20200920,20SEP2020:00:00:00,UFU GRIERSON,12,6,9,9,0,18,18,0,18,0,0,1,6,6,0,1,2,2,0,9,7,2,18
20200920,20SEP2020:00:00:00,UFU GUTIERREZ,12,10,16,6,0,22,22,0,22,0,4,5,3,5,2,3,0,0,0,1,18,3,22
20200920,20SEP2020:00:00:00,UFU MUÑIZ,60,55,55,59,1,115,75,40,85,30,0,0,27,25,33,18,11,1,0,29,36,10,75
20200920,20SEP2020:00:00:00,UFU PENNA,12,10,14,8,0,22,16,6,20,2,0,0,7,6,4,2,2,1,0,5,9,2,16
20200920,20SEP2020:00:00:00,UFU PIROVANO,20,11,21,10,0,31,17,14,31,0,2,6,4,8,9,2,0,0,0,6,9,2,17
20200920,20SEP2020:00:00:00,UFU PIÑERO,11,19,18,11,1,30,22,8,28,2,0,0,6,12,9,3,0,0,0,9,13,0,22
20200920,20SEP2020:00:00:00,UFU RAMOS MEJIA,16,21,31,6,0,37,37,0,37,0,2,0,6,16,5,3,5,0,0,11,17,9,37
20200920,20SEP2020:00:00:00,UFU RIVADAVIA,22,25,36,11,0,47,37,10,37,10,0,0,13,18,10,2,2,2,0,7,19,8,37
20200920,20SEP2020:00:00:00,UFU SANTOJANNI,14,23,13,24,0,37,35,2,35,2,0,2,9,15,5,5,1,0,0,10,22,3,35
20200920,20SEP2020:00:00:00,UFU TORNU,30,21,25,24,2,51,39,12,47,4,3,1,12,7,12,9,6,1,0,7,23,9,39
20200920,20SEP2020:00:00:00,UFU VELEZ SARSFIELD,17,12,19,10,0,29,29,0,29,0,0,0,6,14,1,3,3,2,0,10,15,4,29
20200920,20SEP2020:00:00:00,UFU ZUBIZARRETA,11,20,22,9,0,31,31,0,31,0,0,0,10,10,3,5,2,1,0,8,19,4,31
20200921,21SEP2020:00:00:00,UFU ALVAREZ,13,9,16,6,0,22,16,6,18,4,0,2,6,6,3,0,5,0,0,5,7,4,16
20200921,21SEP2020:00:00:00,UFU ARGERICH,35,42,42,31,4,77,50,27,50,27,4,3,22,19,13,11,3,2,0,15,22,13,50
20200921,21SEP2020:00:00:00,UFU BORDA-MOYANO,36,15,39,12,0,51,47,4,47,4,0,1,4,5,13,9,10,9,0,3,39,5,47
20200921,21SEP2020:00:00:00,UFU DURAND,52,19,62,9,0,71,63,8,69,2,1,5,16,25,14,2,8,0,0,21,30,12,63
20200921,21SEP2020:00:00:00,UFU ELIZALDE,39,33,20,52,0,72,42,30,68,4,42,17,4,7,0,2,0,0,0,1,25,16,42
20200921,21SEP2020:00:00:00,UFU FERNANDEZ,23,21,36,8,0,44,40,4,42,2,0,2,5,14,8,6,7,2,0,14,24,2,40
20200921,21SEP2020:00:00:00,UFU FERRER,4,2,6,0,0,6,4,2,4,2,0,0,0,3,2,1,0,0,0,1,3,0,4
20200921,21SEP2020:00:00:00,UFU GRIERSON,20,24,29,15,0,44,42,2,42,2,0,1,14,11,11,7,0,0,0,14,26,2,42
20200921,21SEP2020:00:00:00,UFU GUTIERREZ,46,29,32,43,0,75,67,8,75,0,23,10,11,21,6,3,1,0,0,5,52,10,67
20200921,21SEP2020:00:00:00,UFU MUÑIZ,120,98,118,100,0,218,150,68,154,64,0,3,56,62,46,28,18,5,0,23,101,26,150
20200921,21SEP2020:00:00:00,UFU PENNA,20,10,17,13,0,30,26,4,28,2,0,2,5,6,5,5,5,2,0,8,16,2,26
20200921,21SEP2020:00:00:00,UFU PIROVANO,33,12,34,11,0,45,43,2,43,2,0,1,14,10,10,6,4,0,0,6,30,7,43
20200921,21SEP2020:00:00:00,UFU PIÑERO,40,29,31,25,13,69,65,4,65,4,0,4,13,13,11,15,7,6,0,18,38,9,65
20200921,21SEP2020:00:00:00,UFU RAMOS MEJIA,39,24,46,16,1,63,59,4,59,4,3,3,13,15,14,12,3,0,0,29,25,5,59
20200921,21SEP2020:00:00:00,UFU RIVADAVIA,34,51,36,35,14,85,67,18,75,10,0,0,25,23,9,12,11,5,0,19,32,16,67
20200921,21SEP2020:00:00:00,UFU SANTOJANNI,49,41,41,47,2,90,82,8,86,4,3,5,13,29,16,17,2,5,0,24,51,7,82
20200921,21SEP2020:00:00:00,UFU TORNU,41,31,57,11,4,72,66,6,66,6,2,6,13,18,11,11,6,5,0,13,35,18,66
20200921,21SEP2020:00:00:00,UFU VELEZ SARSFIELD,16,21,16,21,0,37,35,2,35,2,2,1,10,7,10,3,2,2,0,2,31,2,35
20200921,21SEP2020:00:00:00,UFU ZUBIZARRETA,29,32,36,25,0,61,39,22,45,16,2,2,13,13,13,8,6,4,0,8,27,4,39
20200922,22SEP2020:00:00:00,UFU ALVAREZ,4,21,21,4,0,25,25,0,25,0,0,1,8,9,3,4,0,0,0,3,8,14,25
20200922,22SEP2020:00:00:00,UFU ARGERICH,42,45,49,38,0,87,52,35,68,19,8,8,20,13,26,5,7,0,0,19,24,9,52
20200922,22SEP2020:00:00:00,UFU BORDA-MOYANO,7,10,11,6,0,17,13,4,13,4,0,0,5,1,3,2,5,1,0,1,11,1,13
20200922,22SEP2020:00:00:00,UFU DURAND,34,32,49,15,2,66,66,0,66,0,0,0,18,19,7,12,7,3,0,19,33,14,66
20200922,22SEP2020:00:00:00,UFU ELIZALDE,43,23,22,44,0,66,38,28,48,18,23,15,8,11,5,3,1,0,0,1,32,5,38
20200922,22SEP2020:00:00:00,UFU FERNANDEZ,20,26,36,9,1,46,46,0,46,0,0,0,10,15,11,3,6,1,0,14,25,7,46
20200922,22SEP2020:00:00:00,UFU GRIERSON,18,30,34,14,0,48,46,2,46,2,1,4,12,12,9,5,5,0,0,19,23,4,46
20200922,22SEP2020:00:00:00,UFU GUTIERREZ,42,38,45,35,0,80,72,8,78,2,18,12,11,17,5,9,7,1,0,5,50,15,72
20200922,22SEP2020:00:00:00,UFU MUÑIZ,107,105,97,113,2,212,112,100,120,92,3,1,48,45,58,30,18,9,0,9,82,21,112
20200922,22SEP2020:00:00:00,UFU PENNA,13,10,18,4,1,23,19,4,19,4,0,1,2,2,13,3,2,0,0,5,11,3,19
20200831,31AUG2020:00:00:00,UFU RAMOS MEJIA,48,55,77,24,2,103,96,7,96,7,4,6,30,24,23,11,4,1,0,48,25,23,96
20200831,31AUG2020:00:00:00,UFU RIVADAVIA,35,42,44,23,10,77,65,12,65,12,0,0,17,23,18,11,6,2,0,17,35,13,65
20200831,31AUG2020:00:00:00,UFU SANTOJANNI,35,55,34,52,4,90,80,10,84,6,2,1,22,16,18,19,7,5,0,31,42,7,80
20200831,31AUG2020:00:00:00,UFU TORNU,44,29,55,16,2,73,69,4,69,4,0,3,23,19,11,8,7,2,0,28,27,14,69
20200831,31AUG2020:00:00:00,UFU VELEZ SARSFIELD,14,28,22,20,0,42,40,2,42,0,0,1,13,12,9,2,3,2,0,5,18,17,40
20200831,31AUG2020:00:00:00,UFU ZUBIZARRETA,25,22,28,19,0,47,37,10,39,8,2,0,9,12,9,9,4,2,0,14,12,11,37
20200901,01SEP2020:00:00:00,UFU ALVAREZ,18,12,23,7,0,30,30,0,30,0,3,0,7,8,6,3,2,1,0,7,8,14,30
20200901,01SEP2020:00:00:00,UFU ARGERICH,37,32,40,25,4,69,53,16,53,16,5,4,11,18,11,16,2,2,0,15,27,11,53
20200901,01SEP2020:00:00:00,UFU BORDA-MOYANO,18,16,23,11,0,34,34,0,34,0,0,2,5,3,11,4,6,3,0,7,22,5,34
20200901,01SEP2020:00:00:00,UFU DURAND,52,33,69,15,1,85,77,8,83,2,2,4,24,22,16,14,2,1,0,24,42,11,77
20200901,01SEP2020:00:00:00,UFU ELIZALDE,23,28,19,32,0,51,47,4,47,4,29,6,2,4,7,2,1,0,0,4,33,10,47
20200901,01SEP2020:00:00:00,UFU FERNANDEZ,25,33,44,14,0,58,50,8,56,2,0,0,18,13,13,6,4,4,0,14,25,11,50
20200901,01SEP2020:00:00:00,UFU FERRER,36,24,20,40,0,60,50,10,50,10,0,0,7,24,14,13,1,1,0,28,16,6,50
20200901,01SEP2020:00:00:00,UFU GRIERSON,23,23,23,23,0,46,46,0,46,0,1,2,10,7,15,10,1,0,0,17,29,0,46
20200901,01SEP2020:00:00:00,UFU GUTIERREZ,37,19,36,18,2,56,48,8,56,0,14,10,8,8,11,5,0,0,0,4,35,9,48
20200901,01SEP2020:00:00:00,UFU MUÑIZ,82,120,108,92,2,202,106,96,126,76,4,6,41,61,40,34,11,5,0,38,56,12,106
20200901,01SEP2020:00:00:00,UFU PENNA,21,7,21,5,2,28,24,4,26,2,0,1,10,7,5,2,3,0,0,10,13,1,24
20200901,01SEP2020:00:00:00,UFU PIROVANO,24,19,37,6,0,43,33,10,43,0,0,1,15,7,9,4,7,0,0,9,20,4,33
20200901,01SEP2020:00:00:00,UFU PIÑERO,52,42,67,24,3,94,72,22,80,14,3,8,25,25,19,9,5,0,0,28,32,12,72
20200901,01SEP2020:00:00:00,UFU RAMOS MEJIA,29,45,59,14,1,74,64,10,64,10,0,2,24,20,11,10,6,1,0,34,19,11,64
20200901,01SEP2020:00:00:00,UFU RIVADAVIA,32,29,37,19,5,61,59,2,59,2,0,0,12,19,12,6,8,4,0,8,42,9,59
20200901,01SEP2020:00:00:00,UFU SANTOJANNI,46,46,47,42,3,92,76,16,82,10,3,6,22,18,18,13,9,3,0,28,46,2,76
20200901,01SEP2020:00:00:00,UFU TORNU,50,41,57,22,12,91,73,18,83,8,2,6,24,18,27,10,3,1,0,22,37,14,73
20200901,01SEP2020:00:00:00,UFU VELEZ SARSFIELD,32,22,34,20,0,54,52,2,54,0,0,2,11,21,12,4,2,2,0,5,25,22,52
20200901,01SEP2020:00:00:00,UFU ZUBIZARRETA,35,20,45,10,0,55,33,22,45,10,0,0,10,23,7,8,6,1,0,13,8,12,33
20200902,02SEP2020:00:00:00,UFU ALVAREZ,9,15,16,8,0,24,22,2,22,2,0,4,10,0,5,1,2,2,0,10,9,3,22
20200902,02SEP2020:00:00:00,UFU ARGERICH,27,18,29,14,2,45,33,12,35,10,1,0,11,9,11,9,4,0,0,14,17,2,33
20200902,02SEP2020:00:00:00,UFU BORDA-MOYANO,40,4,37,6,1,44,42,2,42,2,0,0,0,5,6,17,6,10,0,1,35,6,42
20200902,02SEP2020:00:00:00,UFU DURAND,49,50,85,14,0,99,91,8,93,6,4,2,25,27,16,14,10,1,0,31,44,16,91
20200902,02SEP2020:00:00:00,UFU ELIZALDE,34,16,21,27,2,50,24,26,40,10,18,9,6,10,4,2,1,0,0,4,15,5,24
20200902,02SEP2020:00:00:00,UFU FERNANDEZ,25,37,40,22,0,62,60,2,62,0,0,0,13,20,18,8,2,1,0,23,26,11,60
20200902,02SEP2020:00:00:00,UFU FERRER,15,23,17,21,0,38,36,2,36,2,0,3,7,13,6,7,2,0,0,19,10,7,36
20200902,02SEP2020:00:00:00,UFU GRIERSON,16,19,19,16,0,35,35,0,35,0,2,4,8,9,4,5,2,1,0,15,18,2,35
20200902,02SEP2020:00:00:00,UFU GUTIERREZ,31,28,26,31,2,59,57,2,57,2,15,11,3,5,13,7,5,0,0,6,42,9,57
20200902,02SEP2020:00:00:00,UFU MUÑIZ,62,100,87,74,1,162,86,76,104,58,0,2,23,53,36,38,6,4,0,27,52,7,86
20200902,02SEP2020:00:00:00,UFU PENNA,21,12,22,11,0,33,31,2,33,0,0,0,4,8,7,1,6,7,0,10,16,5,31
20200902,02SEP2020:00:00:00,UFU PIROVANO,15,27,29,13,0,42,40,2,42,0,0,1,10,13,5,6,6,1,0,4,30,6,40
20200902,02SEP2020:00:00:00,UFU PIÑERO,20,21,17,23,1,41,21,20,25,16,0,2,11,9,4,8,7,0,0,10,10,1,21
20200902,02SEP2020:00:00:00,UFU RAMOS MEJIA,40,44,63,19,2,84,64,20,74,10,3,0,21,33,12,6,6,3,0,19,38,7,64
20200902,02SEP2020:00:00:00,UFU RIVADAVIA,34,39,29,31,13,73,69,4,69,4,0,0,10,32,15,9,6,1,0,12,40,14,69
20200902,02SEP2020:00:00:00,UFU SANTOJANNI,40,30,39,27,4,70,60,10,62,8,2,5,18,19,13,6,7,0,0,22,34,4,60
20200902,02SEP2020:00:00:00,UFU TORNU,50,47,63,28,6,97,83,14,83,14,3,4,22,26,18,13,11,0,0,20,40,22,83
20200902,02SEP2020:00:00:00,UFU VELEZ SARSFIELD,14,11,13,11,1,25,25,0,25,0,0,0,8,4,6,6,0,1,0,4,14,7,25
20200902,02SEP2020:00:00:00,UFU ZUBIZARRETA,13,16,13,18,0,31,23,8,27,4,0,0,5,7,11,5,3,0,0,6,7,10,23
20200903,03SEP2020:00:00:00,UFU ALVAREZ,10,11,16,5,0,21,21,0,21,0,0,0,8,8,3,1,1,0,0,11,8,2,21
20200903,03SEP2020:00:00:00,UFU ARGERICH,36,20,32,22,2,56,36,20,52,4,0,1,10,15,11,10,7,2,0,10,16,10,36
20200903,03SEP2020:00:00:00,UFU BORDA-MOYANO,47,13,34,21,5,60,54,6,54,6,0,0,11,13,12,8,14,2,0,3,44,7,54
20200903,03SEP2020:00:00:00,UFU DURAND,62,50,87,25,0,112,98,14,102,10,1,3,18,37,22,21,9,1,0,40,46,12,98
20200903,03SEP2020:00:00:00,UFU ELIZALDE,37,16,19,34,0,53,41,12,45,8,24,9,6,7,6,1,0,0,0,3,32,6,41
20200903,03SEP2020:00:00:00,UFU FERNANDEZ,29,25,37,13,4,54,42,12,44,10,0,0,10,21,9,11,2,1,0,12,21,9,42
20200903,03SEP2020:00:00:00,UFU FERRER,20,39,37,22,0,59,45,14,47,12,1,2,10,20,17,5,4,0,0,12,26,7,45
20200903,03SEP2020:00:00:00,UFU GRIERSON,20,29,25,24,0,49,45,4,45,4,0,0,18,13,7,5,6,0,0,17,23,5,45
20200903,03SEP2020:00:00:00,UFU GUTIERREZ,33,13,20,24,2,46,46,0,46,0,9,3,10,12,5,2,5,0,0,6,33,7,46
20200903,03SEP2020:00:00:00,UFU MUÑIZ,90,104,111,82,1,194,116,78,122,72,1,2,44,48,46,34,10,9,0,31,72,13,116
20200903,03SEP2020:00:00:00,UFU PENNA,18,13,23,6,2,31,21,10,27,4,0,0,5,7,7,3,3,6,0,8,10,3,21
20200903,03SEP2020:00:00:00,UFU PIROVANO,15,23,31,7,0,38,32,6,36,2,0,0,9,13,7,5,2,2,0,8,22,2,32
20200903,03SEP2020:00:00:00,UFU PIÑERO,57,49,71,31,4,106,73,33,87,19,7,5,25,27,15,11,10,6,0,31,35,7,73
20200903,03SEP2020:00:00:00,UFU RAMOS MEJIA,54,48,81,19,2,102,96,6,96,6,3,2,26,30,24,15,1,1,0,41,35,20,96
20200903,03SEP2020:00:00:00,UFU RIVADAVIA,42,47,49,29,11,89,77,12,79,10,0,1,23,21,21,13,8,2,0,15,41,21,77
20200903,03SEP2020:00:00:00,UFU SANTOJANNI,44,37,61,20,0,81,73,8,79,2,2,5,19,17,10,15,9,4,0,30,39,4,73
20200903,03SEP2020:00:00:00,UFU TORNU,63,47,81,27,2,110,98,12,102,8,4,6,23,28,16,13,12,8,0,29,52,16,98
20200903,03SEP2020:00:00:00,UFU VELEZ SARSFIELD,32,16,39,9,0,48,44,4,48,0,0,0,14,16,10,6,0,2,0,10,17,17,44
20200903,03SEP2020:00:00:00,UFU ZUBIZARRETA,39,25,46,16,2,64,42,22,52,12,3,0,14,18,12,5,6,6,0,4,15,23,42
20200904,04SEP2020:00:00:00,UFU ALVAREZ,27,17,35,9,0,44,44,0,44,0,5,8,9,10,7,3,1,1,0,14,21,9,44
20200904,04SEP2020:00:00:00,UFU ARGERICH,39,27,45,21,0,66,50,16,54,12,3,1,12,19,16,9,2,4,0,21,22,7,50
20200904,04SEP2020:00:00:00,UFU BORDA-MOYANO,20,9,11,18,0,29,29,0,29,0,0,0,1,5,13,8,1,1,0,2,22,5,29
20200904,04SEP2020:00:00:00,UFU DURAND,60,52,92,17,3,112,100,12,100,12,7,1,23,27,24,18,9,3,0,33,45,22,100
20200904,04SEP2020:00:00:00,UFU ELIZALDE,20,19,16,23,0,39,39,0,39,0,13,11,4,7,1,1,2,0,0,7,26,6,39
20200904,04SEP2020:00:00:00,UFU FERNANDEZ,35,25,39,19,2,60,52,8,58,2,0,2,13,29,12,2,2,0,0,19,19,14,52
20200904,04SEP2020:00:00:00,UFU FERRER,33,32,37,28,0,65,55,10,55,10,0,1,20,18,15,8,2,1,0,25,24,6,55
20200904,04SEP2020:00:00:00,UFU GRIERSON,27,20,23,24,0,47,45,2,45,2,3,2,13,8,11,8,2,0,0,15,28,2,45
20200904,04SEP2020:00:00:00,UFU GUTIERREZ,57,27,35,49,0,84,66,18,72,12,11,3,20,26,14,10,0,0,0,19,31,15,66
20200904,04SEP2020:00:00:00,UFU MUÑIZ,91,118,86,120,3,209,125,84,137,72,2,5,47,62,45,33,10,5,0,33,71,21,125
20200904,04SEP2020:00:00:00,UFU PENNA,16,6,13,8,1,22,16,6,22,0,0,0,0,9,1,9,3,0,0,6,9,1,16
20200904,04SEP2020:00:00:00,UFU PIROVANO,20,14,25,9,0,34,34,0,34,0,0,0,10,6,8,8,1,1,0,10,18,6,34
20200904,04SEP2020:00:00:00,UFU PIÑERO,39,28,43,22,2,67,45,22,57,10,3,1,14,17,15,12,3,2,0,21,22,1,45
20200904,04SEP2020:00:00:00,UFU RAMOS MEJIA,46,47,67,25,1,93,89,4,89,4,2,5,20,29,7,15,13,2,0,27,10,52,89
20200904,04SEP2020:00:00:00,UFU RIVADAVIA,30,35,42,13,10,65,57,8,61,4,0,0,16,24,8,9,7,1,0,11,38,8,57
20200904,04SEP2020:00:00:00,UFU SANTOJANNI,43,37,42,37,1,80,76,4,76,4,1,5,12,20,24,10,5,3,0,31,40,5,76
20200904,04SEP2020:00:00:00,UFU TORNU,47,37,56,26,2,84,70,14,74,10,1,7,10,17,21,18,7,3,0,15,39,15,70
20200904,04SEP2020:00:00:00,UFU VELEZ SARSFIELD,28,17,34,11,0,45,39,6,41,4,0,5,10,8,12,6,2,2,0,10,21,7,39
20200904,04SEP2020:00:00:00,UFU ZUBIZARRETA,36,30,43,22,1,66,40,26,50,16,2,3,12,18,10,17,4,0,0,7,24,9,40
20200905,05SEP2020:00:00:00,UFU ALVAREZ,5,22,20,7,0,27,27,0,27,0,0,0,3,7,10,4,3,0,0,6,19,2,27
20200905,05SEP2020:00:00:00,UFU ARGERICH,5,12,5,12,0,17,15,2,15,2,1,0,5,5,1,3,2,0,0,9,5,1,15
20200905,05SEP2020:00:00:00,UFU BORDA-MOYANO,14,4,6,9,3,18,18,0,18,0,0,0,2,8,3,3,2,0,0,3,12,3,18
20200905,05SEP2020:00:00:00,UFU DURAND,31,42,61,12,0,73,63,10,71,2,6,3,10,24,12,11,4,3,0,26,27,10,63
20200905,05SEP2020:00:00:00,UFU ELIZALDE,11,9,2,18,0,20,18,2,20,0,6,7,1,2,1,2,1,0,0,2,15,1,18
20200905,05SEP2020:00:00:00,UFU FERNANDEZ,17,16,26,7,0,33,33,0,33,0,0,0,9,11,7,4,0,2,0,6,15,12,33
20200905,05SEP2020:00:00:00,UFU FERRER,27,17,20,19,5,44,32,12,34,10,0,0,6,11,15,6,4,2,0,8,19,5,32
20200905,05SEP2020:00:00:00,UFU GRIERSON,27,13,26,14,0,40,38,2,40,0,0,1,11,9,9,7,2,1,0,8,28,2,38
20200905,05SEP2020:00:00:00,UFU GUTIERREZ,22,31,29,24,0,53,47,6,51,2,10,7,7,9,8,8,4,0,0,10,27,10,47
20200905,05SEP2020:00:00:00,UFU MUÑIZ,87,98,93,91,1,185,83,102,89,96,0,6,34,48,38,31,19,9,0,29,45,9,83
20200905,05SEP2020:00:00:00,UFU PENNA,12,5,6,11,0,17,15,2,17,0,0,0,5,6,3,2,1,0,0,8,7,0,15
20200905,05SEP2020:00:00:00,UFU PIROVANO,20,10,21,9,0,30,28,2,28,2,0,0,7,7,7,6,3,0,0,8,16,4,28
20200905,05SEP2020:00:00:00,UFU PIÑERO,40,44,55,26,3,84,60,24,68,16,0,5,14,22,20,7,12,4,0,14,34,12,60
20200905,05SEP2020:00:00:00,UFU RAMOS MEJIA,43,25,51,15,2,68,64,4,64,4,0,0,25,13,14,10,3,3,0,34,8,22,64
20200905,05SEP2020:00:00:00,UFU RIVADAVIA,31,17,29,17,2,48,44,4,46,2,0,0,12,15,10,2,5,4,0,9,29,6,44
20200905,05SEP2020:00:00:00,UFU SANTOJANNI,32,23,22,33,0,55,43,12,49,6,4,1,13,12,18,5,2,0,0,18,25,0,43
20200905,05SEP2020:00:00:00,UFU TORNU,46,42,33,44,11,88,80,8,82,6,2,2,26,21,19,11,7,0,0,36,29,14,80
20200905,05SEP2020:00:00:00,UFU VELEZ SARSFIELD,12,16,14,14,0,28,26,2,28,0,0,1,9,3,10,1,2,2,0,11,13,2,26
20200905,05SEP2020:00:00:00,UFU ZUBIZARRETA,18,14,22,10,0,32,24,8,30,2,0,1,8,4,8,4,3,4,0,12,8,4,24
20200906,06SEP2020:00:00:00,UFU ALVAREZ,7,5,9,3,0,12,10,2,10,2,0,0,3,3,0,2,4,0,0,0,2,8,10
20200906,06SEP2020:00:00:00,UFU ARGERICH,12,17,19,10,0,29,17,12,17,12,1,0,6,6,8,4,4,0,0,7,5,5,17
20200906,06SEP2020:00:00:00,UFU BORDA-MOYANO,4,2,5,1,0,6,4,2,4,2,0,0,0,1,2,0,0,3,0,1,2,1,4
20200906,06SEP2020:00:00:00,UFU DURAND,31,29,55,5,0,60,48,12,56,4,1,6,10,19,8,10,5,1,0,22,19,7,48
20200906,06SEP2020:00:00:00,UFU ELIZALDE,25,18,23,20,0,43,35,8,43,0,15,11,1,8,7,1,0,0,0,3,28,4,35
20200906,06SEP2020:00:00:00,UFU FERNANDEZ,17,21,24,14,0,38,30,8,36,2,0,0,4,22,4,5,3,0,0,12,14,4,30
20200906,06SEP2020:00:00:00,UFU FERRER,12,19,18,11,2,31,21,10,21,10,0,0,8,11,8,1,3,0,0,7,12,2,21
20200906,06SEP2020:00:00:00,UFU GRIERSON,31,19,28,22,0,50,48,2,48,2,6,4,12,10,10,6,2,0,0,17,27,4,48
20200906,06SEP2020:00:00:00,UFU GUTIERREZ,15,22,32,5,0,37,33,4,35,2,7,8,9,7,5,1,0,0,0,2,23,8,33
20200906,06SEP2020:00:00:00,UFU MUÑIZ,57,62,68,51,0,119,67,52,75,44,5,2,13,31,25,18,16,9,0,23,36,8,67
20200906,06SEP2020:00:00:00,UFU PENNA,14,15,17,12,0,29,25,4,25,4,0,3,4,8,4,7,3,0,0,9,11,5,25
20200906,06SEP2020:00:00:00,UFU PIROVANO,12,9,17,0,4,21,17,4,19,2,0,0,2,8,5,5,1,0,0,3,9,5,17
20200906,06SEP2020:00:00:00,UFU PIÑERO,34,31,42,23,0,65,59,6,61,4,1,1,20,13,14,10,6,0,0,17,33,8,59
20200906,06SEP2020:00:00:00,UFU RAMOS MEJIA,27,29,36,18,2,56,54,2,56,0,3,5,14,16,10,3,5,0,0,20,21,13,54
20200906,06SEP2020:00:00:00,UFU RIVADAVIA,17,14,24,5,2,31,29,2,29,2,0,0,7,7,8,4,2,3,0,6,18,4,29
20200906,06SEP2020:00:00:00,UFU SANTOJANNI,20,15,16,19,0,35,33,2,33,2,0,0,7,9,12,5,2,0,0,14,18,1,33
20200906,06SEP2020:00:00:00,UFU TORNU,25,22,18,28,1,47,45,2,47,0,2,9,8,10,7,6,4,1,0,14,24,7,45
20200906,06SEP2020:00:00:00,UFU VELEZ SARSFIELD,19,12,27,4,0,31,25,6,29,2,0,0,6,6,11,5,2,1,0,4,11,10,25
20200906,06SEP2020:00:00:00,UFU ZUBIZARRETA,9,10,12,7,0,19,15,4,19,0,0,1,3,4,5,2,4,0,0,8,5,2,15
20200907,07SEP2020:00:00:00,UFU ALVAREZ,30,8,29,7,2,38,36,2,36,2,3,0,7,5,11,5,5,2,0,9,16,11,36
20200907,07SEP2020:00:00:00,UFU ARGERICH,42,31,46,21,6,73,47,26,47,26,7,2,13,19,18,5,8,1,0,20,15,12,47
20200907,07SEP2020:00:00:00,UFU BORDA-MOYANO,13,3,12,4,0,16,14,2,14,2,0,0,0,4,3,3,5,1,0,4,7,3,14
20200907,07SEP2020:00:00:00,UFU DURAND,47,46,72,20,1,93,89,4,91,2,1,0,13,28,24,12,13,2,0,31,47,11,89
20200907,07SEP2020:00:00:00,UFU ELIZALDE,31,26,21,36,0,57,51,6,51,6,29,11,0,9,4,3,1,0,0,6,36,9,51
20200907,07SEP2020:00:00:00,UFU FERNANDEZ,41,31,55,15,2,72,70,2,70,2,2,0,15,16,15,17,7,0,0,22,34,14,70
20200907,07SEP2020:00:00:00,UFU FERRER,48,40,31,57,0,88,76,12,76,12,0,0,20,40,20,5,3,0,0,32,34,10,76
20200907,07SEP2020:00:00:00,UFU GRIERSON,21,25,37,9,0,46,44,2,44,2,1,3,9,13,10,9,1,0,0,13,28,3,44
20200907,07SEP2020:00:00:00,UFU GUTIERREZ,57,28,35,50,0,85,85,0,85,0,17,12,11,22,15,6,1,1,0,7,53,23,85
20200907,07SEP2020:00:00:00,UFU MUÑIZ,124,134,114,139,5,258,152,106,170,88,4,9,61,73,48,35,22,6,0,36,88,28,152
20200907,07SEP2020:00:00:00,UFU PENNA,23,11,18,16,0,34,28,6,30,4,0,0,2,9,14,4,5,0,0,6,17,5,28
20200907,07SEP2020:00:00:00,UFU PIROVANO,25,27,44,8,0,52,48,4,50,2,0,1,9,15,7,6,9,5,0,12,22,14,48
20200907,07SEP2020:00:00:00,UFU PIÑERO,49,47,61,33,2,96,84,12,88,8,3,2,20,24,24,15,2,6,0,37,40,6,84
20200907,07SEP2020:00:00:00,UFU RAMOS MEJIA,42,38,58,20,2,80,76,4,78,2,4,1,26,21,14,7,6,1,0,36,20,20,76
20200907,07SEP2020:00:00:00,UFU RIVADAVIA,59,44,64,28,11,103,99,4,99,4,0,0,28,26,16,13,16,4,0,25,44,29,99
20200907,07SEP2020:00:00:00,UFU SANTOJANNI,58,37,55,40,0,95,81,14,89,6,2,3,18,25,25,16,5,1,0,31,46,4,81
20200907,07SEP2020:00:00:00,UFU TORNU,41,54,56,35,4,95,71,24,71,24,2,1,15,25,15,16,16,5,0,14,40,16,71
20200907,07SEP2020:00:00:00,UFU VELEZ SARSFIELD,28,17,33,12,0,45,45,0,45,0,0,0,17,5,11,6,5,1,0,5,13,27,45
20200907,07SEP2020:00:00:00,UFU ZUBIZARRETA,39,23,35,27,0,62,26,36,34,28,0,3,16,10,12,14,5,2,0,6,17,3,26
20200908,08SEP2020:00:00:00,UFU ALVAREZ,7,7,13,1,0,14,14,0,14,0,0,0,5,5,3,0,1,0,0,2,8,4,14
20200908,08SEP2020:00:00:00,UFU ARGERICH,25,32,40,15,2,57,53,4,53,4,1,3,9,15,15,5,5,4,0,26,14,13,53
20200908,08SEP2020:00:00:00,UFU BORDA-MOYANO,16,18,26,6,2,34,2,32,2,32,0,0,5,7,7,3,7,5,0,0,2,0,2
20200908,08SEP2020:00:00:00,UFU DURAND,54,38,81,10,1,92,82,10,88,4,4,3,21,22,22,16,4,0,0,22,46,14,82
20200908,08SEP2020:00:00:00,UFU ELIZALDE,32,20,13,39,0,52,38,14,46,6,31,6,1,5,3,3,3,0,0,1,32,5,38
20200908,08SEP2020:00:00:00,UFU FERNANDEZ,40,20,45,15,0,60,56,4,60,0,0,0,9,14,17,17,1,2,0,18,31,7,56
20200908,08SEP2020:00:00:00,UFU FERRER,39,37,30,46,0,76,64,12,68,8,0,0,18,19,24,10,5,0,0,20,37,7,64
20200908,08SEP2020:00:00:00,UFU GRIERSON,18,30,23,25,0,48,42,6,42,6,0,1,12,12,10,6,3,4,0,12,29,1,42
20200908,08SEP2020:00:00:00,UFU GUTIERREZ,39,35,47,27,0,74,59,15,73,1,8,11,17,21,8,3,5,1,0,4,41,14,59
20200908,08SEP2020:00:00:00,UFU MUÑIZ,87,87,80,92,2,174,110,64,124,50,2,1,29,50,49,23,15,5,0,32,57,21,110
20200908,08SEP2020:00:00:00,UFU PENNA,23,8,22,6,3,31,17,14,21,10,0,2,9,7,7,1,4,1,0,3,12,2,17
20200908,08SEP2020:00:00:00,UFU PIROVANO,24,22,32,14,0,46,42,4,46,0,0,2,6,17,9,2,3,7,0,7,30,5,42
20200908,08SEP2020:00:00:00,UFU PIÑERO,50,40,65,24,1,90,66,24,78,12,5,2,20,17,16,11,12,7,0,22,30,12,66
20200908,08SEP2020:00:00:00,UFU RAMOS MEJIA,69,36,73,31,1,105,99,6,99,6,3,9,22,22,27,12,10,0,0,34,41,24,99
20200908,08SEP2020:00:00:00,UFU RIVADAVIA,51,29,43,16,21,80,72,8,72,8,0,2,12,22,21,15,7,1,0,17,42,11,72
20200908,08SEP2020:00:00:00,UFU SANTOJANNI,58,39,59,36,2,97,79,18,93,4,9,2,24,28,18,11,4,1,0,26,47,6,79
20200908,08SEP2020:00:00:00,UFU TORNU,59,72,88,41,2,131,115,16,115,16,3,11,23,40,20,22,11,1,0,38,55,22,115
20200908,08SEP2020:00:00:00,UFU VELEZ SARSFIELD,27,11,25,13,0,38,30,8,38,0,0,0,4,17,7,6,2,2,0,3,25,2,30
20200908,08SEP2020:00:00:00,UFU ZUBIZARRETA,34,16,32,18,0,50,32,18,42,8,0,1,14,10,13,4,6,2,0,7,25,0,32
20200909,09SEP2020:00:00:00,UFU ALVAREZ,5,6,9,2,0,11,9,2,11,0,0,0,7,1,2,0,0,1,0,3,5,1,9
20200909,09SEP2020:00:00:00,UFU ARGERICH,39,32,44,27,0,71,55,16,59,12,0,6,7,19,14,13,1,11,0,23,19,13,55
20200909,09SEP2020:00:00:00,UFU BORDA-MOYANO,27,5,28,4,0,32,28,4,28,4,0,0,5,6,2,9,4,6,0,7,15,6,28
20200909,09SEP2020:00:00:00,UFU DURAND,54,41,82,13,0,95,81,14,93,2,0,2,31,24,12,14,5,7,0,32,33,16,81
20200909,09SEP2020:00:00:00,UFU ELIZALDE,39,23,14,45,3,62,44,18,54,8,36,14,2,3,5,1,1,0,0,7,31,6,44
20200909,09SEP2020:00:00:00,UFU FERNANDEZ,45,33,56,22,0,78,70,8,74,4,0,0,11,28,20,14,5,0,0,17,37,16,70
20200909,09SEP2020:00:00:00,UFU FERRER,39,44,27,56,0,83,77,6,77,6,0,0,18,26,24,10,5,0,0,31,41,5,77
20200909,09SEP2020:00:00:00,UFU GRIERSON,38,26,37,25,2,64,64,0,64,0,0,5,20,12,14,7,2,4,0,22,37,5,64
20200909,09SEP2020:00:00:00,UFU GUTIERREZ,33,33,41,25,0,66,64,2,66,0,21,16,8,14,1,3,3,0,0,4,45,14,64
20200909,09SEP2020:00:00:00,UFU MUÑIZ,106,94,99,99,2,200,116,84,140,60,1,2,42,65,41,22,21,6,0,27,70,19,116
20200909,09SEP2020:00:00:00,UFU PENNA,14,29,22,17,4,43,25,18,33,10,0,0,9,15,5,8,1,5,0,10,11,4,25
20200909,09SEP2020:00:00:00,UFU PIROVANO,11,25,22,12,2,36,18,18,26,10,4,0,8,8,5,6,5,0,0,8,7,2,18
20200909,09SEP2020:00:00:00,UFU PIÑERO,46,38,58,24,2,84,76,8,78,6,4,7,19,18,12,15,7,2,0,19,54,3,76
20200909,09SEP2020:00:00:00,UFU RAMOS MEJIA,46,50,68,26,2,96,82,14,86,10,3,0,28,27,18,10,6,4,0,43,29,10,82
20200909,09SEP2020:00:00:00,UFU RIVADAVIA,58,37,37,45,13,95,81,14,83,12,0,0,31,27,11,15,8,3,0,17,46,17,81
20200909,09SEP2020:00:00:00,UFU SANTOJANNI,36,44,43,37,0,80,68,12,76,4,4,2,17,24,15,12,4,2,0,25,38,5,68
20200909,09SEP2020:00:00:00,UFU TORNU,67,44,74,32,5,111,103,8,103,8,3,7,11,40,25,16,8,1,0,26,52,24,103
20200909,09SEP2020:00:00:00,UFU VELEZ SARSFIELD,24,30,49,3,2,54,38,16,52,2,0,1,14,20,10,6,2,1,0,5,31,2,38
20200909,09SEP2020:00:00:00,UFU ZUBIZARRETA,21,24,19,24,2,45,25,20,41,4,0,0,15,10,6,5,5,4,0,13,10,2,25
20200910,10SEP2020:00:00:00,UFU ALVAREZ,11,9,17,3,0,20,18,2,20,0,3,0,4,5,4,2,2,0,0,5,4,9,18
20200910,10SEP2020:00:00:00,UFU ARGERICH,42,24,38,28,0,66,42,24,44,22,2,3,13,17,11,13,7,0,0,20,17,5,42
20200910,10SEP2020:00:00:00,UFU BORDA-MOYANO,40,19,46,12,1,59,55,4,55,4,0,1,2,8,11,16,9,12,0,10,38,7,55
20200910,10SEP2020:00:00:00,UFU DURAND,69,48,99,15,3,117,99,18,107,10,2,1,20,31,26,21,14,2,0,36,47,16,99
20200910,10SEP2020:00:00:00,UFU ELIZALDE,27,23,8,40,2,50,34,16,40,10,31,7,2,4,5,1,0,0,0,1,28,5,34
20200910,10SEP2020:00:00:00,UFU FERNANDEZ,20,20,36,4,0,40,38,2,38,2,0,2,9,17,5,6,0,1,0,9,21,8,38
20200910,10SEP2020:00:00:00,UFU FERRER,32,21,26,27,0,53,41,12,43,10,0,0,8,7,15,18,5,0,0,10,20,11,41
20200910,10SEP2020:00:00:00,UFU GRIERSON,28,19,28,19,0,47,47,0,47,0,1,1,12,13,14,3,3,0,0,11,32,4,47
20200910,10SEP2020:00:00:00,UFU GUTIERREZ,29,20,31,18,0,49,43,6,47,2,11,6,5,16,8,3,0,0,0,12,24,6,43
20200910,10SEP2020:00:00:00,UFU MUÑIZ,121,141,137,119,6,262,158,104,178,84,3,1,68,77,52,36,16,9,0,23,108,27,158
20200910,10SEP2020:00:00:00,UFU PENNA,16,17,16,13,4,33,27,6,27,6,0,0,12,2,5,10,2,2,0,11,14,2,27
20200910,10SEP2020:00:00:00,UFU PIROVANO,14,10,19,5,0,24,24,0,24,0,0,0,10,5,5,3,1,0,0,3,18,3,24
20200910,10SEP2020:00:00:00,UFU PIÑERO,52,55,68,33,6,107,77,30,89,18,3,4,18,24,19,16,14,9,0,25,40,11,77
20200910,10SEP2020:00:00:00,UFU RAMOS MEJIA,41,46,47,38,2,87,83,4,83,4,5,4,21,22,19,5,8,3,0,38,31,14,83
20200910,10SEP2020:00:00:00,UFU RIVADAVIA,65,47,65,37,10,112,92,20,100,12,0,0,36,35,11,22,6,2,0,19,53,20,92
20200910,10SEP2020:00:00:00,UFU SANTOJANNI,42,35,44,33,0,77,67,10,77,0,6,6,15,18,16,13,2,1,0,25,38,4,67
20200910,10SEP2020:00:00:00,UFU TORNU,41,45,56,25,5,86,82,4,82,4,6,4,19,22,8,14,13,0,0,24,48,10,82
20200910,10SEP2020:00:00:00,UFU VELEZ SARSFIELD,30,12,29,13,0,42,42,0,42,0,0,1,11,10,8,4,6,2,0,8,25,9,42
20200910,10SEP2020:00:00:00,UFU ZUBIZARRETA,38,19,38,19,0,57,39,18,49,8,2,4,12,12,12,12,3,0,0,16,20,3,39
20200911,11SEP2020:00:00:00,UFU ALVAREZ,13,13,24,2,0,26,24,2,24,2,2,4,8,5,3,3,1,0,0,6,10,8,24
20200911,11SEP2020:00:00:00,UFU ARGERICH,36,30,39,27,0,66,64,2,64,2,4,1,22,12,7,13,4,3,0,31,17,16,64
20200911,11SEP2020:00:00:00,UFU BORDA-MOYANO,20,24,29,15,0,44,42,2,42,2,0,2,7,5,12,8,3,7,0,3,32,7,42
20200911,11SEP2020:00:00:00,UFU DURAND,31,47,56,20,2,78,64,14,72,6,2,6,17,25,13,9,6,0,0,18,33,13,64
20200911,11SEP2020:00:00:00,UFU ELIZALDE,39,13,23,28,1,52,33,19,37,15,27,10,3,6,3,2,1,0,0,2,24,7,33
20200911,11SEP2020:00:00:00,UFU FERNANDEZ,29,33,50,11,1,62,58,4,60,2,0,0,11,19,17,9,2,4,0,16,32,10,58
20200911,11SEP2020:00:00:00,UFU FERRER,33,36,28,41,0,69,59,10,59,10,0,1,15,23,23,4,2,1,0,15,39,5,59
20200911,11SEP2020:00:00:00,UFU GRIERSON,23,22,15,30,0,45,45,0,45,0,0,3,12,10,11,8,1,0,0,16,29,0,45
20200911,11SEP2020:00:00:00,UFU GUTIERREZ,30,19,33,15,1,49,45,4,49,0,1,5,4,14,16,8,1,0,0,3,34,7,45
20200911,11SEP2020:00:00:00,UFU MUÑIZ,138,157,145,133,17,295,177,118,223,72,9,5,73,90,50,35,26,7,0,33,109,35,177
20200911,11SEP2020:00:00:00,UFU PENNA,26,12,28,10,0,38,24,14,34,4,0,0,4,7,8,10,5,4,0,7,12,5,24
20201014,14OCT2020:00:00:00,UFU RIVADAVIA,40,38,48,19,11,78,70,8,72,6,0,1,16,24,12,13,9,3,0,12,44,14,70
20201014,14OCT2020:00:00:00,UFU SANTOJANNI,41,28,42,27,0,69,61,8,65,4,1,3,14,16,13,10,9,3,0,25,33,3,61
20201014,14OCT2020:00:00:00,UFU TORNU,54,69,82,41,0,123,109,14,111,12,0,6,16,37,21,19,12,12,0,25,54,30,109
20201014,14OCT2020:00:00:00,UFU VELEZ SARSFIELD,35,33,45,21,2,68,62,6,66,2,0,0,18,13,17,11,3,6,0,10,44,8,62
20201014,14OCT2020:00:00:00,UFU ZUBIZARRETA,8,10,7,11,0,18,16,2,16,2,0,2,3,2,4,2,4,1,0,3,13,0,16
20201015,15OCT2020:00:00:00,UFU ALVAREZ,36,39,57,18,0,75,67,8,67,8,3,5,16,18,16,14,0,3,0,14,39,14,67
20201015,15OCT2020:00:00:00,UFU ARGERICH,41,32,40,27,6,73,51,22,51,22,4,7,11,23,11,4,2,11,0,7,30,14,51
20201015,15OCT2020:00:00:00,UFU BORDA-MOYANO,16,7,14,9,0,23,21,2,21,2,0,0,0,9,5,1,6,2,0,2,11,8,21
20201015,15OCT2020:00:00:00,UFU DURAND,24,28,42,8,2,52,48,4,48,4,0,1,10,17,16,4,1,3,0,11,35,2,48
20201015,15OCT2020:00:00:00,UFU ELIZALDE,35,25,18,42,0,60,48,12,56,4,29,12,5,7,5,1,1,0,0,3,33,12,48
20201015,15OCT2020:00:00:00,UFU FERNANDEZ,13,32,28,16,1,45,43,2,45,0,0,1,8,9,17,4,4,2,0,13,24,6,43
20201015,15OCT2020:00:00:00,UFU FERRER,30,31,28,33,0,61,57,4,57,4,0,2,17,14,12,7,7,2,0,14,36,7,57
20201015,15OCT2020:00:00:00,UFU GRIERSON,16,15,15,16,0,31,29,2,29,2,1,1,6,4,10,3,3,3,0,5,20,4,29
20201015,15OCT2020:00:00:00,UFU GUTIERREZ,74,19,58,35,0,93,75,18,85,8,17,6,29,26,7,5,0,3,0,3,54,18,75
20201015,15OCT2020:00:00:00,UFU MUÑIZ,132,165,151,141,5,297,149,148,159,138,0,8,72,81,49,44,33,10,0,21,96,32,149
20201015,15OCT2020:00:00:00,UFU PENNA,12,7,10,7,2,19,19,0,19,0,0,0,6,9,1,1,2,0,0,6,9,4,19
20201015,15OCT2020:00:00:00,UFU PIROVANO,36,29,52,11,2,65,57,8,61,4,0,3,19,14,14,14,1,0,0,7,36,14,57
20201015,15OCT2020:00:00:00,UFU PIÑERO,55,39,54,26,14,94,74,20,76,18,3,1,27,8,20,22,8,5,0,7,53,12,74
20201015,15OCT2020:00:00:00,UFU RAMOS MEJIA,24,19,35,7,1,43,39,4,43,0,0,1,8,13,9,3,6,3,0,14,21,4,39
20201015,15OCT2020:00:00:00,UFU RIVADAVIA,37,33,39,23,8,70,64,6,64,6,0,1,13,20,12,7,13,4,0,11,44,8,64
20201015,15OCT2020:00:00:00,UFU SANTOJANNI,35,36,30,40,1,71,59,12,69,2,3,0,15,20,17,9,5,2,0,15,42,2,59
20201015,15OCT2020:00:00:00,UFU TORNU,42,48,60,28,2,90,84,6,86,4,2,4,21,23,20,11,6,3,0,8,53,19,84
20201015,15OCT2020:00:00:00,UFU VELEZ SARSFIELD,38,33,56,15,0,71,65,6,69,2,0,0,15,17,22,9,8,0,0,9,45,11,65
20201015,15OCT2020:00:00:00,UFU ZUBIZARRETA,12,15,18,9,0,27,19,8,23,4,3,1,5,8,1,7,0,2,0,7,9,3,19
20201016,16OCT2020:00:00:00,UFU ALVAREZ,82,43,90,35,0,125,117,8,117,8,4,6,42,21,15,21,12,4,0,11,37,69,117
20201016,16OCT2020:00:00:00,UFU ARGERICH,30,16,27,19,0,46,42,4,42,4,4,4,17,8,5,5,1,2,0,12,19,11,42
20201016,16OCT2020:00:00:00,UFU BORDA-MOYANO,14,3,9,7,1,17,13,4,13,4,0,3,1,6,3,2,2,0,0,1,10,2,13
20201016,16OCT2020:00:00:00,UFU DURAND,44,45,77,12,0,89,85,4,87,2,2,6,16,28,9,17,9,2,0,28,37,20,85
20201016,16OCT2020:00:00:00,UFU ELIZALDE,35,25,15,44,1,60,46,14,52,8,34,10,4,7,2,2,1,0,0,2,35,9,46
20201016,16OCT2020:00:00:00,UFU FERNANDEZ,23,23,33,13,0,46,46,0,46,0,0,1,12,14,8,7,1,3,0,4,32,10,46
20201016,16OCT2020:00:00:00,UFU FERRER,17,18,19,16,0,35,33,2,33,2,0,0,11,10,9,5,0,0,0,5,27,1,33
20201016,16OCT2020:00:00:00,UFU GRIERSON,10,5,9,6,0,15,13,2,13,2,0,2,2,3,5,1,2,0,0,3,8,2,13
20201016,16OCT2020:00:00:00,UFU GUTIERREZ,33,23,34,22,0,56,54,2,54,2,9,15,7,7,7,8,3,0,0,1,39,14,54
20201016,16OCT2020:00:00:00,UFU MUÑIZ,130,190,159,157,4,320,160,160,172,148,2,4,80,89,59,46,31,9,0,23,105,32,160
20201016,16OCT2020:00:00:00,UFU PENNA,6,8,7,7,0,14,14,0,14,0,0,0,3,0,5,1,5,0,0,5,6,3,14
20201016,16OCT2020:00:00:00,UFU PIROVANO,18,13,26,5,0,31,29,2,31,0,0,0,9,9,4,6,3,0,0,6,21,2,29
20201016,16OCT2020:00:00:00,UFU PIÑERO,27,26,28,23,2,53,51,2,53,0,1,3,7,13,12,9,6,2,0,22,27,2,51
20201016,16OCT2020:00:00:00,UFU RAMOS MEJIA,42,25,51,14,2,67,63,4,67,0,5,3,13,20,7,14,5,0,0,11,34,18,63
20201016,16OCT2020:00:00:00,UFU RIVADAVIA,48,52,49,46,5,100,92,8,96,4,0,1,29,36,14,7,10,3,0,18,56,14,92
20201016,16OCT2020:00:00:00,UFU SANTOJANNI,29,33,35,25,2,62,54,8,58,4,0,6,14,14,14,8,4,2,0,23,30,1,54
20201016,16OCT2020:00:00:00,UFU TORNU,47,37,56,26,2,84,76,8,78,6,3,2,27,22,12,14,3,1,0,11,51,14,76
20201016,16OCT2020:00:00:00,UFU VELEZ SARSFIELD,46,22,55,13,0,68,66,2,68,0,0,0,12,27,13,10,5,1,0,14,39,13,66
20201016,16OCT2020:00:00:00,UFU ZUBIZARRETA,8,15,10,13,0,23,17,6,19,4,0,0,8,4,5,4,2,0,0,5,10,2,17
20201017,17OCT2020:00:00:00,UFU ALVAREZ,50,27,59,18,0,77,71,6,71,6,1,10,20,13,13,14,2,4,0,16,20,35,71
20201017,17OCT2020:00:00:00,UFU BORDA-MOYANO,2,2,2,2,0,4,4,0,4,0,0,0,0,1,3,0,0,0,0,2,2,0,4
20201017,17OCT2020:00:00:00,UFU DURAND,31,27,44,14,0,58,54,4,54,4,3,1,13,19,8,8,2,4,0,23,27,4,54
20201017,17OCT2020:00:00:00,UFU ELIZALDE,21,10,8,23,0,31,29,2,31,0,23,1,1,4,2,0,0,0,0,0,23,6,29
20201017,17OCT2020:00:00:00,UFU FERNANDEZ,17,13,24,6,0,30,26,4,28,2,0,0,10,9,3,7,1,0,0,9,12,5,26
20201017,17OCT2020:00:00:00,UFU FERRER,34,31,37,28,0,65,61,4,61,4,0,3,19,14,14,9,5,1,0,12,40,9,61
20201017,17OCT2020:00:00:00,UFU GRIERSON,16,9,23,2,0,25,25,0,25,0,3,3,4,6,3,1,1,4,0,10,10,5,25
20201017,17OCT2020:00:00:00,UFU GUTIERREZ,32,10,20,22,0,42,34,8,38,4,10,8,7,11,1,4,1,0,0,0,25,8,34
20201017,17OCT2020:00:00:00,UFU MUÑIZ,111,77,91,95,2,188,96,92,106,82,6,1,38,58,29,24,23,9,0,21,64,10,96
20201017,17OCT2020:00:00:00,UFU PENNA,14,8,14,8,0,22,20,2,22,0,0,0,4,6,4,4,3,1,0,4,13,3,20
20201017,17OCT2020:00:00:00,UFU PIROVANO,22,19,26,13,2,41,37,4,39,2,3,3,10,13,5,5,0,2,0,9,17,11,37
20201017,17OCT2020:00:00:00,UFU PIÑERO,28,25,37,16,0,53,47,6,49,4,0,3,13,19,9,4,4,1,0,14,24,8,47
20201017,17OCT2020:00:00:00,UFU RAMOS MEJIA,13,11,24,0,0,24,22,2,22,2,0,1,7,7,4,2,2,1,0,10,9,3,22
20201017,17OCT2020:00:00:00,UFU RIVADAVIA,36,13,43,6,0,49,41,8,45,4,1,0,10,14,10,11,2,1,0,6,26,9,41
20201017,17OCT2020:00:00:00,UFU SANTOJANNI,36,15,35,16,0,51,51,0,51,0,1,3,13,8,9,8,7,2,0,15,33,3,51
20201017,17OCT2020:00:00:00,UFU TORNU,46,32,29,42,7,78,64,14,72,6,0,1,21,21,19,8,8,0,0,10,43,11,64
20201017,17OCT2020:00:00:00,UFU VELEZ SARSFIELD,17,18,24,11,0,35,33,2,35,0,0,0,11,8,5,3,6,2,0,9,19,5,33
20201017,17OCT2020:00:00:00,UFU ZUBIZARRETA,37,25,43,19,0,62,46,16,54,8,0,3,7,14,10,14,12,2,0,8,32,6,46
20201018,18OCT2020:00:00:00,UFU ALVAREZ,28,24,37,15,0,52,44,8,46,6,7,3,8,9,8,10,6,1,0,11,18,15,44
20201018,18OCT2020:00:00:00,UFU BORDA-MOYANO,1,0,0,1,0,1,1,0,1,0,0,0,1,0,0,0,0,0,0,0,1,0,1
20201018,18OCT2020:00:00:00,UFU DURAND,20,18,36,2,0,38,34,4,34,4,1,5,15,6,5,5,1,0,0,9,23,2,34
20201018,18OCT2020:00:00:00,UFU ELIZALDE,24,25,13,36,0,49,31,18,39,10,23,11,4,4,5,1,1,0,0,2,26,3,31
20201018,18OCT2020:00:00:00,UFU FERNANDEZ,18,8,19,7,0,26,16,10,26,0,0,0,9,6,8,1,0,2,0,6,7,3,16
20201018,18OCT2020:00:00:00,UFU FERRER,10,22,20,12,0,32,28,4,28,4,0,0,5,9,5,4,5,4,0,5,22,1,28
20201018,18OCT2020:00:00:00,UFU GRIERSON,1,4,3,2,0,5,2,3,4,1,0,0,2,2,0,1,0,0,0,0,2,0,2
20201018,18OCT2020:00:00:00,UFU GUTIERREZ,20,8,20,7,1,28,28,0,28,0,8,3,3,11,3,0,0,0,0,1,25,2,28
20201018,18OCT2020:00:00:00,UFU MUÑIZ,51,49,64,36,0,100,54,46,72,28,0,4,28,18,18,20,5,7,0,0,13,41,54
20201018,18OCT2020:00:00:00,UFU PENNA,10,8,16,2,0,18,16,2,16,2,0,4,8,2,2,2,0,0,0,2,1,13,16
20201018,18OCT2020:00:00:00,UFU PIROVANO,22,7,19,10,0,29,25,4,27,2,2,0,6,9,8,1,3,0,0,8,8,9,25
20201018,18OCT2020:00:00:00,UFU PIÑERO,20,18,24,13,1,38,32,6,32,6,2,2,10,11,7,4,0,2,0,5,25,1,32
20201018,18OCT2020:00:00:00,UFU RAMOS MEJIA,15,16,21,10,0,31,29,2,29,2,4,1,7,6,6,3,1,3,0,13,10,6,29
20201018,18OCT2020:00:00:00,UFU RIVADAVIA,13,12,20,5,0,25,23,2,23,2,0,0,2,12,6,1,2,2,0,2,15,5,23
20201018,18OCT2020:00:00:00,UFU SANTOJANNI,8,14,16,6,0,22,16,6,18,4,0,2,8,3,1,5,2,1,0,5,11,0,16
20201018,18OCT2020:00:00:00,UFU TORNU,18,11,9,17,3,29,23,6,29,0,0,3,8,9,3,0,2,4,0,4,12,7,23
20201018,18OCT2020:00:00:00,UFU VELEZ SARSFIELD,20,19,33,6,0,39,37,2,39,0,0,0,17,7,10,2,1,2,0,15,17,5,37
20201018,18OCT2020:00:00:00,UFU ZUBIZARRETA,18,16,19,10,5,34,20,14,30,4,3,4,12,3,2,10,0,0,0,7,7,6,20
20201019,19OCT2020:00:00:00,UFU ALVAREZ,39,42,58,21,2,81,71,10,71,10,3,5,8,24,14,9,8,10,0,14,45,12,71
20201019,19OCT2020:00:00:00,UFU ARGERICH,20,20,29,11,0,40,30,10,30,10,2,0,11,6,11,0,8,2,0,4,15,11,30
20201019,19OCT2020:00:00:00,UFU BORDA-MOYANO,2,1,2,1,0,3,3,0,3,0,0,0,1,0,1,0,1,0,0,1,2,0,3
20201019,19OCT2020:00:00:00,UFU DURAND,40,33,62,11,0,73,67,6,67,6,2,2,18,25,11,10,4,1,0,20,38,9,67
20201019,19OCT2020:00:00:00,UFU ELIZALDE,25,14,10,28,1,39,31,8,37,2,21,7,1,3,2,2,3,0,0,3,26,2,31
20201019,19OCT2020:00:00:00,UFU FERNANDEZ,41,29,51,15,4,70,64,6,70,0,0,2,21,15,15,6,8,3,0,17,33,14,64
20201019,19OCT2020:00:00:00,UFU FERRER,26,16,23,19,0,42,36,6,36,6,0,2,5,14,14,3,4,0,0,5,26,5,36
20201019,19OCT2020:00:00:00,UFU GRIERSON,19,25,20,24,0,44,42,2,42,2,0,2,12,12,6,9,1,2,0,15,24,3,42
20201019,19OCT2020:00:00:00,UFU GUTIERREZ,51,22,43,29,1,73,61,12,69,4,15,21,6,12,7,8,4,0,0,2,43,15,61
20201019,19OCT2020:00:00:00,UFU MUÑIZ,109,162,116,152,3,271,153,118,169,102,6,8,72,59,56,45,22,3,0,20,111,22,153
20201019,19OCT2020:00:00:00,UFU PENNA,11,12,15,8,0,23,21,2,21,2,0,0,4,6,3,9,1,0,0,4,11,6,21
20201019,19OCT2020:00:00:00,UFU PIROVANO,53,19,51,19,2,72,50,22,70,2,0,5,12,17,12,11,7,8,0,2,34,13,50
20201019,19OCT2020:00:00:00,UFU PIÑERO,27,20,32,9,6,47,45,2,47,0,0,0,11,12,9,10,5,0,0,9,29,6,45
20201019,19OCT2020:00:00:00,UFU RAMOS MEJIA,48,38,74,12,0,86,76,10,78,8,6,1,21,19,20,4,10,5,0,13,51,12,76
20201019,19OCT2020:00:00:00,UFU RIVADAVIA,28,43,37,23,11,71,67,4,67,4,0,0,11,21,27,7,4,1,0,7,46,14,67
20201019,19OCT2020:00:00:00,UFU SANTOJANNI,47,22,42,23,4,69,53,16,63,6,4,6,9,19,9,12,9,1,0,17,35,1,53
20201019,19OCT2020:00:00:00,UFU TORNU,38,37,51,24,0,75,57,18,61,14,5,3,12,22,11,15,6,1,0,19,26,12,57
20201019,19OCT2020:00:00:00,UFU VELEZ SARSFIELD,36,29,48,17,0,65,65,0,65,0,0,0,14,20,15,9,3,4,0,20,37,8,65
20201019,19OCT2020:00:00:00,UFU ZUBIZARRETA,18,19,23,14,0,37,23,14,35,2,0,0,11,5,9,7,2,3,0,5,16,2,23
20201020,20OCT2020:00:00:00,UFU ALVAREZ,77,44,89,32,0,121,113,8,113,8,3,7,27,33,24,18,9,0,0,19,30,63,113
20201020,20OCT2020:00:00:00,UFU ARGERICH,20,25,30,14,1,45,23,22,27,18,6,3,11,5,3,10,2,5,0,3,13,7,23
20201020,20OCT2020:00:00:00,UFU BORDA-MOYANO,43,9,35,14,3,52,52,0,52,0,0,1,9,14,10,9,5,4,0,2,33,16,52
20201020,20OCT2020:00:00:00,UFU DURAND,26,18,39,5,0,44,42,2,42,2,3,2,9,10,9,3,7,1,0,15,22,5,42
20201020,20OCT2020:00:00:00,UFU ELIZALDE,38,23,16,45,0,61,41,20,49,12,20,17,10,7,2,4,1,0,0,3,31,7,41
20201020,20OCT2020:00:00:00,UFU FERNANDEZ,26,24,38,10,2,50,48,2,50,0,0,0,17,14,6,7,6,0,0,6,34,8,48
20201020,20OCT2020:00:00:00,UFU FERRER,26,23,27,22,0,49,47,2,47,2,0,2,8,17,10,7,5,0,0,16,27,4,47
20201020,20OCT2020:00:00:00,UFU GRIERSON,27,19,25,21,0,46,44,2,44,2,0,1,13,9,12,5,3,3,0,11,31,2,44
20201020,20OCT2020:00:00:00,UFU GUTIERREZ,33,30,30,33,0,63,61,2,63,0,12,8,6,21,11,5,0,0,0,0,43,15,61
20201020,20OCT2020:00:00:00,UFU MUÑIZ,101,112,108,100,5,213,145,68,157,56,5,4,38,66,34,39,21,6,0,19,90,36,145
20201020,20OCT2020:00:00:00,UFU PENNA,10,7,10,7,0,17,17,0,17,0,0,0,1,5,5,3,2,1,0,2,14,1,17
20201020,20OCT2020:00:00:00,UFU PIROVANO,17,11,21,5,2,28,24,4,26,2,0,2,2,10,5,3,2,4,0,7,14,3,24
20201020,20OCT2020:00:00:00,UFU PIÑERO,51,26,38,26,13,77,55,22,63,14,1,7,15,16,18,12,8,0,0,5,35,13,55
20201020,20OCT2020:00:00:00,UFU RAMOS MEJIA,28,27,39,16,0,55,43,12,47,8,2,0,12,13,11,11,6,0,0,11,26,6,43
20201020,20OCT2020:00:00:00,UFU RIVADAVIA,37,32,39,23,7,69,69,0,69,0,0,0,18,16,18,11,4,2,0,14,39,16,69
20201020,20OCT2020:00:00:00,UFU SANTOJANNI,40,32,38,34,0,72,66,6,68,4,5,3,16,13,11,15,7,2,0,14,47,5,66
20201020,20OCT2020:00:00:00,UFU TORNU,32,35,42,25,0,67,65,2,65,2,1,1,13,24,17,8,2,1,0,10,34,20,65
20201020,20OCT2020:00:00:00,UFU VELEZ SARSFIELD,35,38,51,22,0,73,71,2,73,0,0,4,22,20,13,8,5,1,0,5,56,10,71
20201020,20OCT2020:00:00:00,UFU ZUBIZARRETA,6,13,13,6,0,19,15,4,15,4,0,0,3,8,2,3,0,3,0,1,14,0,15
20201021,21OCT2020:00:00:00,UFU ALVAREZ,76,77,113,39,1,153,145,8,145,8,6,7,30,38,27,26,14,5,0,11,54,80,145
20201021,21OCT2020:00:00:00,UFU ARGERICH,26,31,38,17,2,57,39,18,39,18,1,4,14,13,7,8,4,6,0,5,23,11,39
20201021,21OCT2020:00:00:00,UFU BORDA-MOYANO,14,16,8,22,0,30,30,0,30,0,0,2,2,10,9,5,2,0,0,0,1,29,30
20201021,21OCT2020:00:00:00,UFU DURAND,21,25,38,8,0,46,46,0,46,0,0,1,9,11,9,11,4,1,0,12,28,6,46
20201021,21OCT2020:00:00:00,UFU ELIZALDE,33,23,25,31,0,56,36,20,44,12,27,16,0,6,5,2,0,0,0,2,25,9,36
20201021,21OCT2020:00:00:00,UFU FERNANDEZ,22,19,36,5,0,41,35,6,41,0,0,1,9,12,6,7,2,4,0,7,22,6,35
20201021,21OCT2020:00:00:00,UFU FERRER,24,26,25,25,0,50,48,2,48,2,0,0,12,18,5,9,6,0,0,15,27,6,48
20201021,21OCT2020:00:00:00,UFU GRIERSON,18,19,26,11,0,37,37,0,37,0,1,2,10,13,5,4,2,0,0,5,25,6,37
20201021,21OCT2020:00:00:00,UFU GUTIERREZ,38,28,38,28,0,66,58,8,66,0,26,7,6,9,12,3,2,1,0,3,41,12,58
20201021,21OCT2020:00:00:00,UFU MUÑIZ,156,190,160,182,4,346,212,134,236,110,7,8,79,88,75,49,36,4,0,8,83,121,212
20201021,21OCT2020:00:00:00,UFU PENNA,14,17,18,13,0,31,29,2,29,2,0,1,6,3,10,7,4,0,0,5,14,10,29
20201021,21OCT2020:00:00:00,UFU PIROVANO,18,20,31,7,0,38,36,2,38,0,0,0,10,8,7,4,3,6,0,6,23,7,36
20201021,21OCT2020:00:00:00,UFU PIÑERO,30,22,29,21,2,52,48,4,48,4,0,1,10,13,11,8,6,3,0,9,32,7,48
20201021,21OCT2020:00:00:00,UFU RAMOS MEJIA,26,19,35,10,0,45,35,10,41,4,1,0,9,13,6,11,3,2,0,12,18,5,35
20201021,21OCT2020:00:00:00,UFU RIVADAVIA,36,43,42,34,3,79,77,2,77,2,0,0,31,19,10,6,8,5,0,10,44,21,77
20201021,21OCT2020:00:00:00,UFU SANTOJANNI,24,31,24,27,4,55,47,8,47,8,1,0,16,14,17,5,2,0,0,7,34,6,47
20201021,21OCT2020:00:00:00,UFU TORNU,38,19,41,15,1,57,53,4,53,4,2,2,18,11,10,10,4,0,0,9,31,10,53
20201021,21OCT2020:00:00:00,UFU VELEZ SARSFIELD,21,26,38,9,0,47,45,2,47,0,0,1,10,16,5,7,4,4,0,7,30,8,45
20201021,21OCT2020:00:00:00,UFU ZUBIZARRETA,13,17,19,11,0,30,28,2,30,0,0,1,9,8,8,1,1,2,0,6,22,0,28
20201022,22OCT2020:00:00:00,UFU ALVAREZ,38,47,55,26,4,85,77,8,79,6,3,1,32,12,13,15,7,2,0,16,38,23,77
20201022,22OCT2020:00:00:00,UFU ARGERICH,13,32,31,10,4,45,15,30,17,28,2,0,12,11,4,6,6,4,0,2,10,3,15
20201022,22OCT2020:00:00:00,UFU BORDA-MOYANO,11,2,8,5,0,13,11,2,11,2,0,0,2,3,2,3,0,3,0,0,10,1,11
20201022,22OCT2020:00:00:00,UFU DURAND,25,21,43,3,0,46,44,2,44,2,0,1,6,14,11,10,3,1,0,9,33,2,44
20201022,22OCT2020:00:00:00,UFU ELIZALDE,25,24,12,37,0,49,39,10,43,6,22,10,3,7,4,3,0,0,0,0,33,6,39
20201022,22OCT2020:00:00:00,UFU FERNANDEZ,39,35,57,15,2,74,58,16,74,0,0,2,23,20,12,10,6,1,0,12,35,11,58
20201022,22OCT2020:00:00:00,UFU FERRER,26,19,32,13,0,45,33,12,33,12,0,3,22,4,7,4,4,1,0,8,22,3,33
20201022,22OCT2020:00:00:00,UFU GRIERSON,23,15,29,9,0,38,38,0,38,0,1,2,10,12,5,7,1,0,0,6,29,3,38
20201022,22OCT2020:00:00:00,UFU GUTIERREZ,32,20,34,18,0,52,46,6,52,0,10,5,9,20,5,2,1,0,0,0,37,9,46
20201022,22OCT2020:00:00:00,UFU MUÑIZ,85,133,120,98,0,218,118,100,124,94,5,4,43,75,45,31,15,0,0,12,89,17,118
20201022,22OCT2020:00:00:00,UFU PENNA,5,8,3,10,0,13,13,0,13,0,0,0,2,6,2,2,1,0,0,2,9,2,13
20201022,22OCT2020:00:00:00,UFU PIROVANO,23,23,38,6,2,46,42,4,44,2,0,1,14,21,4,4,2,0,0,9,24,9,42
20201022,22OCT2020:00:00:00,UFU PIÑERO,17,17,22,12,0,34,32,2,32,2,0,0,5,12,5,5,2,5,0,8,19,5,32
20201022,22OCT2020:00:00:00,UFU RAMOS MEJIA,34,32,49,14,3,66,56,10,58,8,2,5,21,21,8,7,2,0,0,15,33,8,56
20201022,22OCT2020:00:00:00,UFU RIVADAVIA,15,19,21,10,3,34,32,2,32,2,0,0,6,12,7,3,6,0,0,4,22,6,32
20201022,22OCT2020:00:00:00,UFU SANTOJANNI,19,26,30,15,0,45,41,4,41,4,1,2,14,11,10,3,3,1,0,7,33,1,41
20201022,22OCT2020:00:00:00,UFU TORNU,31,36,45,19,3,67,51,16,51,16,0,3,17,12,17,12,4,2,0,10,30,11,51
20201022,22OCT2020:00:00:00,UFU VELEZ SARSFIELD,29,33,56,6,0,62,58,4,60,2,0,1,21,9,13,9,9,0,0,13,37,8,58
20201022,22OCT2020:00:00:00,UFU ZUBIZARRETA,4,6,6,4,0,10,4,6,6,4,0,0,2,1,2,1,2,2,0,1,2,1,4
20201023,23OCT2020:00:00:00,UFU ALVAREZ,53,43,71,25,0,96,86,10,86,10,2,6,28,15,18,16,10,1,0,7,34,45,86
20201023,23OCT2020:00:00:00,UFU ARGERICH,25,18,29,12,2,43,33,10,35,8,0,0,9,7,6,7,11,3,0,2,22,9,33
20201023,23OCT2020:00:00:00,UFU BORDA-MOYANO,10,5,11,4,0,15,15,0,15,0,0,0,3,7,4,1,0,0,0,1,11,3,15
20201023,23OCT2020:00:00:00,UFU DURAND,24,22,38,8,0,46,44,2,44,2,0,3,12,14,8,4,4,1,0,18,25,1,44
20201023,23OCT2020:00:00:00,UFU ELIZALDE,29,21,29,21,0,50,33,17,43,7,20,12,5,4,5,4,0,0,0,1,24,8,33
20201023,23OCT2020:00:00:00,UFU FERNANDEZ,6,2,6,2,0,8,8,0,8,0,0,0,2,2,3,0,1,0,0,0,6,2,8
20201023,23OCT2020:00:00:00,UFU FERRER,29,21,31,19,0,50,46,4,46,4,0,2,9,12,15,10,2,0,0,15,25,6,46
20201023,23OCT2020:00:00:00,UFU GRIERSON,27,17,21,23,0,44,44,0,44,0,0,1,14,11,3,7,7,1,0,8,31,5,44
20201023,23OCT2020:00:00:00,UFU GUTIERREZ,46,18,38,26,0,64,57,7,63,1,17,4,12,14,5,9,3,0,0,0,45,12,57
20201023,23OCT2020:00:00:00,UFU MUÑIZ,120,159,109,165,5,279,119,160,127,152,4,5,65,55,65,61,23,1,0,15,88,16,119
20201023,23OCT2020:00:00:00,UFU PIROVANO,26,20,39,7,0,46,40,6,46,0,4,0,10,13,11,2,1,5,0,11,22,7,40
20201023,23OCT2020:00:00:00,UFU PIÑERO,25,18,26,11,6,43,35,8,37,6,0,0,12,8,8,8,3,4,0,8,24,3,35
20201023,23OCT2020:00:00:00,UFU RAMOS MEJIA,30,18,39,8,1,48,44,4,46,2,2,1,18,6,6,9,4,2,0,4,31,9,44
20201023,23OCT2020:00:00:00,UFU RIVADAVIA,22,27,34,13,2,49,47,2,47,2,0,0,18,18,2,5,3,3,0,6,32,7,47
20201023,23OCT2020:00:00:00,UFU SANTOJANNI,30,23,32,21,0,53,47,6,51,2,3,0,11,6,15,13,1,4,0,6,37,4,47
20201023,23OCT2020:00:00:00,UFU TORNU,26,31,37,19,1,57,47,10,53,4,2,2,13,13,13,7,3,4,0,12,27,8,47
20201023,23OCT2020:00:00:00,UFU VELEZ SARSFIELD,36,26,47,15,0,62,62,0,62,0,0,1,12,13,10,8,11,7,0,12,34,16,62
20201023,23OCT2020:00:00:00,UFU ZUBIZARRETA,24,16,22,18,0,40,34,6,38,2,2,2,13,8,7,8,0,0,0,8,22,4,34
20201024,24OCT2020:00:00:00,UFU ALVAREZ,25,25,46,4,0,50,44,6,44,6,2,0,12,12,14,5,3,2,0,10,26,8,44
20201024,24OCT2020:00:00:00,UFU BORDA-MOYANO,15,5,8,12,0,20,20,0,20,0,0,1,8,5,2,2,0,2,0,0,15,5,20
20201024,24OCT2020:00:00:00,UFU DURAND,20,22,36,6,0,42,38,4,38,4,8,1,7,7,11,6,2,0,0,7,24,7,38
20201024,24OCT2020:00:00:00,UFU ELIZALDE,18,12,12,18,0,30,26,4,30,0,18,4,4,1,2,1,0,0,0,1,20,5,26
20201024,24OCT2020:00:00:00,UFU FERNANDEZ,27,16,31,12,0,43,37,6,39,4,0,0,9,15,10,2,2,5,0,8,25,4,37
20201024,24OCT2020:00:00:00,UFU FERRER,21,16,22,13,2,37,33,4,33,4,0,2,10,11,9,3,2,0,0,8,19,6,33
20201024,24OCT2020:00:00:00,UFU GRIERSON,27,27,30,22,2,54,44,10,54,0,7,4,15,7,6,7,3,5,0,15,28,1,44
20201024,24OCT2020:00:00:00,UFU GUTIERREZ,25,12,26,11,0,37,31,6,31,6,13,4,6,9,2,0,2,1,0,0,23,7,31
20201024,24OCT2020:00:00:00,UFU MUÑIZ,74,72,91,55,0,146,62,84,68,78,8,2,37,38,28,18,9,6,0,6,41,15,62
20201024,24OCT2020:00:00:00,UFU PENNA,4,6,4,6,0,10,10,0,10,0,0,0,1,2,2,3,1,1,0,3,7,0,10
20201024,24OCT2020:00:00:00,UFU PIROVANO,2,10,10,2,0,12,10,2,12,0,0,0,2,3,4,0,3,0,0,3,6,1,10
20201024,24OCT2020:00:00:00,UFU PIÑERO,14,16,12,16,2,30,24,6,26,4,0,2,4,8,4,9,3,0,0,8,10,6,24
20201024,24OCT2020:00:00:00,UFU RAMOS MEJIA,17,16,27,4,2,33,27,6,27,6,2,1,10,8,2,5,2,3,0,11,10,6,27
20201024,24OCT2020:00:00:00,UFU RIVADAVIA,27,24,34,16,1,51,45,6,45,6,0,1,8,11,19,8,4,0,0,7,28,10,45
20201024,24OCT2020:00:00:00,UFU SANTOJANNI,20,20,28,8,4,40,32,8,34,6,0,0,6,14,8,5,3,4,0,7,24,1,32
20201024,24OCT2020:00:00:00,UFU TORNU,26,21,19,28,0,47,47,0,47,0,1,1,14,9,9,8,4,1,0,17,25,5,47
20201024,24OCT2020:00:00:00,UFU VELEZ SARSFIELD,37,30,44,23,0,67,63,4,65,2,0,0,19,22,9,8,5,4,0,12,39,12,63
20201024,24OCT2020:00:00:00,UFU ZUBIZARRETA,25,21,30,16,0,46,26,20,38,8,4,0,7,10,9,8,1,7,0,5,18,3,26
20201025,25OCT2020:00:00:00,UFU ALVAREZ,32,40,55,15,2,72,62,10,62,10,7,7,12,10,15,14,4,3,0,18,37,7,62
20201025,25OCT2020:00:00:00,UFU BORDA-MOYANO,10,20,18,9,3,30,8,22,8,22,0,2,10,8,7,0,3,0,0,1,5,2,8
20201025,25OCT2020:00:00:00,UFU DURAND,18,13,26,5,0,31,31,0,31,0,0,3,10,5,6,6,1,0,0,2,25,4,31
20201025,25OCT2020:00:00:00,UFU ELIZALDE,23,16,19,20,0,39,23,16,37,2,21,6,0,6,5,1,0,0,0,1,21,1,23
20201025,25OCT2020:00:00:00,UFU FERNANDEZ,5,10,9,6,0,15,15,0,15,0,0,0,4,3,5,3,0,0,0,4,8,3,15
20201025,25OCT2020:00:00:00,UFU FERRER,9,9,12,6,0,18,18,0,18,0,0,0,5,7,4,1,0,1,0,9,7,2,18
20201025,25OCT2020:00:00:00,UFU GRIERSON,10,15,13,11,1,25,25,0,25,0,0,2,7,5,5,4,1,1,0,7,18,0,25
20201025,25OCT2020:00:00:00,UFU GUTIERREZ,16,14,15,15,0,30,24,6,24,6,9,5,3,7,2,4,0,0,0,3,19,2,24
20201025,25OCT2020:00:00:00,UFU MUÑIZ,46,50,45,51,0,96,54,42,66,30,0,0,19,21,18,23,10,5,0,14,37,3,54
20201025,25OCT2020:00:00:00,UFU PENNA,11,3,6,8,0,14,6,8,12,2,0,0,7,5,2,0,0,0,0,3,3,0,6
20201025,25OCT2020:00:00:00,UFU PIROVANO,6,5,8,1,2,11,9,2,9,2,0,0,5,0,1,2,3,0,0,2,5,2,9
20201025,25OCT2020:00:00:00,UFU PIÑERO,11,6,9,8,0,17,17,0,17,0,0,0,4,7,2,0,4,0,0,5,12,0,17
20201025,25OCT2020:00:00:00,UFU RAMOS MEJIA,9,8,11,5,1,17,15,2,15,2,2,0,6,3,2,1,1,2,0,5,8,2,15
20201025,25OCT2020:00:00:00,UFU RIVADAVIA,16,12,21,7,0,28,26,2,26,2,0,0,13,1,5,8,1,0,0,7,14,5,26
20201025,25OCT2020:00:00:00,UFU SANTOJANNI,18,17,23,12,0,35,27,8,29,6,2,0,11,9,5,5,3,0,0,5,21,1,27
20201025,25OCT2020:00:00:00,UFU TORNU,16,11,9,17,1,27,25,2,25,2,0,0,13,4,5,4,1,0,0,6,14,5,25
20200929,29SEP2020:00:00:00,UFU ZUBIZARRETA,12,21,18,11,4,33,17,16,25,8,1,4,2,10,8,5,3,0,0,7,10,0,17
20200930,30SEP2020:00:00:00,UFU ALVAREZ,5,5,7,3,0,10,10,0,10,0,0,0,3,5,1,0,1,0,0,3,5,2,10
20200930,30SEP2020:00:00:00,UFU ARGERICH,53,30,66,15,2,83,53,30,55,28,7,10,22,14,12,10,4,4,0,13,30,10,53
20200930,30SEP2020:00:00:00,UFU BORDA-MOYANO,36,13,47,2,0,49,45,4,45,4,0,0,4,3,5,15,7,15,0,15,23,7,45
20200930,30SEP2020:00:00:00,UFU DURAND,36,36,66,6,0,72,72,0,72,0,3,1,19,24,10,5,8,2,0,26,37,9,72
20200930,30SEP2020:00:00:00,UFU ELIZALDE,38,28,27,35,4,66,56,10,60,6,33,10,7,12,2,0,1,1,0,4,44,8,56
20200930,30SEP2020:00:00:00,UFU FERNANDEZ,19,30,29,19,1,49,49,0,49,0,0,3,10,23,5,5,1,2,0,12,23,14,49
20200930,30SEP2020:00:00:00,UFU FERRER,36,24,33,27,0,60,54,6,54,6,0,0,14,15,17,13,1,0,0,20,31,3,54
20200930,30SEP2020:00:00:00,UFU GRIERSON,27,27,28,26,0,54,52,2,52,2,3,0,6,12,15,10,4,4,0,20,30,2,52
20200930,30SEP2020:00:00:00,UFU GUTIERREZ,30,17,34,13,0,47,39,8,47,0,13,5,10,8,4,3,4,0,0,2,34,3,39
20200930,30SEP2020:00:00:00,UFU MUÑIZ,125,173,120,167,11,298,160,138,180,118,5,4,79,85,54,36,15,20,0,27,113,20,160
20200930,30SEP2020:00:00:00,UFU PENNA,14,13,23,4,0,27,25,2,25,2,0,0,6,6,5,2,7,1,0,7,17,1,25
20200930,30SEP2020:00:00:00,UFU PIROVANO,31,23,34,18,2,54,50,4,52,2,0,2,5,20,7,10,8,2,0,7,29,12,50
20200930,30SEP2020:00:00:00,UFU PIÑERO,51,33,38,26,20,84,72,12,74,10,0,1,23,17,19,13,7,4,0,19,46,7,72
20200930,30SEP2020:00:00:00,UFU RAMOS MEJIA,47,44,49,41,1,91,85,6,85,6,15,5,24,24,8,10,3,2,0,21,50,14,85
20200930,30SEP2020:00:00:00,UFU RIVADAVIA,34,47,44,32,5,81,71,10,73,8,0,0,20,20,13,12,9,7,0,15,44,12,71
20200930,30SEP2020:00:00:00,UFU SANTOJANNI,41,40,36,43,2,81,57,24,71,10,8,3,19,15,13,11,6,6,0,16,38,3,57
20200930,30SEP2020:00:00:00,UFU TORNU,50,45,64,29,2,95,81,14,81,14,5,1,27,25,19,8,6,4,0,12,52,17,81
20200930,30SEP2020:00:00:00,UFU VELEZ SARSFIELD,24,16,24,16,0,40,38,2,38,2,0,1,5,9,6,13,5,1,0,7,19,12,38
20200930,30SEP2020:00:00:00,UFU ZUBIZARRETA,29,11,20,20,0,40,28,12,32,8,0,0,13,4,9,8,5,1,0,8,19,1,28
20201001,01OCT2020:00:00:00,UFU ALVAREZ,4,3,6,1,0,7,7,0,7,0,0,1,3,1,2,0,0,0,0,4,2,1,7
20201001,01OCT2020:00:00:00,UFU ARGERICH,19,15,24,10,0,34,32,2,32,2,1,0,14,8,4,5,2,0,0,12,16,4,32
20201001,01OCT2020:00:00:00,UFU BORDA-MOYANO,32,8,17,23,0,40,38,2,38,2,0,1,5,10,12,3,5,4,0,5,19,14,38
20201001,01OCT2020:00:00:00,UFU DURAND,29,27,47,9,0,56,54,2,54,2,2,2,15,12,16,5,1,3,0,22,30,2,54
20201001,01OCT2020:00:00:00,UFU ELIZALDE,39,20,18,40,1,59,43,16,51,8,28,8,4,12,5,2,0,0,0,3,31,9,43
20201001,01OCT2020:00:00:00,UFU FERNANDEZ,37,18,39,14,2,55,49,6,55,0,0,1,17,18,8,6,2,3,0,13,28,8,49
20201001,01OCT2020:00:00:00,UFU FERRER,27,16,28,14,1,43,39,4,41,2,0,0,14,11,10,4,4,0,0,10,24,5,39
20201001,01OCT2020:00:00:00,UFU GRIERSON,26,29,29,26,0,55,55,0,55,0,4,2,11,12,11,9,6,0,0,19,34,2,55
20201001,01OCT2020:00:00:00,UFU GUTIERREZ,44,15,37,22,0,59,47,12,59,0,14,19,5,10,5,4,2,0,0,1,36,9,47
20201001,01OCT2020:00:00:00,UFU MUÑIZ,192,232,113,283,28,424,258,166,276,148,14,10,165,102,45,46,27,15,0,38,176,44,258
20201001,01OCT2020:00:00:00,UFU PENNA,13,8,18,3,0,21,11,10,17,4,0,3,6,3,4,5,0,0,0,4,3,4,11
20201001,01OCT2020:00:00:00,UFU PIROVANO,50,19,41,28,0,69,67,2,67,2,1,1,14,19,13,18,3,0,0,9,46,12,67
20201001,01OCT2020:00:00:00,UFU PIÑERO,48,34,58,18,6,82,64,18,74,8,3,1,23,20,11,9,7,8,0,15,44,5,64
20201001,01OCT2020:00:00:00,UFU RAMOS MEJIA,76,66,96,44,2,142,122,20,134,8,11,2,38,20,24,19,20,8,0,31,61,30,122
20201001,01OCT2020:00:00:00,UFU RIVADAVIA,37,27,27,27,10,64,58,6,60,4,0,0,13,14,15,16,5,1,0,9,35,13,58
20201001,01OCT2020:00:00:00,UFU SANTOJANNI,47,34,37,43,1,81,69,12,81,0,4,3,19,28,19,5,3,0,0,23,43,3,69
20201001,01OCT2020:00:00:00,UFU TORNU,39,37,48,26,2,76,60,16,60,16,9,6,14,20,10,11,2,4,0,13,35,12,60
20201001,01OCT2020:00:00:00,UFU VELEZ SARSFIELD,36,32,34,34,0,68,62,6,64,4,0,5,18,13,14,17,0,1,0,13,32,17,62
20201001,01OCT2020:00:00:00,UFU ZUBIZARRETA,29,12,26,15,0,41,31,10,33,8,1,3,9,10,6,8,2,2,0,6,21,4,31
20201002,02OCT2020:00:00:00,UFU ALVAREZ,9,3,11,1,0,12,12,0,12,0,2,1,4,2,3,0,0,0,0,5,6,1,12
20201002,02OCT2020:00:00:00,UFU ARGERICH,29,19,18,30,0,48,36,12,38,10,0,3,4,13,5,5,13,5,0,11,17,8,36
20201002,02OCT2020:00:00:00,UFU BORDA-MOYANO,11,10,12,8,1,21,17,4,17,4,0,0,0,4,6,5,4,2,0,2,12,3,17
20201002,02OCT2020:00:00:00,UFU DURAND,36,31,54,13,0,67,65,2,65,2,1,5,18,21,12,8,2,0,0,24,28,13,65
20201002,02OCT2020:00:00:00,UFU ELIZALDE,22,19,20,21,0,41,27,14,39,2,28,7,3,0,1,2,0,0,0,3,16,8,27
20201002,02OCT2020:00:00:00,UFU FERNANDEZ,28,24,37,15,0,52,48,4,48,4,0,1,14,19,9,2,4,3,0,13,25,10,48
20201002,02OCT2020:00:00:00,UFU FERRER,25,21,26,20,0,46,40,6,40,6,0,0,6,23,6,10,1,0,0,15,18,7,40
20201002,02OCT2020:00:00:00,UFU GRIERSON,20,19,17,22,0,39,39,0,39,0,1,2,12,8,7,6,1,2,0,15,22,2,39
20201002,02OCT2020:00:00:00,UFU GUTIERREZ,28,13,33,8,0,41,29,12,37,4,11,5,8,12,0,4,1,0,0,0,21,5,29
20201002,02OCT2020:00:00:00,UFU MUÑIZ,207,250,189,244,24,457,189,268,199,258,22,11,159,106,51,56,38,14,0,35,126,28,189
20201002,02OCT2020:00:00:00,UFU PENNA,16,13,24,5,0,29,27,2,27,2,0,4,3,7,3,8,2,2,0,5,19,3,27
20201002,02OCT2020:00:00:00,UFU PIROVANO,31,24,38,17,0,55,53,2,55,0,0,2,11,21,13,1,6,1,0,10,32,11,53
20201002,02OCT2020:00:00:00,UFU PIÑERO,29,51,37,13,30,80,68,12,78,2,2,0,18,21,14,17,4,4,0,5,42,21,68
20201002,02OCT2020:00:00:00,UFU RAMOS MEJIA,39,39,55,23,0,78,58,20,62,16,2,2,25,23,9,8,7,2,0,27,23,8,58
20201002,02OCT2020:00:00:00,UFU RIVADAVIA,31,34,48,12,5,65,59,6,61,4,0,2,22,21,10,7,3,0,0,7,35,15,59
20201002,02OCT2020:00:00:00,UFU SANTOJANNI,26,35,30,27,4,61,55,6,57,4,0,4,10,14,13,10,7,3,0,19,34,2,55
20201002,02OCT2020:00:00:00,UFU TORNU,57,44,74,27,0,101,95,6,95,6,2,3,19,32,22,16,7,0,0,20,45,30,95
20201002,02OCT2020:00:00:00,UFU VELEZ SARSFIELD,22,27,41,8,0,49,49,0,49,0,0,0,8,16,12,7,1,5,0,9,32,8,49
20201002,02OCT2020:00:00:00,UFU ZUBIZARRETA,21,19,20,17,3,40,30,10,36,4,5,3,10,12,4,0,3,3,0,2,25,3,30
20201003,03OCT2020:00:00:00,UFU ALVAREZ,3,5,7,1,0,8,8,0,8,0,0,2,1,1,0,4,0,0,0,0,4,4,8
20201003,03OCT2020:00:00:00,UFU BORDA-MOYANO,7,3,7,3,0,10,10,0,10,0,0,1,1,2,3,3,0,0,0,1,8,1,10
20201003,03OCT2020:00:00:00,UFU DURAND,41,38,66,13,0,79,3,76,3,76,0,3,11,25,15,14,9,2,0,1,2,0,3
20201003,03OCT2020:00:00:00,UFU ELIZALDE,20,8,6,22,0,28,24,4,28,0,15,3,3,3,1,1,1,1,0,0,21,3,24
20201003,03OCT2020:00:00:00,UFU FERNANDEZ,14,15,21,8,0,29,23,6,23,6,0,2,2,9,10,3,2,1,0,8,10,5,23
20201003,03OCT2020:00:00:00,UFU FERRER,9,13,9,13,0,22,22,0,22,0,0,0,7,4,6,5,0,0,0,6,14,2,22
20201003,03OCT2020:00:00:00,UFU GRIERSON,23,15,30,8,0,38,34,4,38,0,0,0,14,7,5,6,5,1,0,9,24,1,34
20201003,03OCT2020:00:00:00,UFU GUTIERREZ,21,18,24,15,0,39,31,8,37,2,8,5,5,10,8,0,3,0,0,2,24,3,31
20201003,03OCT2020:00:00:00,UFU MUÑIZ,111,123,100,122,12,234,76,158,84,150,9,0,101,51,23,30,14,6,0,13,61,2,76
20201003,03OCT2020:00:00:00,UFU PENNA,11,6,8,9,0,17,15,2,17,0,0,1,7,4,2,2,1,0,0,1,10,4,15
20201003,03OCT2020:00:00:00,UFU PIROVANO,19,18,28,7,2,37,33,4,35,2,0,1,12,10,10,3,1,0,0,6,20,7,33
20201003,03OCT2020:00:00:00,UFU PIÑERO,9,11,10,10,0,20,20,0,20,0,1,1,6,3,3,4,0,2,0,9,8,3,20
20201003,03OCT2020:00:00:00,UFU RAMOS MEJIA,21,24,24,21,0,45,41,4,41,4,0,1,18,11,3,9,2,1,0,11,16,14,41
20201003,03OCT2020:00:00:00,UFU RIVADAVIA,21,14,27,6,2,35,33,2,33,2,0,0,6,5,5,14,3,2,0,7,21,5,33
20201003,03OCT2020:00:00:00,UFU SANTOJANNI,28,23,18,33,0,51,41,10,51,0,2,5,8,14,7,9,6,0,0,9,30,2,41
20201003,03OCT2020:00:00:00,UFU TORNU,20,18,17,17,4,38,36,2,36,2,0,0,14,14,5,5,0,0,0,7,15,14,36
20201003,03OCT2020:00:00:00,UFU VELEZ SARSFIELD,28,38,41,25,0,66,60,6,66,0,0,3,12,16,15,7,11,2,0,7,35,18,60
20201003,03OCT2020:00:00:00,UFU ZUBIZARRETA,15,11,19,7,0,26,18,8,26,0,1,2,4,6,8,5,0,0,0,4,11,3,18
20201004,04OCT2020:00:00:00,UFU ALVAREZ,3,4,6,1,0,7,5,2,5,2,0,0,1,0,5,0,1,0,0,1,3,1,5
20201004,04OCT2020:00:00:00,UFU BORDA-MOYANO,0,2,2,0,0,2,2,0,2,0,0,0,0,2,0,0,0,0,0,0,0,2,2
20201004,04OCT2020:00:00:00,UFU DURAND,35,27,48,14,0,62,60,2,60,2,1,1,14,17,16,8,4,1,0,18,31,11,60
20201004,04OCT2020:00:00:00,UFU ELIZALDE,15,11,4,22,0,26,26,0,26,0,14,3,4,5,0,0,0,0,0,2,20,4,26
20201004,04OCT2020:00:00:00,UFU FERNANDEZ,7,11,13,5,0,18,16,2,16,2,0,0,6,6,1,4,0,1,0,8,5,3,16
20201004,04OCT2020:00:00:00,UFU FERRER,28,8,22,14,0,36,32,4,32,4,0,0,11,10,4,7,4,0,0,6,25,1,32
20201004,04OCT2020:00:00:00,UFU GRIERSON,8,9,11,6,0,17,17,0,17,0,2,0,5,4,1,1,1,3,0,2,15,0,17
20201004,04OCT2020:00:00:00,UFU GUTIERREZ,22,8,17,13,0,30,26,4,26,4,11,3,7,7,1,1,0,0,0,2,18,5,26
20201004,04OCT2020:00:00:00,UFU MUÑIZ,61,88,65,80,4,149,49,100,73,76,8,1,55,53,15,8,6,3,0,12,30,7,49
20201004,04OCT2020:00:00:00,UFU PENNA,10,9,14,5,0,19,11,8,19,0,0,1,2,5,9,0,2,0,0,0,8,3,11
20201004,04OCT2020:00:00:00,UFU PIROVANO,8,10,14,4,0,18,18,0,18,0,0,0,9,4,3,0,2,0,0,3,11,4,18
20201004,04OCT2020:00:00:00,UFU PIÑERO,34,27,45,14,2,61,53,8,53,8,2,5,19,4,10,12,3,6,0,3,41,9,53
20201004,04OCT2020:00:00:00,UFU RAMOS MEJIA,18,31,35,14,0,49,47,2,47,2,4,0,12,12,10,10,1,0,0,9,21,17,47
20201004,04OCT2020:00:00:00,UFU RIVADAVIA,9,16,21,2,2,25,23,2,23,2,0,0,1,10,8,3,2,1,0,5,13,5,23
20201004,04OCT2020:00:00:00,UFU SANTOJANNI,12,14,15,11,0,26,26,0,26,0,0,2,8,3,9,4,0,0,0,9,15,2,26
20201004,04OCT2020:00:00:00,UFU TORNU,14,18,21,9,2,32,28,4,30,2,0,0,8,9,4,7,2,2,0,4,19,5,28
20201004,04OCT2020:00:00:00,UFU VELEZ SARSFIELD,22,13,30,5,0,35,31,4,31,4,0,0,12,3,3,11,3,3,0,2,27,2,31
20201004,04OCT2020:00:00:00,UFU ZUBIZARRETA,16,10,19,7,0,26,20,6,20,6,1,6,6,3,3,6,0,1,0,7,9,4,20
20201005,05OCT2020:00:00:00,UFU ALVAREZ,18,22,23,17,0,40,34,6,38,2,1,4,12,9,12,2,0,0,0,8,11,15,34
20201005,05OCT2020:00:00:00,UFU ARGERICH,38,23,34,27,0,61,49,12,49,12,3,5,8,12,17,10,6,0,0,12,24,13,49
20201005,05OCT2020:00:00:00,UFU BORDA-MOYANO,42,19,42,15,4,61,57,4,57,4,0,0,20,7,8,13,9,4,0,9,34,14,57
20201005,05OCT2020:00:00:00,UFU DURAND,25,32,49,8,0,57,55,2,57,0,1,1,12,18,14,4,3,4,0,23,26,6,55
20201005,05OCT2020:00:00:00,UFU ELIZALDE,22,18,8,32,0,40,28,12,36,4,16,13,4,4,1,1,1,0,0,0,27,1,28
20201005,05OCT2020:00:00:00,UFU FERNANDEZ,28,41,51,15,3,69,65,4,69,0,0,2,17,21,15,11,3,0,0,23,33,9,65
20201005,05OCT2020:00:00:00,UFU FERRER,24,24,27,21,0,48,46,2,46,2,0,4,16,14,5,4,3,2,0,12,27,7,46
20201005,05OCT2020:00:00:00,UFU GRIERSON,29,20,28,21,0,49,49,0,49,0,2,3,10,10,14,6,4,0,0,22,26,1,49
20201005,05OCT2020:00:00:00,UFU GUTIERREZ,63,12,39,36,0,75,65,10,75,0,12,13,19,12,8,5,5,1,0,7,42,15,65
20201005,05OCT2020:00:00:00,UFU MUÑIZ,132,156,123,159,6,288,162,126,180,108,1,3,78,67,59,44,25,11,0,28,106,28,162
20201005,05OCT2020:00:00:00,UFU PENNA,20,11,21,8,2,31,23,8,27,4,0,0,7,5,12,4,3,0,0,9,9,5,23
20201005,05OCT2020:00:00:00,UFU PIROVANO,36,21,43,14,0,57,49,8,53,4,2,2,13,16,8,6,8,2,0,6,35,8,49
20201005,05OCT2020:00:00:00,UFU PIÑERO,28,35,33,17,13,63,55,8,57,6,3,2,15,18,9,11,4,1,0,12,30,13,55
20201005,05OCT2020:00:00:00,UFU RAMOS MEJIA,39,33,49,21,2,72,70,2,70,2,2,1,11,21,17,11,5,4,0,18,35,17,70
20201005,05OCT2020:00:00:00,UFU RIVADAVIA,37,37,33,40,1,74,62,12,66,8,0,0,17,25,14,14,4,0,0,15,36,11,62
20201005,05OCT2020:00:00:00,UFU SANTOJANNI,46,38,45,39,0,84,66,18,78,6,4,3,20,26,18,8,3,2,0,19,43,4,66
20201005,05OCT2020:00:00:00,UFU TORNU,21,29,32,16,2,50,46,4,46,4,2,3,14,14,8,7,1,1,0,11,27,7,46
20201005,05OCT2020:00:00:00,UFU VELEZ SARSFIELD,18,21,32,7,0,39,37,2,37,2,0,0,7,16,10,4,2,0,0,6,25,6,37
20201005,05OCT2020:00:00:00,UFU ZUBIZARRETA,22,8,19,9,2,30,18,12,26,4,0,5,2,10,6,3,2,2,0,4,12,2,18
20201006,06OCT2020:00:00:00,UFU ALVAREZ,16,6,14,8,0,22,20,2,20,2,0,0,12,3,4,3,0,0,0,1,9,10,20
20201006,06OCT2020:00:00:00,UFU ARGERICH,34,20,27,26,1,54,44,10,44,10,3,2,20,12,11,1,4,1,0,11,27,6,44
20201006,06OCT2020:00:00:00,UFU BORDA-MOYANO,4,5,5,4,0,9,9,0,9,0,0,0,1,3,2,1,2,0,0,0,8,1,9
20201006,06OCT2020:00:00:00,UFU DURAND,39,33,62,10,0,72,68,4,68,4,3,4,10,19,16,12,1,7,0,29,34,5,68
20201006,06OCT2020:00:00:00,UFU ELIZALDE,30,18,14,34,0,48,32,16,44,4,26,10,5,4,3,0,0,0,0,0,26,6,32
20201006,06OCT2020:00:00:00,UFU FERNANDEZ,27,34,42,19,0,61,45,16,57,4,0,0,9,22,11,13,6,0,0,11,21,13,45
20201006,06OCT2020:00:00:00,UFU FERRER,33,13,21,23,2,46,42,4,42,4,0,0,12,14,11,5,2,2,0,14,22,6,42
20201006,06OCT2020:00:00:00,UFU GRIERSON,20,32,29,23,0,52,50,2,50,2,2,0,16,21,9,3,0,1,0,7,39,4,50
20201006,06OCT2020:00:00:00,UFU GUTIERREZ,45,25,46,24,0,70,60,10,70,0,21,12,5,15,6,8,2,1,0,6,39,10,60
20201006,06OCT2020:00:00:00,UFU MUÑIZ,128,172,162,130,8,300,150,150,168,132,6,7,74,74,75,35,20,9,0,22,88,39,150
20201006,06OCT2020:00:00:00,UFU PENNA,15,11,21,5,0,26,20,6,20,6,0,0,10,5,4,3,2,2,0,2,13,5,20
20201006,06OCT2020:00:00:00,UFU PIROVANO,28,19,31,16,0,47,43,4,47,0,0,0,7,14,14,8,3,1,0,9,29,5,43
20201006,06OCT2020:00:00:00,UFU PIÑERO,32,39,35,17,19,71,61,10,67,4,2,1,14,18,18,10,4,4,0,21,37,3,61
20201006,06OCT2020:00:00:00,UFU RAMOS MEJIA,24,28,30,21,1,52,44,8,50,2,1,2,13,13,13,3,5,2,0,22,15,7,44
20201006,06OCT2020:00:00:00,UFU RIVADAVIA,36,32,46,19,3,68,66,2,66,2,0,0,20,16,16,8,5,3,0,19,36,10,66
20201006,06OCT2020:00:00:00,UFU SANTOJANNI,43,21,29,35,0,64,52,12,62,2,1,2,19,17,7,9,8,1,0,17,30,5,52
20201006,06OCT2020:00:00:00,UFU TORNU,34,40,59,11,4,74,66,8,66,8,0,4,19,19,13,6,10,3,0,15,35,16,66
20201006,06OCT2020:00:00:00,UFU VELEZ SARSFIELD,22,31,42,11,0,53,53,0,53,0,0,2,14,12,15,9,0,1,0,14,34,5,53
20201006,06OCT2020:00:00:00,UFU ZUBIZARRETA,12,21,11,19,3,33,27,6,29,4,2,0,5,6,6,7,5,2,0,6,18,3,27
20201007,07OCT2020:00:00:00,UFU ALVAREZ,14,17,25,6,0,31,27,4,27,4,3,0,11,14,1,2,0,0,0,11,9,7,27
20201007,07OCT2020:00:00:00,UFU ARGERICH,30,32,39,23,0,62,46,16,46,16,4,5,9,15,13,6,8,2,0,19,21,6,46
20201007,07OCT2020:00:00:00,UFU BORDA-MOYANO,21,6,15,12,0,27,27,0,27,0,0,0,2,2,5,5,11,2,0,0,24,3,27
20201007,07OCT2020:00:00:00,UFU DURAND,32,37,51,16,2,69,65,4,65,4,5,3,12,27,7,8,6,1,0,19,40,6,65
20201007,07OCT2020:00:00:00,UFU ELIZALDE,36,31,11,56,0,67,45,22,53,14,36,12,6,10,2,1,0,0,0,1,37,7,45
20201007,07OCT2020:00:00:00,UFU FERNANDEZ,33,26,49,10,0,59,49,10,57,2,0,2,12,16,6,16,7,0,0,8,27,14,49
20201007,07OCT2020:00:00:00,UFU FERRER,22,23,25,20,0,45,35,10,35,10,0,2,11,16,6,7,1,2,0,7,26,2,35
20201007,07OCT2020:00:00:00,UFU GRIERSON,28,26,33,20,1,54,52,2,52,2,3,4,12,13,10,9,2,1,0,13,36,3,52
20201007,07OCT2020:00:00:00,UFU GUTIERREZ,34,22,37,17,2,56,54,2,56,0,9,9,7,13,10,4,4,0,0,4,40,10,54
20201007,07OCT2020:00:00:00,UFU MUÑIZ,146,154,152,141,7,300,178,122,186,114,10,7,58,85,54,45,28,13,0,28,122,26,178
20201007,07OCT2020:00:00:00,UFU PENNA,20,16,26,10,0,36,36,0,36,0,0,2,6,10,9,3,3,3,0,11,19,6,36
20201007,07OCT2020:00:00:00,UFU PIROVANO,35,18,42,11,0,53,49,4,53,0,0,7,10,13,8,5,7,3,0,9,34,6,49
20201007,07OCT2020:00:00:00,UFU PIÑERO,18,35,31,10,12,53,37,16,45,8,0,3,8,6,12,14,5,5,0,13,20,4,37
20201007,07OCT2020:00:00:00,UFU RAMOS MEJIA,28,33,45,16,0,61,59,2,59,2,1,2,9,26,12,7,2,2,0,22,29,8,59
20201007,07OCT2020:00:00:00,UFU RIVADAVIA,53,36,52,36,1,89,77,12,83,6,0,3,20,26,16,10,11,3,0,20,39,17,77
20201007,07OCT2020:00:00:00,UFU SANTOJANNI,29,29,32,25,1,58,56,2,58,0,1,1,15,12,14,8,3,4,0,14,38,4,56
20201007,07OCT2020:00:00:00,UFU TORNU,44,46,75,15,0,90,84,6,84,6,2,6,26,21,15,15,3,2,0,16,41,27,84
20201007,07OCT2020:00:00:00,UFU VELEZ SARSFIELD,31,32,45,18,0,63,55,8,63,0,0,1,13,19,6,9,15,0,0,18,32,5,55
20201007,07OCT2020:00:00:00,UFU ZUBIZARRETA,19,9,20,8,0,28,22,6,24,4,0,0,12,5,3,6,1,1,0,11,9,2,22
20201008,08OCT2020:00:00:00,UFU ALVAREZ,63,28,66,21,4,91,57,34,59,32,5,6,18,29,15,11,5,2,0,14,32,11,57
20201008,08OCT2020:00:00:00,UFU ARGERICH,27,18,27,18,0,45,23,22,37,8,0,1,7,14,8,8,3,4,0,10,9,4,23
20201008,08OCT2020:00:00:00,UFU BORDA-MOYANO,13,7,15,5,0,20,18,2,18,2,0,0,2,4,5,4,5,0,0,1,12,5,18
20201008,08OCT2020:00:00:00,UFU DURAND,40,48,72,16,0,88,84,4,84,4,7,5,16,24,11,10,12,3,0,25,45,14,84
20201008,08OCT2020:00:00:00,UFU ELIZALDE,29,25,15,37,2,54,44,10,50,4,20,15,1,7,6,5,0,0,0,4,28,12,44
20201008,08OCT2020:00:00:00,UFU FERNANDEZ,34,24,45,13,0,58,48,10,58,0,0,0,9,23,8,7,10,1,0,9,24,15,48
20201008,08OCT2020:00:00:00,UFU FERRER,30,19,26,21,2,49,39,10,39,10,0,1,17,9,13,7,1,1,0,7,25,7,39
20201008,08OCT2020:00:00:00,UFU GRIERSON,16,16,16,16,0,32,30,2,30,2,0,1,9,11,4,2,4,1,0,6,21,3,30
20201008,08OCT2020:00:00:00,UFU GUTIERREZ,44,18,44,17,1,62,60,2,60,2,17,8,8,12,11,1,4,1,0,0,52,8,60
20201008,08OCT2020:00:00:00,UFU MUÑIZ,136,162,156,130,12,298,164,134,174,124,9,15,54,94,48,44,29,5,0,21,96,47,164
20201008,08OCT2020:00:00:00,UFU PENNA,10,1,7,4,0,11,11,0,11,0,0,0,3,1,2,3,2,0,0,3,6,2,11
20201008,08OCT2020:00:00:00,UFU PIROVANO,33,30,51,10,2,63,51,12,59,4,2,2,15,20,10,11,3,0,0,10,30,11,51
20201008,08OCT2020:00:00:00,UFU PIÑERO,24,39,32,12,19,63,53,10,57,6,0,2,18,13,15,9,6,0,0,7,34,12,53
20201008,08OCT2020:00:00:00,UFU RAMOS MEJIA,27,31,46,10,2,58,56,2,56,2,3,1,15,12,15,8,3,1,0,29,13,14,56
20201008,08OCT2020:00:00:00,UFU RIVADAVIA,27,35,28,32,2,62,57,5,57,5,0,0,16,26,7,5,7,1,0,11,34,12,57
20201008,08OCT2020:00:00:00,UFU SANTOJANNI,27,27,35,19,0,54,52,2,54,0,0,0,11,17,6,12,7,1,0,23,29,0,52
20201008,08OCT2020:00:00:00,UFU TORNU,36,26,47,15,0,62,60,2,62,0,1,2,7,24,12,11,2,3,0,11,36,13,60
20201008,08OCT2020:00:00:00,UFU VELEZ SARSFIELD,43,28,50,21,0,71,71,0,71,0,0,0,11,21,12,9,6,12,0,15,42,14,71
20201008,08OCT2020:00:00:00,UFU ZUBIZARRETA,36,22,35,23,0,58,38,20,44,14,3,3,14,14,10,8,3,3,0,11,26,1,38
20201009,09OCT2020:00:00:00,UFU ALVAREZ,38,44,51,31,0,82,70,12,74,8,1,4,24,27,7,13,5,1,0,21,39,10,70
20201009,09OCT2020:00:00:00,UFU ARGERICH,27,11,24,13,1,38,32,6,34,4,0,1,10,7,7,7,6,0,0,9,17,6,32
20201009,09OCT2020:00:00:00,UFU BORDA-MOYANO,10,7,12,5,0,17,17,0,17,0,0,0,2,3,8,2,2,0,0,0,14,3,17
20201009,09OCT2020:00:00:00,UFU DURAND,41,35,61,15,0,76,70,6,70,6,2,0,11,29,12,15,4,3,0,25,32,13,70
20201009,09OCT2020:00:00:00,UFU ELIZALDE,26,26,11,41,0,52,33,19,37,15,23,10,0,8,3,1,6,1,0,0,30,3,33
20201009,09OCT2020:00:00:00,UFU FERNANDEZ,36,30,47,14,5,66,62,4,62,4,0,2,19,20,8,7,8,2,0,12,27,23,62
20201009,09OCT2020:00:00:00,UFU FERRER,20,22,32,10,0,42,36,6,36,6,0,1,10,12,9,5,2,3,0,11,17,8,36
20201009,09OCT2020:00:00:00,UFU GRIERSON,9,5,9,5,0,14,14,0,14,0,0,0,3,6,2,2,1,0,0,5,9,0,14
20201009,09OCT2020:00:00:00,UFU GUTIERREZ,33,18,32,19,0,51,45,6,49,2,8,7,7,16,8,4,1,0,0,4,31,9,45
20201009,09OCT2020:00:00:00,UFU MUÑIZ,104,146,130,109,11,250,112,138,126,124,3,8,54,67,50,37,22,9,0,16,83,13,112
20201009,09OCT2020:00:00:00,UFU PENNA,8,7,8,6,1,15,11,4,11,4,0,0,7,3,3,1,1,0,0,1,9,1,11
20201009,09OCT2020:00:00:00,UFU PIROVANO,27,21,35,13,0,48,44,4,46,2,5,1,8,16,8,5,3,2,0,2,35,7,44
20201009,09OCT2020:00:00:00,UFU PIÑERO,30,25,26,18,11,55,51,4,53,2,0,0,10,18,15,8,4,0,0,9,37,4,51
20201009,09OCT2020:00:00:00,UFU RAMOS MEJIA,19,19,26,12,0,38,34,4,36,2,1,0,7,13,5,3,8,1,0,13,14,7,34
20201009,09OCT2020:00:00:00,UFU RIVADAVIA,50,27,42,33,2,77,71,6,71,6,2,1,27,17,12,12,4,2,0,13,45,12,71
20201009,09OCT2020:00:00:00,UFU SANTOJANNI,41,30,39,32,0,71,61,10,63,8,1,3,22,23,10,8,4,0,0,15,42,4,61
20201009,09OCT2020:00:00:00,UFU TORNU,45,59,74,28,2,104,94,10,94,10,3,2,22,18,24,10,18,7,0,20,45,26,94
20201009,09OCT2020:00:00:00,UFU VELEZ SARSFIELD,31,25,42,14,0,56,54,2,54,2,0,0,13,8,9,16,7,3,0,14,29,11,54
20201009,09OCT2020:00:00:00,UFU ZUBIZARRETA,26,22,32,16,0,48,30,18,30,18,1,4,9,17,4,8,4,1,0,11,16,3,30
20201010,10OCT2020:00:00:00,UFU ALVAREZ,30,21,42,7,2,51,43,8,43,8,0,1,15,8,13,4,6,4,0,7,22,14,43
20201010,10OCT2020:00:00:00,UFU BORDA-MOYANO,0,9,9,0,0,9,9,0,9,0,0,0,1,6,0,0,2,0,0,0,6,3,9
20201010,10OCT2020:00:00:00,UFU DURAND,30,20,47,3,0,50,48,2,48,2,3,1,14,13,8,6,5,0,0,16,25,7,48
20201010,10OCT2020:00:00:00,UFU ELIZALDE,23,20,16,27,0,43,25,18,33,10,27,5,1,7,1,0,2,0,0,3,15,7,25
20201010,10OCT2020:00:00:00,UFU FERNANDEZ,12,13,17,8,0,25,25,0,25,0,0,0,5,7,5,6,2,0,0,10,12,3,25
20201010,10OCT2020:00:00:00,UFU FERRER,33,17,26,24,0,50,46,4,46,4,0,1,14,10,17,4,3,1,0,6,32,7,46
20201010,10OCT2020:00:00:00,UFU GRIERSON,13,21,13,21,0,34,34,0,34,0,0,2,10,10,3,6,3,0,0,9,22,3,34
20201010,10OCT2020:00:00:00,UFU GUTIERREZ,34,18,38,14,0,52,44,8,46,6,11,9,7,13,9,2,1,0,0,2,30,12,44
20201010,10OCT2020:00:00:00,UFU MUÑIZ,60,74,68,61,5,134,68,66,70,64,4,4,26,41,26,10,13,10,0,14,49,5,68
20201010,10OCT2020:00:00:00,UFU PENNA,9,3,6,6,0,12,12,0,12,0,0,0,1,7,2,1,1,0,0,3,6,3,12
20201010,10OCT2020:00:00:00,UFU PIROVANO,13,6,14,5,0,19,17,2,19,0,0,0,2,6,4,4,3,0,0,3,11,3,17
20201010,10OCT2020:00:00:00,UFU PIÑERO,10,25,20,12,3,35,31,4,35,0,0,0,9,10,6,6,1,3,0,8,14,9,31
20201010,10OCT2020:00:00:00,UFU RAMOS MEJIA,22,16,27,10,1,38,38,0,38,0,2,0,7,12,9,2,4,2,0,12,11,15,38
20201010,10OCT2020:00:00:00,UFU RIVADAVIA,18,25,35,8,0,43,39,4,43,0,0,0,7,18,1,10,6,1,0,3,26,9,39
20201010,10OCT2020:00:00:00,UFU SANTOJANNI,21,17,24,14,0,38,36,2,36,2,0,1,11,6,8,6,6,0,0,12,20,4,36
20201010,10OCT2020:00:00:00,UFU TORNU,31,25,32,21,3,56,52,4,52,4,4,5,12,12,13,5,3,2,0,18,22,12,52
20201010,10OCT2020:00:00:00,UFU VELEZ SARSFIELD,28,28,44,12,0,56,54,2,54,2,0,1,13,14,6,13,6,3,0,14,34,6,54
20201010,10OCT2020:00:00:00,UFU ZUBIZARRETA,23,12,20,14,1,35,23,12,31,4,1,0,2,10,12,4,4,2,0,11,12,0,23
20201011,11OCT2020:00:00:00,UFU ALVAREZ,23,29,46,6,0,52,46,6,46,6,6,2,8,9,6,10,4,7,0,4,3,39,46
20201011,11OCT2020:00:00:00,UFU BORDA-MOYANO,22,3,21,4,0,25,25,0,25,0,0,1,8,3,1,5,3,4,0,2,16,7,25
20201011,11OCT2020:00:00:00,UFU DURAND,13,19,32,0,0,32,32,0,32,0,1,0,12,12,2,2,2,1,0,14,16,2,32
20201011,11OCT2020:00:00:00,UFU ELIZALDE,19,24,13,30,0,43,19,24,43,0,36,3,1,1,2,0,0,0,0,0,17,2,19
20201011,11OCT2020:00:00:00,UFU FERNANDEZ,27,13,27,13,0,40,24,16,38,2,0,2,5,13,5,5,5,5,0,10,7,7,24
20201011,11OCT2020:00:00:00,UFU FERRER,13,14,18,9,0,27,27,0,27,0,0,0,9,15,1,2,0,0,0,6,17,4,27
20201011,11OCT2020:00:00:00,UFU GRIERSON,16,15,24,5,2,31,29,2,29,2,1,3,5,9,5,4,3,1,0,15,12,2,29
20201011,11OCT2020:00:00:00,UFU GUTIERREZ,26,7,19,14,0,33,33,0,33,0,9,3,5,7,7,1,1,0,0,3,24,6,33
20201011,11OCT2020:00:00:00,UFU MUÑIZ,41,60,52,49,0,101,49,52,61,40,2,3,17,41,15,15,6,2,0,8,25,16,49
20201011,11OCT2020:00:00:00,UFU PENNA,15,4,13,6,0,19,19,0,19,0,0,0,0,6,4,4,5,0,0,2,7,10,19
20201011,11OCT2020:00:00:00,UFU PIROVANO,17,13,25,3,2,30,22,8,28,2,1,1,11,7,5,3,0,2,0,7,11,4,22
20201011,11OCT2020:00:00:00,UFU PIÑERO,19,15,22,12,0,34,34,0,34,0,1,0,7,10,6,6,4,0,0,11,15,8,34
20201011,11OCT2020:00:00:00,UFU RAMOS MEJIA,13,15,18,9,1,28,26,2,26,2,3,1,6,8,2,0,7,1,0,10,14,2,26
20201011,11OCT2020:00:00:00,UFU RIVADAVIA,19,9,20,8,0,28,24,4,24,4,0,0,9,9,5,3,0,2,0,5,10,9,24
20201011,11OCT2020:00:00:00,UFU SANTOJANNI,26,17,19,22,2,43,37,6,41,2,2,1,8,12,4,11,3,2,0,13,23,1,37
20201011,11OCT2020:00:00:00,UFU TORNU,23,16,21,18,0,39,39,0,39,0,1,6,5,15,7,5,0,0,0,10,21,8,39
20201011,11OCT2020:00:00:00,UFU VELEZ SARSFIELD,21,14,22,12,1,35,29,6,33,2,0,0,9,9,4,4,4,5,0,7,18,4,29
20201011,11OCT2020:00:00:00,UFU ZUBIZARRETA,29,27,40,16,0,56,44,12,48,8,5,2,10,10,19,5,5,0,0,12,23,9,44
20201012,12OCT2020:00:00:00,UFU ALVAREZ,35,30,58,7,0,65,53,12,53,12,4,1,17,17,12,10,4,0,0,14,33,6,53
20201012,12OCT2020:00:00:00,UFU BORDA-MOYANO,4,8,7,3,2,12,12,0,12,0,0,1,2,3,2,4,0,0,0,1,9,2,12
20201012,12OCT2020:00:00:00,UFU DURAND,38,38,71,5,0,76,72,4,72,4,6,1,15,16,19,7,8,4,0,25,31,16,72
20201012,12OCT2020:00:00:00,UFU ELIZALDE,28,24,6,46,0,52,42,10,44,8,24,14,5,6,1,2,0,0,0,0,37,5,42
20201012,12OCT2020:00:00:00,UFU FERNANDEZ,22,18,33,7,0,40,38,2,40,0,0,0,3,15,10,3,3,6,0,7,25,6,38
20201012,12OCT2020:00:00:00,UFU FERRER,21,16,22,14,1,37,37,0,37,0,0,1,10,12,5,3,5,1,0,8,24,5,37
20201012,12OCT2020:00:00:00,UFU GRIERSON,26,23,23,24,2,49,21,28,21,28,1,1,16,13,6,3,7,2,0,8,13,0,21
20201012,12OCT2020:00:00:00,UFU GUTIERREZ,32,18,23,27,0,50,38,12,44,6,14,6,2,16,7,1,4,0,0,0,30,8,38
20201012,12OCT2020:00:00:00,UFU MUÑIZ,76,82,74,84,0,158,90,68,98,60,1,4,22,33,34,35,18,11,0,16,48,26,90
20201012,12OCT2020:00:00:00,UFU PENNA,21,9,17,11,2,30,22,8,22,8,0,0,5,10,5,1,5,4,0,3,13,6,22
20201012,12OCT2020:00:00:00,UFU PIROVANO,22,12,24,10,0,34,34,0,34,0,0,0,8,9,9,3,1,4,0,9,17,8,34
20201012,12OCT2020:00:00:00,UFU PIÑERO,21,15,26,10,0,36,34,2,34,2,2,0,13,7,5,7,2,0,0,11,18,5,34
20201012,12OCT2020:00:00:00,UFU RAMOS MEJIA,29,20,28,21,0,49,47,2,49,0,2,2,10,17,12,6,0,0,0,15,22,10,47
20201012,12OCT2020:00:00:00,UFU RIVADAVIA,42,34,60,14,2,76,70,6,74,2,0,1,24,20,12,11,6,2,0,14,33,21,70
20201012,12OCT2020:00:00:00,UFU SANTOJANNI,21,18,16,23,0,39,33,6,39,0,1,0,14,8,3,5,7,1,0,11,21,1,33
20201012,12OCT2020:00:00:00,UFU TORNU,44,27,27,42,2,71,63,8,63,8,7,2,12,19,12,8,8,3,0,20,22,20,63
20201012,12OCT2020:00:00:00,UFU VELEZ SARSFIELD,34,23,44,11,2,57,51,6,53,4,2,1,14,15,7,15,3,0,0,12,31,8,51
20201012,12OCT2020:00:00:00,UFU ZUBIZARRETA,36,26,43,14,5,62,50,12,52,10,6,6,17,10,3,10,9,1,0,19,24,7,50
20201013,13OCT2020:00:00:00,UFU ALVAREZ,38,48,59,25,2,86,82,4,82,4,4,2,19,22,18,13,6,2,0,17,41,24,82
20201013,13OCT2020:00:00:00,UFU ARGERICH,30,20,39,9,2,50,40,10,44,6,2,4,13,12,8,6,1,4,0,11,27,2,40
20201013,13OCT2020:00:00:00,UFU BORDA-MOYANO,10,18,11,15,2,28,16,12,16,12,0,4,0,4,10,9,0,1,0,2,12,2,16
20201013,13OCT2020:00:00:00,UFU DURAND,24,32,48,8,0,56,48,8,48,8,2,2,11,22,9,7,3,0,0,17,24,7,48
20201013,13OCT2020:00:00:00,UFU ELIZALDE,45,22,15,49,3,67,51,16,55,12,32,16,6,8,5,0,0,0,0,3,36,12,51
20201013,13OCT2020:00:00:00,UFU FERNANDEZ,35,24,44,15,0,59,37,22,59,0,0,3,9,15,10,14,5,3,0,15,14,8,37
20201013,13OCT2020:00:00:00,UFU FERRER,20,24,28,16,0,44,34,10,34,10,0,0,15,16,5,6,2,0,0,11,23,0,34
20201013,13OCT2020:00:00:00,UFU GRIERSON,18,21,20,19,0,39,39,0,39,0,0,2,15,12,3,1,4,2,0,17,20,2,39
20201013,13OCT2020:00:00:00,UFU GUTIERREZ,34,38,39,33,0,72,52,20,68,4,34,8,8,14,6,1,1,0,0,4,45,3,52
20201013,13OCT2020:00:00:00,UFU MUÑIZ,112,147,112,140,7,259,167,92,187,72,9,9,46,65,66,36,23,5,0,23,127,17,167
20201013,13OCT2020:00:00:00,UFU PENNA,16,10,15,11,0,26,26,0,26,0,0,2,4,6,7,3,3,1,0,9,14,3,26
20201013,13OCT2020:00:00:00,UFU PIROVANO,31,22,39,12,2,53,41,12,51,2,0,0,12,16,5,7,7,6,0,5,28,8,41
20201013,13OCT2020:00:00:00,UFU PIÑERO,28,38,28,21,17,66,56,10,60,6,2,3,20,20,10,8,2,1,0,15,34,7,56
20201013,13OCT2020:00:00:00,UFU RAMOS MEJIA,29,29,42,14,2,58,54,4,54,4,1,4,15,19,4,5,8,2,0,11,28,15,54
20201013,13OCT2020:00:00:00,UFU RIVADAVIA,37,33,31,23,16,70,66,4,66,4,0,0,24,21,11,11,2,1,0,18,30,17,66
20201013,13OCT2020:00:00:00,UFU SANTOJANNI,46,44,50,37,4,91,75,16,89,2,1,2,15,26,18,12,12,5,0,22,48,5,75
20201013,13OCT2020:00:00:00,UFU TORNU,46,51,67,30,0,97,93,4,93,4,4,1,19,32,15,16,7,3,0,18,29,45,93
20201013,13OCT2020:00:00:00,UFU VELEZ SARSFIELD,45,44,64,25,0,89,85,4,89,0,0,1,23,15,22,11,15,2,0,14,54,17,85
20201013,13OCT2020:00:00:00,UFU ZUBIZARRETA,34,24,46,12,0,58,30,28,34,24,4,3,17,18,7,4,2,3,0,5,22,3,30
20201014,14OCT2020:00:00:00,UFU ALVAREZ,44,36,53,23,4,80,76,4,76,4,1,3,16,26,9,15,3,7,0,9,44,23,76
20201014,14OCT2020:00:00:00,UFU ARGERICH,25,19,24,16,4,44,34,10,34,10,1,2,12,7,5,9,1,7,0,7,18,9,34
20201014,14OCT2020:00:00:00,UFU BORDA-MOYANO,37,11,35,12,1,48,48,0,48,0,0,0,2,8,8,8,8,14,0,7,31,10,48
20201014,14OCT2020:00:00:00,UFU DURAND,32,21,40,12,1,53,53,0,53,0,1,3,9,17,10,10,3,0,0,17,28,8,53
20201014,14OCT2020:00:00:00,UFU ELIZALDE,35,38,14,59,0,73,49,24,61,12,42,14,4,3,9,0,1,0,0,1,43,5,49
20201014,14OCT2020:00:00:00,UFU FERNANDEZ,16,32,34,14,0,48,46,2,46,2,0,1,22,12,6,7,0,0,0,15,23,8,46
20201014,14OCT2020:00:00:00,UFU FERRER,28,29,29,28,0,57,51,6,51,6,0,2,13,16,10,11,5,0,0,13,33,5,51
20201014,14OCT2020:00:00:00,UFU GRIERSON,14,17,22,9,0,31,31,0,31,0,0,1,12,8,6,1,1,2,0,7,24,0,31
20201014,14OCT2020:00:00:00,UFU GUTIERREZ,47,36,45,38,0,83,65,18,79,4,28,6,8,16,15,7,1,2,0,2,52,11,65
20201014,14OCT2020:00:00:00,UFU MUÑIZ,106,187,138,147,8,293,167,126,175,118,9,12,60,74,62,37,27,12,0,25,111,31,167
20201014,14OCT2020:00:00:00,UFU PENNA,18,9,21,6,0,27,23,4,23,4,0,0,9,7,6,0,5,0,0,5,13,5,23
20201014,14OCT2020:00:00:00,UFU PIROVANO,36,29,42,22,1,65,51,14,61,4,0,1,11,22,4,11,9,7,0,8,30,13,51
20201014,14OCT2020:00:00:00,UFU PIÑERO,43,34,44,14,19,77,63,14,71,6,3,4,15,20,17,10,6,2,0,17,38,8,63
20201014,14OCT2020:00:00:00,UFU RAMOS MEJIA,42,36,66,12,0,78,68,10,72,6,8,6,18,8,17,7,7,7,0,10,39,19,68
20201105,05NOV2020:00:00:00,UFU VELEZ SARSFIELD,16,19,23,12,0,35,35,0,35,0,0,0,8,11,6,6,1,3,0,4,26,5,35
20201105,05NOV2020:00:00:00,UFU ZUBIZARRETA,11,5,11,5,0,16,14,2,14,2,1,0,4,4,3,2,1,1,0,1,11,2,14
20201106,06NOV2020:00:00:00,UFU ALVAREZ,45,29,56,18,0,74,62,12,66,8,6,3,19,13,12,9,7,5,0,5,46,11,62
20201106,06NOV2020:00:00:00,UFU ARGERICH,20,30,37,13,0,50,28,22,28,22,0,2,11,21,6,6,3,1,0,3,22,3,28
20201106,06NOV2020:00:00:00,UFU BORDA-MOYANO,14,6,7,11,2,20,20,0,20,0,0,0,6,3,5,2,4,0,0,1,16,3,20
20201106,06NOV2020:00:00:00,UFU DURAND,29,22,42,8,1,51,49,2,49,2,2,0,16,5,13,8,7,0,0,14,28,7,49
20201106,06NOV2020:00:00:00,UFU ELIZALDE,30,21,12,39,0,51,24,27,46,5,39,6,1,2,3,0,0,0,0,1,21,2,24
20201106,06NOV2020:00:00:00,UFU FERNANDEZ,20,23,29,14,0,43,29,14,37,6,0,1,9,14,9,7,3,0,0,6,18,5,29
20201106,06NOV2020:00:00:00,UFU FERRER,25,21,29,15,2,46,40,6,40,6,1,0,15,11,12,5,1,1,0,7,29,4,40
20201106,06NOV2020:00:00:00,UFU GRIERSON,17,11,9,19,0,28,26,2,28,0,2,2,4,9,4,0,5,2,0,4,10,12,26
20201106,06NOV2020:00:00:00,UFU GUTIERREZ,49,44,71,22,0,93,85,8,89,4,12,5,21,40,10,3,0,2,0,0,62,22,85
20201106,06NOV2020:00:00:00,UFU MUÑIZ,135,171,137,159,10,306,138,168,148,158,14,10,76,74,57,51,20,4,0,13,104,21,138
20201106,06NOV2020:00:00:00,UFU PENNA,9,16,18,7,0,25,19,6,21,4,0,0,7,5,0,7,1,5,0,2,14,3,19
20201106,06NOV2020:00:00:00,UFU PIROVANO,28,28,37,19,0,56,56,0,56,0,2,3,17,10,8,10,3,3,0,4,41,11,56
20201106,06NOV2020:00:00:00,UFU PIÑERO,27,36,30,29,4,63,47,16,53,10,0,1,20,15,10,11,4,2,0,12,30,5,47
20201106,06NOV2020:00:00:00,UFU RAMOS MEJIA,47,34,59,22,0,81,79,2,79,2,4,1,16,22,10,17,5,6,0,22,47,10,79
20201106,06NOV2020:00:00:00,UFU RIVADAVIA,28,35,40,22,1,63,59,4,61,2,0,0,20,18,17,4,2,2,0,4,43,12,59
20201106,06NOV2020:00:00:00,UFU SANTOJANNI,42,33,31,40,4,75,61,14,65,10,6,0,23,19,9,14,4,0,0,4,55,2,61
20201106,06NOV2020:00:00:00,UFU TORNU,38,29,50,17,0,67,63,4,63,4,0,7,21,9,10,15,1,4,0,8,35,20,63
20201106,06NOV2020:00:00:00,UFU VELEZ SARSFIELD,34,19,41,12,0,53,45,8,53,0,0,0,11,8,14,8,8,4,0,8,30,7,45
20201107,07NOV2020:00:00:00,UFU ALVAREZ,52,38,83,7,0,90,82,8,82,8,2,11,13,19,22,11,9,3,0,10,45,27,82
20201107,07NOV2020:00:00:00,UFU BORDA-MOYANO,0,4,4,0,0,4,4,0,4,0,0,0,0,2,1,0,0,1,0,0,3,1,4
20201107,07NOV2020:00:00:00,UFU DURAND,20,21,33,8,0,41,41,0,41,0,3,2,5,8,12,5,5,1,0,11,24,6,41
20201107,07NOV2020:00:00:00,UFU ELIZALDE,19,18,17,20,0,37,33,4,37,0,20,7,3,6,1,0,0,0,0,0,26,7,33
20201107,07NOV2020:00:00:00,UFU FERNANDEZ,6,0,4,2,0,6,6,0,6,0,0,0,0,2,3,0,0,1,0,1,3,2,6
20201107,07NOV2020:00:00:00,UFU FERRER,22,17,24,15,0,39,35,4,37,2,0,0,9,13,8,6,1,2,0,10,17,8,35
20201107,07NOV2020:00:00:00,UFU GRIERSON,6,12,13,5,0,18,16,2,16,2,0,0,8,3,4,2,1,0,0,6,10,0,16
20201107,07NOV2020:00:00:00,UFU GUTIERREZ,35,20,26,29,0,55,51,4,51,4,13,10,15,9,3,0,5,0,0,2,37,11,51
20201107,07NOV2020:00:00:00,UFU MUÑIZ,91,115,117,84,5,206,90,116,98,108,12,7,61,54,30,21,15,6,0,10,72,8,90
20201107,07NOV2020:00:00:00,UFU PENNA,7,10,8,9,0,17,15,2,17,0,0,0,4,6,5,2,0,0,0,4,9,2,15
20201107,07NOV2020:00:00:00,UFU PIROVANO,10,5,11,4,0,15,11,4,13,2,0,2,2,5,3,2,1,0,0,3,7,1,11
20201107,07NOV2020:00:00:00,UFU PIÑERO,16,13,17,12,0,29,29,0,29,0,0,2,5,9,4,5,4,0,0,6,21,2,29
20201107,07NOV2020:00:00:00,UFU RAMOS MEJIA,15,7,14,7,1,22,20,2,20,2,0,0,9,2,5,4,1,1,0,3,15,2,20
20201107,07NOV2020:00:00:00,UFU RIVADAVIA,30,31,56,5,0,61,59,2,59,2,0,0,17,20,6,8,3,7,0,7,39,13,59
20201107,07NOV2020:00:00:00,UFU SANTOJANNI,16,20,17,19,0,36,32,4,34,2,0,1,4,18,9,2,2,0,0,2,28,2,32
20201107,07NOV2020:00:00:00,UFU TORNU,32,28,36,17,7,60,44,16,50,10,2,2,15,19,6,8,7,1,0,7,31,5,44
20201107,07NOV2020:00:00:00,UFU VELEZ SARSFIELD,20,26,34,12,0,46,40,6,46,0,0,2,6,13,6,7,7,5,0,3,29,8,40
20201107,07NOV2020:00:00:00,UFU ZUBIZARRETA,16,18,19,13,2,34,30,4,32,2,1,0,6,11,7,3,4,2,0,9,19,2,30
20201108,08NOV2020:00:00:00,UFU ALVAREZ,26,27,44,7,2,53,45,8,45,8,1,2,12,14,6,5,6,7,0,7,29,9,45
20201108,08NOV2020:00:00:00,UFU BORDA-MOYANO,24,3,19,8,0,27,27,0,27,0,0,2,3,12,3,5,2,0,0,0,19,8,27
20201108,08NOV2020:00:00:00,UFU DURAND,28,20,44,4,0,48,48,0,48,0,2,5,6,20,8,3,2,2,0,12,27,9,48
20201108,08NOV2020:00:00:00,UFU ELIZALDE,20,8,4,23,1,28,24,4,26,2,9,8,1,5,2,3,0,0,0,1,21,2,24
20201108,08NOV2020:00:00:00,UFU FERNANDEZ,5,8,10,3,0,13,9,4,13,0,0,0,4,3,3,2,1,0,0,2,5,2,9
20201108,08NOV2020:00:00:00,UFU FERRER,7,9,5,11,0,16,12,4,12,4,0,2,7,2,5,0,0,0,0,0,11,1,12
20201108,08NOV2020:00:00:00,UFU GRIERSON,4,18,18,4,0,22,22,0,22,0,0,0,3,3,7,7,2,0,0,9,12,1,22
20201108,08NOV2020:00:00:00,UFU GUTIERREZ,32,17,26,23,0,49,41,8,43,6,7,11,8,12,9,1,1,0,0,1,27,11,41
20201108,08NOV2020:00:00:00,UFU MUÑIZ,49,72,69,50,2,121,73,48,95,26,1,5,31,37,20,12,11,4,0,6,61,6,73
20201108,08NOV2020:00:00:00,UFU PENNA,8,3,8,3,0,11,11,0,11,0,0,0,3,3,2,3,0,0,0,3,4,4,11
20201108,08NOV2020:00:00:00,UFU PIROVANO,11,9,20,0,0,20,18,2,18,2,0,0,8,6,3,1,2,0,0,6,10,2,18
20201108,08NOV2020:00:00:00,UFU PIÑERO,13,19,21,9,2,32,28,4,28,4,1,1,6,5,7,9,1,2,0,9,13,6,28
20201108,08NOV2020:00:00:00,UFU RAMOS MEJIA,25,16,30,10,1,41,33,8,33,8,0,8,3,12,4,6,8,0,0,2,16,15,33
20201108,08NOV2020:00:00:00,UFU RIVADAVIA,27,17,24,20,0,44,42,2,42,2,0,0,18,7,9,6,3,1,0,10,25,7,42
20201108,08NOV2020:00:00:00,UFU SANTOJANNI,8,18,18,8,0,26,24,2,26,0,2,1,1,5,10,3,3,1,0,5,19,0,24
20201108,08NOV2020:00:00:00,UFU TORNU,23,24,27,17,3,47,41,6,45,2,4,4,13,9,8,6,2,1,0,4,25,12,41
20201108,08NOV2020:00:00:00,UFU VELEZ SARSFIELD,16,13,26,3,0,29,23,6,27,2,0,1,12,5,6,1,2,2,0,4,17,2,23
20201108,08NOV2020:00:00:00,UFU ZUBIZARRETA,18,15,21,12,0,33,29,4,29,4,0,1,6,4,8,7,2,5,0,8,16,5,29
20201109,09NOV2020:00:00:00,UFU ALVAREZ,61,53,87,27,0,114,98,16,102,12,7,1,24,38,16,11,7,10,0,8,39,51,98
20201109,09NOV2020:00:00:00,UFU ARGERICH,23,27,30,20,0,50,30,20,30,20,5,1,12,10,4,3,10,5,0,3,20,7,30
20201109,09NOV2020:00:00:00,UFU BORDA-MOYANO,11,5,11,5,0,16,12,4,12,4,0,1,2,3,1,2,2,5,0,2,6,4,12
20201109,09NOV2020:00:00:00,UFU DURAND,38,23,49,12,0,61,49,12,51,10,2,1,9,21,13,7,8,0,0,11,34,4,49
20201109,09NOV2020:00:00:00,UFU ELIZALDE,33,16,6,43,0,49,41,8,47,2,27,12,2,4,3,0,1,0,0,0,39,2,41
20201109,09NOV2020:00:00:00,UFU FERNANDEZ,27,17,30,14,0,44,38,6,42,2,0,2,12,4,14,3,6,3,0,10,21,7,38
20201109,09NOV2020:00:00:00,UFU FERRER,21,24,26,19,0,45,37,8,37,8,0,0,10,15,13,5,2,0,0,7,28,2,37
20201109,09NOV2020:00:00:00,UFU GRIERSON,22,29,21,29,1,51,49,2,49,2,0,3,12,12,15,8,1,0,0,14,32,3,49
20201109,09NOV2020:00:00:00,UFU GUTIERREZ,54,41,59,36,0,95,87,8,91,4,23,16,15,20,10,6,5,0,0,2,73,12,87
20201109,09NOV2020:00:00:00,UFU MUÑIZ,149,193,164,174,4,342,162,180,176,166,12,20,78,96,76,34,21,5,0,6,132,24,162
20201109,09NOV2020:00:00:00,UFU PENNA,18,6,21,3,0,24,22,2,22,2,0,0,5,10,1,7,1,0,0,5,14,3,22
20201109,09NOV2020:00:00:00,UFU PIROVANO,35,28,44,15,4,63,49,14,55,8,0,0,14,12,16,12,6,3,0,4,38,7,49
20201109,09NOV2020:00:00:00,UFU PIÑERO,30,38,31,35,2,68,68,0,68,0,0,0,10,20,10,16,5,7,0,16,40,11,68
20201109,09NOV2020:00:00:00,UFU RAMOS MEJIA,23,19,32,9,1,42,36,6,36,6,0,0,12,15,5,9,1,0,0,5,26,5,36
20201109,09NOV2020:00:00:00,UFU RIVADAVIA,66,62,81,33,14,128,74,54,74,54,0,0,49,20,19,25,7,8,0,8,49,17,74
20201109,09NOV2020:00:00:00,UFU SANTOJANNI,31,33,27,35,2,64,56,8,60,4,2,1,15,13,8,10,13,2,0,17,35,4,56
20201109,09NOV2020:00:00:00,UFU TORNU,31,8,30,9,0,39,37,2,37,2,1,1,9,7,6,6,4,5,0,4,24,9,37
20201109,09NOV2020:00:00:00,UFU VELEZ SARSFIELD,26,28,39,15,0,54,52,2,54,0,0,0,15,18,10,3,7,1,0,3,37,12,52
20201109,09NOV2020:00:00:00,UFU ZUBIZARRETA,32,28,36,24,0,60,56,4,56,4,2,8,12,7,11,10,6,4,0,9,39,8,56
20201110,10NOV2020:00:00:00,UFU ALVAREZ,42,39,57,23,1,81,75,6,75,6,6,3,16,28,19,6,2,1,0,7,33,35,75
20201110,10NOV2020:00:00:00,UFU ARGERICH,28,19,27,20,0,47,35,12,35,12,4,2,10,11,11,6,0,3,0,7,23,5,35
20201110,10NOV2020:00:00:00,UFU BORDA-MOYANO,5,2,7,0,0,7,7,0,7,0,0,0,2,5,0,0,0,0,0,1,4,2,7
20201110,10NOV2020:00:00:00,UFU DURAND,31,29,50,10,0,60,58,2,58,2,1,0,11,21,14,5,6,2,0,13,42,3,58
20201110,10NOV2020:00:00:00,UFU ELIZALDE,35,38,21,51,1,73,49,24,65,8,24,17,6,8,5,10,3,0,0,0,43,6,49
20201110,10NOV2020:00:00:00,UFU FERNANDEZ,28,15,32,9,2,43,39,4,43,0,0,1,10,22,4,5,1,0,0,3,29,7,39
20201110,10NOV2020:00:00:00,UFU FERRER,27,19,30,16,0,46,44,2,44,2,0,2,12,12,10,5,4,1,0,4,32,8,44
20201110,10NOV2020:00:00:00,UFU GRIERSON,16,16,11,21,0,32,32,0,32,0,1,0,10,8,9,3,1,0,0,4,12,16,32
20201110,10NOV2020:00:00:00,UFU GUTIERREZ,38,31,28,41,0,69,63,6,65,4,20,12,6,15,9,3,3,1,0,6,52,4,63
20201110,10NOV2020:00:00:00,UFU MUÑIZ,132,172,112,188,4,304,158,146,166,138,10,9,87,90,56,33,14,5,0,13,125,20,158
20201110,10NOV2020:00:00:00,UFU PENNA,7,14,13,8,0,21,19,2,21,0,0,0,5,1,1,3,8,3,0,1,12,6,19
20201110,10NOV2020:00:00:00,UFU PIROVANO,35,23,48,8,2,58,50,8,52,6,0,1,18,14,10,3,8,4,0,6,34,10,50
20201110,10NOV2020:00:00:00,UFU PIÑERO,29,29,29,27,2,58,54,4,54,4,1,1,15,16,12,7,6,0,0,9,31,13,54
20201110,10NOV2020:00:00:00,UFU RAMOS MEJIA,27,26,40,10,3,53,51,2,51,2,3,3,13,10,13,4,4,3,0,23,18,10,51
20201110,10NOV2020:00:00:00,UFU RIVADAVIA,22,33,30,23,2,55,47,8,49,6,1,0,12,20,10,7,5,0,0,7,34,6,47
20201110,10NOV2020:00:00:00,UFU SANTOJANNI,39,38,34,42,1,77,65,12,71,6,0,3,22,17,18,10,3,4,0,12,47,6,65
20201110,10NOV2020:00:00:00,UFU TORNU,28,53,49,32,0,81,69,12,71,10,2,2,30,12,18,10,7,0,0,16,38,15,69
20201110,10NOV2020:00:00:00,UFU VELEZ SARSFIELD,24,26,38,12,0,50,46,4,50,0,0,1,8,12,10,9,7,3,0,4,38,4,46
20201110,10NOV2020:00:00:00,UFU ZUBIZARRETA,20,7,13,11,3,27,19,8,19,8,4,0,2,9,10,1,0,1,0,5,14,0,19
20201111,11NOV2020:00:00:00,UFU ALVAREZ,40,44,67,16,1,84,70,14,72,12,8,2,25,16,10,14,0,9,0,14,41,15,70
20201111,11NOV2020:00:00:00,UFU BORDA-MOYANO,7,0,7,0,0,7,7,0,7,0,0,0,1,3,3,0,0,0,0,0,4,3,7
20201111,11NOV2020:00:00:00,UFU DURAND,18,20,27,11,0,38,36,2,38,0,6,0,9,11,5,4,2,1,0,8,20,8,36
20201111,11NOV2020:00:00:00,UFU ELIZALDE,25,28,13,40,0,53,43,10,51,2,26,12,4,6,1,4,0,0,0,2,36,5,43
20201111,11NOV2020:00:00:00,UFU FERNANDEZ,18,8,16,10,0,26,24,2,26,0,0,0,7,13,1,2,3,0,0,5,16,3,24
20201111,11NOV2020:00:00:00,UFU FERRER,22,31,36,17,0,53,51,2,51,2,2,6,9,16,6,7,5,2,0,6,35,10,51
20201111,11NOV2020:00:00:00,UFU GRIERSON,39,75,45,65,4,114,112,2,112,2,0,10,25,27,29,17,4,2,0,1,2,109,112
20201111,11NOV2020:00:00:00,UFU GUTIERREZ,37,26,34,29,0,63,57,6,57,6,15,17,7,7,13,0,3,1,0,2,42,12,57
20201111,11NOV2020:00:00:00,UFU MUÑIZ,102,152,104,148,2,254,104,150,118,136,11,15,79,78,27,24,19,1,0,10,84,10,104
20201111,11NOV2020:00:00:00,UFU PENNA,7,6,9,3,1,13,11,2,11,2,0,0,2,4,4,1,2,0,0,0,11,0,11
20201111,11NOV2020:00:00:00,UFU PIROVANO,23,13,17,19,0,36,36,0,36,0,1,0,12,6,4,6,5,2,0,4,28,4,36
20201111,11NOV2020:00:00:00,UFU PIÑERO,27,25,36,13,3,52,38,14,40,12,4,6,12,13,6,6,3,2,0,5,27,6,38
20201111,11NOV2020:00:00:00,UFU RAMOS MEJIA,31,23,42,12,0,54,40,14,48,6,2,2,7,10,13,7,6,7,0,8,21,11,40
20201111,11NOV2020:00:00:00,UFU RIVADAVIA,55,40,73,22,0,95,91,4,91,4,0,3,25,19,25,14,6,3,0,9,59,20,91
20201111,11NOV2020:00:00:00,UFU SANTOJANNI,30,33,27,34,2,63,55,8,59,4,2,2,18,15,15,4,7,0,0,10,41,4,55
20201111,11NOV2020:00:00:00,UFU TORNU,25,16,23,17,1,41,35,6,41,0,2,2,8,10,13,2,1,3,0,8,22,5,35
20201111,11NOV2020:00:00:00,UFU VELEZ SARSFIELD,32,48,56,24,0,80,76,4,76,4,0,1,20,15,20,12,8,4,0,10,46,20,76
20201111,11NOV2020:00:00:00,UFU ZUBIZARRETA,25,31,44,12,0,56,54,2,54,2,0,4,9,18,9,9,3,4,0,12,36,6,54
20201112,12NOV2020:00:00:00,UFU ALVAREZ,58,46,72,32,0,104,92,12,96,8,10,6,21,32,14,10,11,0,0,8,62,22,92
20201112,12NOV2020:00:00:00,UFU ARGERICH,30,19,35,14,0,49,37,12,37,12,0,0,19,12,6,5,4,3,0,7,24,6,37
20201112,12NOV2020:00:00:00,UFU BORDA-MOYANO,17,22,23,16,0,39,33,6,33,6,1,2,13,8,10,3,0,2,0,2,27,4,33
20201112,12NOV2020:00:00:00,UFU DURAND,32,18,37,13,0,50,46,4,46,4,1,1,12,14,13,5,2,2,0,6,32,8,46
20201112,12NOV2020:00:00:00,UFU ELIZALDE,31,26,22,35,0,57,41,16,55,2,41,6,1,2,5,1,1,0,0,1,32,8,41
20201112,12NOV2020:00:00:00,UFU FERNANDEZ,35,22,50,5,2,57,53,4,55,2,0,0,22,14,7,10,2,2,0,6,35,12,53
20201112,12NOV2020:00:00:00,UFU FERRER,29,17,21,25,0,46,42,4,42,4,0,1,7,19,8,6,3,2,0,4,35,3,42
20201112,12NOV2020:00:00:00,UFU GRIERSON,10,27,16,21,0,37,35,2,35,2,0,3,13,10,8,2,1,0,0,4,29,2,35
20201112,12NOV2020:00:00:00,UFU GUTIERREZ,45,41,56,30,0,86,80,6,84,2,6,7,16,21,14,10,5,7,0,4,55,21,80
20201112,12NOV2020:00:00:00,UFU MUÑIZ,119,165,147,131,6,284,150,134,160,124,4,13,69,67,56,37,28,10,0,14,121,14,150
20201112,12NOV2020:00:00:00,UFU PENNA,13,13,17,9,0,26,16,10,22,4,0,0,5,9,6,3,0,3,0,1,11,4,16
20201112,12NOV2020:00:00:00,UFU PIROVANO,30,20,35,11,4,50,38,12,38,12,0,0,16,9,10,8,3,4,0,1,33,4,38
20201112,12NOV2020:00:00:00,UFU PIÑERO,26,21,25,17,5,47,41,6,41,6,2,1,13,13,5,6,6,1,0,2,35,4,41
20201112,12NOV2020:00:00:00,UFU RAMOS MEJIA,23,26,37,8,4,49,43,6,45,4,5,2,11,10,5,4,5,7,0,8,28,7,43
20201112,12NOV2020:00:00:00,UFU RIVADAVIA,56,53,64,40,5,109,99,10,99,10,0,5,44,32,14,11,3,0,0,8,73,18,99
20201112,12NOV2020:00:00:00,UFU SANTOJANNI,20,28,26,22,0,48,46,2,46,2,1,4,9,13,8,5,8,0,0,8,32,6,46
20201112,12NOV2020:00:00:00,UFU TORNU,37,28,41,23,1,65,57,8,59,6,7,2,12,25,10,6,1,2,0,10,36,11,57
20201112,12NOV2020:00:00:00,UFU VELEZ SARSFIELD,39,23,46,16,0,62,60,2,60,2,0,0,13,13,14,12,8,2,0,8,39,13,60
20201112,12NOV2020:00:00:00,UFU ZUBIZARRETA,24,16,27,11,2,40,38,2,38,2,0,1,5,9,7,10,4,4,0,6,29,3,38
20201113,13NOV2020:00:00:00,UFU ALVAREZ,43,48,75,16,0,91,89,2,89,2,1,2,17,25,20,11,8,7,0,8,70,11,89
20201113,13NOV2020:00:00:00,UFU ARGERICH,21,17,23,13,2,38,28,10,28,10,2,0,9,8,10,8,0,1,0,2,22,4,28
20201113,13NOV2020:00:00:00,UFU BORDA-MOYANO,9,0,7,2,0,9,7,2,7,2,0,0,1,1,2,3,2,0,0,1,5,1,7
20201113,13NOV2020:00:00:00,UFU DURAND,33,23,52,4,0,56,50,6,50,6,0,3,10,20,10,7,4,2,0,10,30,10,50
20201113,13NOV2020:00:00:00,UFU ELIZALDE,32,27,7,50,2,59,33,26,53,6,41,8,1,3,4,2,0,0,0,2,24,7,33
20201113,13NOV2020:00:00:00,UFU FERNANDEZ,37,24,50,7,4,61,51,10,59,2,0,4,15,18,3,10,5,6,0,9,32,10,51
20201113,13NOV2020:00:00:00,UFU FERRER,13,20,19,14,0,33,29,4,29,4,0,4,11,6,5,5,2,0,0,7,22,0,29
20201117,17NOV2020:00:00:00,UFU BORDA-MOYANO,6,3,6,3,0,9,7,2,7,2,0,0,4,0,0,4,1,0,0,1,6,0,7
20201117,17NOV2020:00:00:00,UFU FERNANDEZ,24,16,28,10,2,40,24,16,32,8,0,1,6,13,8,8,4,0,0,4,16,4,24
20201117,17NOV2020:00:00:00,UFU FERRER,29,20,22,27,0,49,49,0,49,0,1,3,17,10,8,7,3,0,0,7,31,11,49
20201117,17NOV2020:00:00:00,UFU GRIERSON,17,13,16,14,0,30,30,0,30,0,0,2,8,7,8,1,3,1,0,2,23,5,30
20201117,17NOV2020:00:00:00,UFU GUTIERREZ,40,40,57,23,0,80,74,6,80,0,19,13,8,12,18,10,0,0,0,0,51,22,74
20201117,17NOV2020:00:00:00,UFU MUÑIZ,126,127,118,131,4,253,117,136,119,134,14,17,48,66,42,38,20,8,0,13,96,8,117
20201117,17NOV2020:00:00:00,UFU PENNA,2,2,2,2,0,4,2,2,4,0,0,0,2,1,0,0,0,1,0,0,2,0,2
20201117,17NOV2020:00:00:00,UFU PIÑERO,18,14,17,8,7,32,24,8,24,8,2,1,4,13,5,6,1,0,0,3,16,5,24
20201117,17NOV2020:00:00:00,UFU RAMOS MEJIA,33,19,42,10,0,52,44,8,46,6,4,4,10,16,8,9,1,0,0,11,27,6,44
20201117,17NOV2020:00:00:00,UFU RIVADAVIA,34,41,57,15,3,75,67,8,69,6,0,0,26,24,10,8,6,1,0,6,54,7,67
20201117,17NOV2020:00:00:00,UFU SANTOJANNI,18,28,23,23,0,46,42,4,44,2,0,0,20,7,7,7,3,2,0,9,27,6,42
20201117,17NOV2020:00:00:00,UFU TORNU,6,2,6,2,0,8,4,4,8,0,2,0,3,1,1,1,0,0,0,1,3,0,4
20201117,17NOV2020:00:00:00,UFU VELEZ SARSFIELD,19,27,36,10,0,46,44,2,46,0,0,1,8,19,4,8,5,1,0,6,31,7,44
20201118,18NOV2020:00:00:00,UFU ALVAREZ,73,64,111,24,2,137,127,10,127,10,1,13,38,28,21,19,11,6,0,6,57,64,127
20201118,18NOV2020:00:00:00,UFU ARGERICH,45,37,61,20,1,82,68,14,68,14,8,4,19,14,13,12,9,3,0,8,41,18,68
20201118,18NOV2020:00:00:00,UFU BORDA-MOYANO,8,24,28,4,0,32,28,4,28,4,0,0,11,13,6,2,0,0,0,2,14,12,28
20201118,18NOV2020:00:00:00,UFU DURAND,38,36,66,8,0,74,74,0,74,0,4,0,19,26,9,10,5,1,0,13,48,13,74
20201118,18NOV2020:00:00:00,UFU ELIZALDE,55,35,30,60,0,90,66,24,74,16,46,13,10,11,3,5,0,2,0,1,51,14,66
20201118,18NOV2020:00:00:00,UFU FERNANDEZ,22,22,38,5,1,44,38,6,44,0,0,0,15,16,8,3,2,0,0,5,22,11,38
20201118,18NOV2020:00:00:00,UFU FERRER,26,23,32,17,0,49,49,0,49,0,0,0,9,17,10,8,4,1,0,8,36,5,49
20201118,18NOV2020:00:00:00,UFU GRIERSON,25,39,30,33,1,64,64,0,64,0,0,7,12,23,11,6,3,2,0,3,52,9,64
20201118,18NOV2020:00:00:00,UFU GUTIERREZ,71,58,89,40,0,129,107,22,121,8,26,16,22,27,15,9,14,0,0,3,83,21,107
20201118,18NOV2020:00:00:00,UFU MUÑIZ,127,186,139,166,8,313,153,160,165,148,14,16,46,98,51,40,33,15,0,14,122,17,153
20201118,18NOV2020:00:00:00,UFU PENNA,17,8,21,4,0,25,21,4,25,0,0,0,5,13,2,2,3,0,0,6,13,2,21
20201118,18NOV2020:00:00:00,UFU PIROVANO,47,45,64,26,2,92,82,10,86,6,0,0,20,26,21,13,8,4,0,7,66,9,82
20201118,18NOV2020:00:00:00,UFU PIÑERO,39,25,41,20,3,64,58,6,58,6,0,2,18,17,11,6,5,5,0,6,41,11,58
20201118,18NOV2020:00:00:00,UFU RAMOS MEJIA,25,38,47,15,1,63,55,8,57,6,1,1,8,22,16,6,3,6,0,15,33,7,55
20201118,18NOV2020:00:00:00,UFU RIVADAVIA,61,48,70,37,2,109,103,6,103,6,0,0,45,27,14,18,2,3,0,7,71,24,103
20201118,18NOV2020:00:00:00,UFU SANTOJANNI,47,36,35,42,6,83,67,16,71,12,6,2,15,20,13,11,5,11,0,6,56,5,67
20201118,18NOV2020:00:00:00,UFU TORNU,51,62,71,39,3,113,85,28,97,16,3,8,21,34,20,16,6,5,0,9,58,18,85
20201118,18NOV2020:00:00:00,UFU VELEZ SARSFIELD,37,35,51,21,0,72,70,2,70,2,0,0,20,16,24,7,3,2,0,4,53,13,70
20201118,18NOV2020:00:00:00,UFU ZUBIZARRETA,48,46,60,26,8,94,78,16,82,12,3,7,14,24,22,10,8,6,0,27,41,10,78
20201119,19NOV2020:00:00:00,UFU ALVAREZ,47,31,57,20,1,78,68,10,68,10,0,6,26,14,14,9,5,4,0,7,42,19,68
20201119,19NOV2020:00:00:00,UFU ARGERICH,34,20,35,19,0,54,34,20,42,12,4,0,17,9,7,7,8,2,0,4,22,8,34
20201119,19NOV2020:00:00:00,UFU BORDA-MOYANO,10,4,9,5,0,14,14,0,14,0,0,2,2,5,2,2,1,0,0,2,9,3,14
20201119,19NOV2020:00:00:00,UFU DURAND,38,25,54,9,0,63,63,0,63,0,3,1,18,16,14,6,4,1,0,8,37,18,63
20201119,19NOV2020:00:00:00,UFU ELIZALDE,56,39,39,54,2,95,51,44,67,28,47,10,4,17,10,2,2,3,0,1,41,9,51
20201119,19NOV2020:00:00:00,UFU FERNANDEZ,31,18,35,11,3,49,43,6,49,0,0,0,8,21,5,8,7,0,0,2,30,11,43
20201119,19NOV2020:00:00:00,UFU FERRER,27,15,31,11,0,42,42,0,42,0,0,0,14,14,4,9,1,0,0,6,31,5,42
20201119,19NOV2020:00:00:00,UFU GRIERSON,17,22,25,14,0,39,33,6,33,6,5,3,12,6,12,1,0,0,0,5,24,4,33
20201119,19NOV2020:00:00:00,UFU GUTIERREZ,65,43,79,29,0,108,97,11,103,5,18,12,19,38,10,6,4,1,0,1,72,22,97
20201119,19NOV2020:00:00:00,UFU MUÑIZ,125,197,138,165,19,322,152,170,162,160,16,16,67,74,78,42,18,11,0,15,125,12,152
20201119,19NOV2020:00:00:00,UFU PENNA,15,11,20,6,0,26,22,4,24,2,0,0,4,8,4,3,6,1,0,2,17,3,22
20201119,19NOV2020:00:00:00,UFU PIROVANO,49,28,58,19,0,77,67,10,77,0,0,1,17,28,12,7,9,3,0,4,56,7,67
20201119,19NOV2020:00:00:00,UFU PIÑERO,34,42,58,18,0,76,66,10,68,8,6,7,22,19,9,10,2,1,0,5,32,27,66
20201119,19NOV2020:00:00:00,UFU RAMOS MEJIA,11,23,22,7,5,34,24,10,28,6,0,0,9,8,10,4,3,0,0,2,18,4,24
20201119,19NOV2020:00:00:00,UFU RIVADAVIA,67,45,56,41,15,112,88,24,90,22,0,2,41,41,12,7,8,1,0,5,65,17,88
20201119,19NOV2020:00:00:00,UFU SANTOJANNI,34,35,39,24,6,69,53,16,63,6,2,6,10,17,17,8,7,2,0,6,44,3,53
20201119,19NOV2020:00:00:00,UFU TORNU,47,32,67,12,0,79,67,12,67,12,1,2,19,28,11,10,1,7,0,4,49,14,67
20201119,19NOV2020:00:00:00,UFU VELEZ SARSFIELD,36,23,37,22,0,59,57,2,57,2,0,3,16,21,7,6,5,1,0,2,47,8,57
20201119,19NOV2020:00:00:00,UFU ZUBIZARRETA,42,25,40,27,0,67,63,4,63,4,8,4,8,16,14,12,3,2,0,9,32,22,63
20201120,20NOV2020:00:00:00,UFU ALVAREZ,61,44,90,13,2,105,93,12,95,10,3,2,28,24,23,17,3,5,0,14,61,17,93
20201120,20NOV2020:00:00:00,UFU ARGERICH,23,16,31,8,0,39,31,8,31,8,1,6,9,4,4,8,6,1,0,3,20,8,31
20201120,20NOV2020:00:00:00,UFU BORDA-MOYANO,8,5,10,3,0,13,11,2,11,2,0,1,4,3,3,2,0,0,0,1,8,2,11
20201120,20NOV2020:00:00:00,UFU DURAND,36,21,51,6,0,57,53,4,53,4,3,1,16,16,6,9,4,2,0,12,36,4,53
20201120,20NOV2020:00:00:00,UFU ELIZALDE,22,23,11,33,1,45,31,14,37,8,26,11,0,3,3,1,1,0,0,1,25,5,31
20201120,20NOV2020:00:00:00,UFU FERNANDEZ,24,19,37,6,0,43,37,6,41,2,0,0,15,14,2,7,5,0,0,10,23,4,37
20201120,20NOV2020:00:00:00,UFU FERRER,28,14,22,20,0,42,36,6,36,6,0,0,7,15,9,6,4,1,0,2,32,2,36
20201120,20NOV2020:00:00:00,UFU GRIERSON,22,21,26,17,0,43,41,2,41,2,4,4,6,7,8,10,1,3,0,9,27,5,41
20201120,20NOV2020:00:00:00,UFU GUTIERREZ,53,28,57,24,0,81,69,12,77,4,16,7,14,23,12,7,2,0,0,5,43,20,69
20201120,20NOV2020:00:00:00,UFU MUÑIZ,154,170,129,185,10,324,154,170,170,154,7,10,47,91,71,64,23,11,0,26,112,16,154
20201120,20NOV2020:00:00:00,UFU PENNA,16,6,12,9,1,22,16,6,16,6,0,0,5,5,3,5,3,1,0,4,12,0,16
20201120,20NOV2020:00:00:00,UFU PIROVANO,61,35,77,19,0,96,81,15,83,13,2,2,31,25,15,7,13,1,0,3,55,22,81
20201120,20NOV2020:00:00:00,UFU PIÑERO,30,21,26,21,4,51,49,2,49,2,0,5,9,8,17,6,3,3,0,5,39,5,49
20201120,20NOV2020:00:00:00,UFU RAMOS MEJIA,11,16,20,7,0,27,27,0,27,0,1,2,4,6,7,4,1,2,0,4,22,1,27
20201120,20NOV2020:00:00:00,UFU RIVADAVIA,68,54,74,40,8,122,110,12,112,10,0,6,28,33,24,12,16,3,0,6,80,23,110
20201120,20NOV2020:00:00:00,UFU SANTOJANNI,44,24,34,34,0,68,62,6,68,0,2,2,19,14,16,7,4,4,0,6,52,4,62
20201120,20NOV2020:00:00:00,UFU TORNU,57,31,73,8,7,88,78,10,78,10,5,3,35,15,7,10,7,6,0,6,53,19,78
20201120,20NOV2020:00:00:00,UFU VELEZ SARSFIELD,27,19,42,4,0,46,42,4,44,2,0,0,10,15,8,8,3,2,0,0,29,13,42
20201120,20NOV2020:00:00:00,UFU ZUBIZARRETA,24,28,24,21,7,52,46,6,46,6,4,0,11,18,3,11,3,2,0,6,34,6,46
20201121,21NOV2020:00:00:00,UFU ALVAREZ,27,25,43,6,3,52,44,8,44,8,0,5,10,16,10,5,4,2,0,5,33,6,44
20201121,21NOV2020:00:00:00,UFU BORDA-MOYANO,8,2,6,4,0,10,8,2,8,2,0,1,1,0,5,1,0,2,0,0,6,2,8
20201121,21NOV2020:00:00:00,UFU DURAND,30,19,38,9,2,49,47,2,47,2,1,4,14,17,6,4,3,0,0,11,29,7,47
20201121,21NOV2020:00:00:00,UFU ELIZALDE,20,15,6,29,0,35,27,8,29,6,21,8,0,4,2,0,0,0,0,0,20,7,27
20201121,21NOV2020:00:00:00,UFU FERNANDEZ,14,8,15,7,0,22,18,4,18,4,0,0,9,7,2,2,2,0,0,4,13,1,18
20201121,21NOV2020:00:00:00,UFU FERRER,15,23,12,24,2,38,36,2,36,2,0,0,17,6,9,2,4,0,0,6,24,6,36
20201121,21NOV2020:00:00:00,UFU GRIERSON,25,11,21,13,2,36,34,2,34,2,0,1,12,10,4,2,6,1,0,12,19,3,34
20201121,21NOV2020:00:00:00,UFU GUTIERREZ,47,13,45,13,2,60,52,8,56,4,8,4,9,23,7,5,4,0,0,1,40,10,52
20201121,21NOV2020:00:00:00,UFU MUÑIZ,97,76,84,88,1,173,89,84,93,80,5,9,48,38,38,20,10,5,0,17,67,5,89
20201121,21NOV2020:00:00:00,UFU PENNA,9,5,9,5,0,14,8,6,12,2,0,0,0,8,4,1,1,0,0,0,7,1,8
20201121,21NOV2020:00:00:00,UFU PIROVANO,23,15,33,5,0,38,34,4,38,0,0,1,8,14,7,4,1,3,0,4,27,3,34
20201121,21NOV2020:00:00:00,UFU PIÑERO,16,14,24,5,1,30,26,4,26,4,0,0,9,8,7,4,0,2,0,3,17,6,26
20201121,21NOV2020:00:00:00,UFU RAMOS MEJIA,15,11,18,7,1,26,20,6,20,6,1,0,5,11,4,1,2,2,0,10,7,3,20
20201121,21NOV2020:00:00:00,UFU RIVADAVIA,46,37,66,16,1,83,79,4,81,2,0,1,23,24,11,9,7,8,0,11,56,11,79
20201121,21NOV2020:00:00:00,UFU SANTOJANNI,15,14,19,10,0,29,13,16,25,4,2,0,7,2,5,2,8,3,0,1,12,0,13
20201121,21NOV2020:00:00:00,UFU TORNU,28,32,28,26,6,60,36,24,58,2,2,4,13,15,12,7,3,4,0,4,22,10,36
20201121,21NOV2020:00:00:00,UFU VELEZ SARSFIELD,17,11,21,7,0,28,26,2,26,2,0,0,7,5,6,5,4,1,0,4,19,3,26
20201121,21NOV2020:00:00:00,UFU ZUBIZARRETA,42,34,58,18,0,76,65,11,69,7,1,4,12,23,15,12,7,2,0,6,53,6,65
20201122,22NOV2020:00:00:00,UFU ALVAREZ,62,47,86,21,2,109,43,66,43,66,10,3,34,20,17,14,7,4,0,5,28,10,43
20201122,22NOV2020:00:00:00,UFU BORDA-MOYANO,35,3,29,9,0,38,12,26,12,26,0,1,15,5,7,7,1,2,0,0,9,3,12
20201122,22NOV2020:00:00:00,UFU DURAND,15,8,17,6,0,23,21,2,21,2,0,0,6,6,4,2,4,1,0,5,14,2,21
20201122,22NOV2020:00:00:00,UFU ELIZALDE,25,17,16,26,0,42,17,25,35,7,31,7,1,1,1,1,0,0,0,2,12,3,17
20201122,22NOV2020:00:00:00,UFU FERNANDEZ,13,8,17,4,0,21,17,4,21,0,0,0,3,8,3,5,2,0,0,2,10,5,17
20201122,22NOV2020:00:00:00,UFU FERRER,12,13,22,3,0,25,19,6,19,6,1,1,8,4,5,5,1,0,0,0,17,2,19
20201122,22NOV2020:00:00:00,UFU GRIERSON,16,11,19,8,0,27,27,0,27,0,0,1,10,5,3,6,2,0,0,6,16,5,27
20201122,22NOV2020:00:00:00,UFU GUTIERREZ,35,24,37,22,0,59,51,8,59,0,12,9,11,10,12,2,1,2,0,2,41,7,51
20201122,22NOV2020:00:00:00,UFU MUÑIZ,88,63,77,71,3,151,89,62,119,32,8,8,30,30,34,20,13,8,0,14,65,10,89
20201122,22NOV2020:00:00:00,UFU PENNA,13,2,6,9,0,15,9,6,13,2,0,0,0,5,2,1,2,5,0,2,5,2,9
20201122,22NOV2020:00:00:00,UFU PIROVANO,18,10,26,2,0,28,24,4,28,0,0,0,8,5,9,3,3,0,0,1,20,3,24
20201122,22NOV2020:00:00:00,UFU PIÑERO,7,12,16,2,1,19,15,4,15,4,3,2,2,4,2,5,1,0,0,2,12,1,15
20201122,22NOV2020:00:00:00,UFU RAMOS MEJIA,24,19,33,10,0,43,43,0,43,0,2,4,11,5,13,0,4,4,0,5,21,17,43
20201122,22NOV2020:00:00:00,UFU RIVADAVIA,35,28,52,7,4,63,55,8,55,8,2,0,19,21,6,6,6,3,0,11,33,10,55
20201122,22NOV2020:00:00:00,UFU SANTOJANNI,17,20,26,11,0,37,29,8,31,6,2,1,8,7,9,3,6,1,0,4,20,5,29
20201122,22NOV2020:00:00:00,UFU TORNU,8,22,16,11,3,30,26,4,26,4,0,2,6,5,6,9,2,0,0,6,13,7,26
20201122,22NOV2020:00:00:00,UFU VELEZ SARSFIELD,15,22,23,14,0,37,33,4,37,0,0,2,6,13,10,4,2,0,0,0,29,4,33
20201122,22NOV2020:00:00:00,UFU ZUBIZARRETA,31,30,40,21,0,61,57,4,57,4,0,1,18,11,12,10,7,2,0,13,25,19,57
20201123,23NOV2020:00:00:00,UFU ALVAREZ,45,17,53,9,0,62,48,14,48,14,0,7,13,18,13,3,6,2,0,3,35,10,48
20201123,23NOV2020:00:00:00,UFU BORDA-MOYANO,0,7,4,3,0,7,7,0,7,0,0,0,0,6,1,0,0,0,0,0,4,3,7
20201123,23NOV2020:00:00:00,UFU DURAND,23,26,44,5,0,49,49,0,49,0,0,4,11,11,10,4,7,2,0,7,38,4,49
20201123,23NOV2020:00:00:00,UFU ELIZALDE,39,25,25,39,0,64,48,16,62,2,37,10,2,6,5,3,1,0,0,2,39,7,48
20201123,23NOV2020:00:00:00,UFU FERNANDEZ,15,7,18,4,0,22,22,0,22,0,0,0,5,6,5,3,3,0,0,3,15,4,22
20201123,23NOV2020:00:00:00,UFU FERRER,16,13,16,13,0,29,27,2,27,2,0,0,8,14,4,2,0,1,0,3,19,5,27
20201123,23NOV2020:00:00:00,UFU GRIERSON,13,22,15,20,0,35,33,2,33,2,0,0,13,8,3,9,2,0,0,9,24,0,33
20201123,23NOV2020:00:00:00,UFU GUTIERREZ,53,26,47,31,1,79,73,6,75,4,31,14,12,7,10,2,3,0,0,2,50,18,73
20201123,23NOV2020:00:00:00,UFU MUÑIZ,109,106,137,73,5,215,101,114,105,110,10,10,58,52,44,32,5,4,0,8,67,26,101
20201123,23NOV2020:00:00:00,UFU PENNA,10,8,14,4,0,18,18,0,18,0,0,2,9,5,1,0,1,0,0,1,12,5,18
20201123,23NOV2020:00:00:00,UFU PIROVANO,31,26,51,6,0,57,51,6,53,4,1,5,17,10,10,6,7,1,0,4,40,7,51
20201123,23NOV2020:00:00:00,UFU PIÑERO,13,13,21,5,0,26,24,2,24,2,0,0,3,9,7,3,1,3,0,1,16,7,24
20201123,23NOV2020:00:00:00,UFU RAMOS MEJIA,15,15,16,14,0,30,28,2,28,2,3,1,11,1,8,2,4,0,0,4,17,7,28
20201123,23NOV2020:00:00:00,UFU RIVADAVIA,59,47,84,22,0,106,74,32,74,32,0,2,40,23,15,14,10,2,0,6,41,22,74
20201123,23NOV2020:00:00:00,UFU SANTOJANNI,13,18,14,17,0,31,25,6,29,2,0,2,4,14,1,2,7,1,0,3,21,1,25
20201123,23NOV2020:00:00:00,UFU TORNU,16,12,9,12,7,28,24,4,24,4,0,0,6,8,9,3,0,2,0,2,16,5,24
20201123,23NOV2020:00:00:00,UFU VELEZ SARSFIELD,24,22,36,10,0,46,40,6,40,6,0,2,19,9,8,4,3,1,0,3,30,7,40
20201123,23NOV2020:00:00:00,UFU ZUBIZARRETA,55,38,59,34,0,93,83,10,83,10,5,6,31,15,18,11,5,2,0,4,60,19,83
20201124,24NOV2020:00:00:00,UFU ALVAREZ,70,68,97,39,2,138,128,10,128,10,6,4,40,34,17,20,8,9,0,6,42,80,128
20201124,24NOV2020:00:00:00,UFU ARGERICH,37,20,43,14,0,57,43,14,45,12,2,3,9,18,11,7,6,1,0,1,27,15,43
20201124,24NOV2020:00:00:00,UFU BORDA-MOYANO,6,2,5,3,0,8,8,0,8,0,0,0,0,1,3,3,1,0,0,1,6,1,8
20201124,24NOV2020:00:00:00,UFU DURAND,26,14,32,8,0,40,40,0,40,0,0,1,5,16,9,5,3,1,0,8,30,2,40
20201124,24NOV2020:00:00:00,UFU ELIZALDE,35,26,11,50,0,61,45,16,57,4,33,12,1,6,6,3,0,0,0,0,33,12,45
20201124,24NOV2020:00:00:00,UFU FERNANDEZ,35,18,43,9,1,53,43,10,49,4,0,3,12,14,11,10,1,2,0,7,25,11,43
20201124,24NOV2020:00:00:00,UFU FERRER,38,26,21,43,0,64,60,4,60,4,0,2,17,16,16,11,1,1,0,10,46,4,60
20201124,24NOV2020:00:00:00,UFU GRIERSON,37,37,26,48,0,74,64,10,64,10,0,5,24,20,9,9,6,1,0,8,40,16,64
20201124,24NOV2020:00:00:00,UFU GUTIERREZ,72,42,66,47,1,114,98,16,104,10,22,20,22,17,18,11,2,2,0,2,80,15,98
20201124,24NOV2020:00:00:00,UFU MUÑIZ,129,146,143,125,7,275,147,128,153,122,4,20,73,57,54,38,26,3,0,18,120,9,147
20201124,24NOV2020:00:00:00,UFU PENNA,11,16,12,15,0,27,21,6,23,4,0,2,7,2,2,7,3,4,0,0,18,3,21
20201124,24NOV2020:00:00:00,UFU PIROVANO,33,24,47,10,0,57,51,6,57,0,0,0,9,14,12,13,7,2,0,2,46,3,51
20201124,24NOV2020:00:00:00,UFU PIÑERO,26,31,39,17,1,57,51,6,51,6,2,1,14,15,8,9,3,5,0,7,29,10,51
20201124,24NOV2020:00:00:00,UFU RAMOS MEJIA,48,27,52,22,1,75,61,14,67,8,11,8,12,12,11,12,6,3,0,8,45,8,61
20201113,13NOV2020:00:00:00,UFU GRIERSON,29,29,27,31,0,58,58,0,58,0,1,2,13,13,17,9,3,0,0,11,36,11,58
20201113,13NOV2020:00:00:00,UFU GUTIERREZ,43,33,60,16,0,76,72,4,76,0,21,8,18,16,7,5,1,0,0,2,56,14,72
20201113,13NOV2020:00:00:00,UFU MUÑIZ,153,181,175,149,10,334,138,196,146,188,4,8,80,77,77,54,27,7,0,10,113,15,138
20201113,13NOV2020:00:00:00,UFU PENNA,8,10,11,7,0,18,14,4,18,0,0,0,7,4,1,5,1,0,0,1,11,2,14
20201113,13NOV2020:00:00:00,UFU PIROVANO,32,17,39,8,2,49,41,8,45,4,1,3,12,7,6,8,7,5,0,8,30,3,41
20201113,13NOV2020:00:00:00,UFU PIÑERO,32,22,38,13,3,54,46,8,52,2,2,2,15,9,14,7,5,0,0,8,33,5,46
20201113,13NOV2020:00:00:00,UFU RAMOS MEJIA,24,18,34,8,0,42,36,6,40,2,0,6,4,11,9,8,3,1,0,8,22,6,36
20201113,13NOV2020:00:00:00,UFU RIVADAVIA,65,46,70,32,9,111,97,14,97,14,0,2,40,39,16,10,4,0,0,7,72,18,97
20201113,13NOV2020:00:00:00,UFU SANTOJANNI,47,26,44,29,0,73,55,18,61,12,7,1,13,19,18,8,7,0,0,5,45,5,55
20201113,13NOV2020:00:00:00,UFU TORNU,29,30,48,11,0,59,45,14,45,14,2,3,10,20,12,3,8,1,0,8,27,10,45
20201113,13NOV2020:00:00:00,UFU VELEZ SARSFIELD,20,20,33,7,0,40,40,0,40,0,0,2,9,10,10,4,0,5,0,7,25,8,40
20201113,13NOV2020:00:00:00,UFU ZUBIZARRETA,31,22,37,14,2,53,41,12,43,10,1,1,13,12,8,5,11,2,0,9,23,9,41
20201114,14NOV2020:00:00:00,UFU ALVAREZ,40,29,47,19,3,69,61,8,61,8,8,7,24,12,14,3,1,0,0,9,39,13,61
20201114,14NOV2020:00:00:00,UFU BORDA-MOYANO,22,4,20,3,3,26,26,0,26,0,0,0,3,9,6,2,6,0,0,1,18,7,26
20201114,14NOV2020:00:00:00,UFU DURAND,16,23,33,6,0,39,35,4,37,2,4,1,8,11,6,7,2,0,0,9,22,4,35
20201114,14NOV2020:00:00:00,UFU ELIZALDE,26,25,14,35,2,51,27,24,49,2,35,8,4,1,3,0,0,0,0,2,21,4,27
20201114,14NOV2020:00:00:00,UFU FERNANDEZ,4,6,5,5,0,10,10,0,10,0,0,0,4,2,2,2,0,0,0,1,9,0,10
20201114,14NOV2020:00:00:00,UFU FERRER,18,13,17,14,0,31,29,2,29,2,2,1,7,11,4,4,1,1,0,7,20,2,29
20201114,14NOV2020:00:00:00,UFU GRIERSON,31,27,31,23,4,58,50,8,56,2,0,3,10,15,8,7,13,2,0,14,32,3,50
20201114,14NOV2020:00:00:00,UFU GUTIERREZ,20,24,33,11,0,44,42,2,42,2,12,9,3,6,8,1,4,1,0,2,25,15,42
20201114,14NOV2020:00:00:00,UFU MUÑIZ,102,82,102,79,3,184,77,107,83,101,2,2,43,41,44,28,15,9,0,10,62,5,77
20201114,14NOV2020:00:00:00,UFU PENNA,10,5,9,6,0,15,13,2,15,0,0,0,1,2,1,7,0,4,0,5,5,3,13
20201114,14NOV2020:00:00:00,UFU PIROVANO,13,5,15,2,1,18,18,0,18,0,0,0,4,3,1,5,2,3,0,3,14,1,18
20201114,14NOV2020:00:00:00,UFU PIÑERO,7,24,26,3,2,31,25,6,25,6,0,2,5,10,4,7,0,3,0,2,17,6,25
20201114,14NOV2020:00:00:00,UFU RAMOS MEJIA,20,19,30,9,0,39,29,10,31,8,4,0,7,16,3,6,2,1,0,11,15,3,29
20201114,14NOV2020:00:00:00,UFU RIVADAVIA,34,27,53,8,0,61,57,4,59,2,0,1,26,16,6,6,2,4,0,8,44,5,57
20201114,14NOV2020:00:00:00,UFU SANTOJANNI,30,19,22,25,2,49,41,8,43,6,0,4,10,11,10,6,6,2,0,3,36,2,41
20201114,14NOV2020:00:00:00,UFU TORNU,19,14,11,16,6,33,29,4,29,4,0,0,4,12,10,5,0,2,0,5,19,5,29
20201114,14NOV2020:00:00:00,UFU VELEZ SARSFIELD,27,20,32,15,0,47,47,0,47,0,0,1,6,15,11,11,3,0,0,15,26,6,47
20201114,14NOV2020:00:00:00,UFU ZUBIZARRETA,29,22,31,19,1,51,47,4,47,4,0,2,8,10,13,3,13,2,0,16,29,2,47
20201115,15NOV2020:00:00:00,UFU ALVAREZ,34,42,69,7,0,76,32,44,32,44,9,4,15,18,20,8,0,2,0,1,18,13,32
20201115,15NOV2020:00:00:00,UFU BORDA-MOYANO,0,3,3,0,0,3,3,0,3,0,0,0,0,3,0,0,0,0,0,0,2,1,3
20201115,15NOV2020:00:00:00,UFU DURAND,13,13,21,5,0,26,26,0,26,0,1,0,4,9,5,4,3,0,0,6,15,5,26
20201115,15NOV2020:00:00:00,UFU ELIZALDE,21,21,16,26,0,42,26,16,40,2,24,10,2,5,0,1,0,0,0,1,19,6,26
20201115,15NOV2020:00:00:00,UFU FERNANDEZ,12,9,15,6,0,21,19,2,21,0,0,0,5,7,3,3,0,3,0,3,10,6,19
20201115,15NOV2020:00:00:00,UFU FERRER,10,12,15,7,0,22,22,0,22,0,0,0,4,9,4,2,2,1,0,1,19,2,22
20201115,15NOV2020:00:00:00,UFU GRIERSON,12,9,10,11,0,21,21,0,21,0,0,0,3,9,5,0,4,0,0,9,12,0,21
20201115,15NOV2020:00:00:00,UFU GUTIERREZ,31,21,38,14,0,52,50,2,50,2,13,4,7,15,5,4,3,1,0,3,40,5,50
20201115,15NOV2020:00:00:00,UFU MUÑIZ,76,56,74,58,0,132,70,62,88,44,4,6,21,25,28,19,18,11,0,4,57,9,70
20201115,15NOV2020:00:00:00,UFU PENNA,8,7,11,3,1,15,9,6,13,2,0,1,5,4,0,2,1,2,0,2,6,1,9
20201115,15NOV2020:00:00:00,UFU PIROVANO,7,15,20,2,0,22,22,0,22,0,0,2,10,5,4,1,0,0,0,2,15,5,22
20201115,15NOV2020:00:00:00,UFU PIÑERO,7,7,12,2,0,14,8,6,8,6,0,0,1,2,3,5,3,0,0,5,2,1,8
20201115,15NOV2020:00:00:00,UFU RAMOS MEJIA,10,7,15,2,0,17,17,0,17,0,0,2,2,9,2,2,0,0,0,1,10,6,17
20201115,15NOV2020:00:00:00,UFU RIVADAVIA,19,16,32,3,0,35,33,2,33,2,0,0,9,13,4,4,5,0,0,3,27,2,33
20201115,15NOV2020:00:00:00,UFU SANTOJANNI,15,14,17,12,0,29,27,2,29,0,0,1,4,6,11,6,1,0,0,6,19,2,27
20201115,15NOV2020:00:00:00,UFU TORNU,12,20,18,12,2,32,20,12,24,8,2,4,8,4,5,4,3,2,0,5,12,3,20
20201115,15NOV2020:00:00:00,UFU VELEZ SARSFIELD,13,18,19,12,0,31,29,2,29,2,0,0,5,8,10,3,4,1,0,6,17,6,29
20201115,15NOV2020:00:00:00,UFU ZUBIZARRETA,16,22,20,17,1,38,36,2,36,2,2,3,5,7,10,6,1,4,0,9,21,6,36
20201116,16NOV2020:00:00:00,UFU ALVAREZ,48,57,77,28,0,105,93,12,93,12,2,3,22,29,17,8,14,10,0,6,60,27,93
20201116,16NOV2020:00:00:00,UFU ARGERICH,33,20,34,19,0,53,43,10,43,10,7,4,9,9,9,10,1,4,0,5,21,17,43
20201116,16NOV2020:00:00:00,UFU BORDA-MOYANO,11,2,11,2,0,13,7,6,7,6,0,2,3,0,5,2,1,0,0,0,5,2,7
20201116,16NOV2020:00:00:00,UFU DURAND,29,21,40,10,0,50,46,4,46,4,6,1,12,14,7,4,2,4,0,7,35,4,46
20201116,16NOV2020:00:00:00,UFU ELIZALDE,32,16,12,35,1,48,36,12,44,4,26,11,4,6,1,0,0,0,0,2,29,5,36
20201116,16NOV2020:00:00:00,UFU FERNANDEZ,39,33,56,16,0,72,68,4,70,2,0,4,14,20,17,9,6,2,0,12,38,18,68
20201116,16NOV2020:00:00:00,UFU FERRER,18,28,26,20,0,46,42,4,42,4,0,0,7,15,16,3,4,1,0,2,38,2,42
20201116,16NOV2020:00:00:00,UFU GRIERSON,32,39,33,38,0,71,71,0,71,0,2,6,20,10,14,11,2,6,0,9,58,4,71
20201116,16NOV2020:00:00:00,UFU GUTIERREZ,60,36,74,22,0,96,88,8,96,0,27,21,12,20,10,3,2,1,0,6,61,20,88
20201116,16NOV2020:00:00:00,UFU MUÑIZ,109,135,128,111,5,244,174,70,180,64,5,7,43,63,53,51,14,8,0,8,138,28,174
20201116,16NOV2020:00:00:00,UFU PENNA,21,14,23,10,2,35,33,2,33,2,0,1,5,7,11,6,5,0,0,7,22,4,33
20201116,16NOV2020:00:00:00,UFU PIROVANO,48,32,58,20,2,80,68,12,78,2,0,5,19,11,17,9,11,8,0,6,46,16,68
20201116,16NOV2020:00:00:00,UFU PIÑERO,28,19,30,8,9,47,43,4,45,2,0,0,7,11,11,9,4,5,0,7,31,5,43
20201116,16NOV2020:00:00:00,UFU RAMOS MEJIA,38,25,50,13,0,63,51,12,57,6,1,2,15,17,7,11,6,4,0,13,27,11,51
20201116,16NOV2020:00:00:00,UFU RIVADAVIA,79,61,75,51,14,140,76,64,76,64,0,0,39,39,27,8,13,14,0,3,57,15,76
20201116,16NOV2020:00:00:00,UFU SANTOJANNI,37,27,32,29,3,64,56,8,56,8,1,1,13,14,14,10,6,5,0,5,49,2,56
20201116,16NOV2020:00:00:00,UFU TORNU,27,38,41,24,0,65,61,4,63,2,3,4,14,13,18,7,5,1,0,11,39,11,61
20201116,16NOV2020:00:00:00,UFU VELEZ SARSFIELD,37,23,45,13,2,60,56,4,56,4,0,0,19,15,13,8,4,1,0,6,40,10,56
20201116,16NOV2020:00:00:00,UFU ZUBIZARRETA,40,19,41,18,0,59,51,8,53,6,1,0,10,11,12,9,7,9,0,11,37,3,51
20201117,17NOV2020:00:00:00,UFU ALVAREZ,21,28,35,14,0,49,45,4,45,4,2,1,18,15,8,3,2,0,0,6,32,7,45
20201117,17NOV2020:00:00:00,UFU ARGERICH,16,22,17,19,2,38,26,12,28,10,8,3,11,10,2,3,0,1,0,1,18,7,26
20201025,25OCT2020:00:00:00,UFU VELEZ SARSFIELD,14,18,28,4,0,32,30,2,30,2,0,2,7,7,7,5,4,0,0,9,16,5,30
20201025,25OCT2020:00:00:00,UFU ZUBIZARRETA,32,16,33,13,2,48,28,20,46,2,3,2,16,8,8,9,0,2,0,10,9,9,28
20201026,26OCT2020:00:00:00,UFU ALVAREZ,59,49,69,35,4,108,96,12,98,10,7,5,15,30,20,13,13,5,0,17,46,33,96
20201026,26OCT2020:00:00:00,UFU ARGERICH,45,16,38,22,1,61,49,12,51,10,4,4,12,12,10,8,11,0,0,3,27,19,49
20201026,26OCT2020:00:00:00,UFU BORDA-MOYANO,8,7,12,3,0,15,15,0,15,0,0,0,1,8,2,4,0,0,0,3,9,3,15
20201026,26OCT2020:00:00:00,UFU DURAND,29,34,46,17,0,63,55,8,57,6,5,1,8,21,14,9,3,2,0,22,30,3,55
20201026,26OCT2020:00:00:00,UFU ELIZALDE,30,32,27,35,0,62,46,16,54,8,31,11,2,2,9,6,1,0,0,2,38,6,46
20201026,26OCT2020:00:00:00,UFU FERNANDEZ,28,18,37,9,0,46,36,10,40,6,0,2,8,14,9,4,6,3,0,8,21,7,36
20201026,26OCT2020:00:00:00,UFU FERRER,36,22,33,25,0,58,52,6,52,6,0,2,10,20,8,14,2,2,0,14,33,5,52
20201026,26OCT2020:00:00:00,UFU GRIERSON,27,37,45,18,1,64,64,0,64,0,3,6,15,16,9,8,6,1,0,10,46,8,64
20201026,26OCT2020:00:00:00,UFU GUTIERREZ,51,24,28,47,0,75,71,4,75,0,18,12,16,14,6,8,1,0,0,2,57,12,71
20201026,26OCT2020:00:00:00,UFU MUÑIZ,123,128,123,125,3,251,141,110,151,100,7,5,57,57,63,41,15,6,0,23,97,21,141
20201026,26OCT2020:00:00:00,UFU PENNA,8,13,8,13,0,21,15,6,21,0,0,1,7,3,5,2,3,0,0,4,11,0,15
20201026,26OCT2020:00:00:00,UFU PIROVANO,35,35,55,15,0,70,66,4,68,2,2,0,11,16,20,10,5,6,0,6,44,16,66
20201026,26OCT2020:00:00:00,UFU PIÑERO,25,13,20,16,2,38,34,4,38,0,1,1,7,7,6,5,7,4,0,5,27,2,34
20201026,26OCT2020:00:00:00,UFU RAMOS MEJIA,23,21,28,14,2,44,40,4,40,4,4,3,10,9,5,9,3,1,0,10,22,8,40
20201026,26OCT2020:00:00:00,UFU RIVADAVIA,39,19,34,24,0,58,22,36,22,36,0,1,11,14,6,14,6,6,0,3,19,0,22
20201026,26OCT2020:00:00:00,UFU SANTOJANNI,28,26,35,19,0,54,46,8,50,4,0,1,13,16,6,9,4,5,0,12,32,2,46
20201026,26OCT2020:00:00:00,UFU TORNU,44,11,44,9,2,55,51,4,51,4,2,1,6,14,18,8,4,2,0,7,32,12,51
20201026,26OCT2020:00:00:00,UFU VELEZ SARSFIELD,43,22,54,11,0,65,65,0,65,0,0,0,10,17,13,16,7,2,0,5,42,18,65
20201026,26OCT2020:00:00:00,UFU ZUBIZARRETA,16,20,18,17,1,36,26,10,28,8,6,3,8,7,4,3,2,3,0,6,20,0,26
20201027,27OCT2020:00:00:00,UFU ALVAREZ,24,37,46,13,2,61,53,8,57,4,2,2,15,10,12,5,13,2,0,11,33,9,53
20201027,27OCT2020:00:00:00,UFU ARGERICH,31,30,38,22,1,61,33,28,33,28,0,4,15,16,12,8,2,4,0,9,17,7,33
20201027,27OCT2020:00:00:00,UFU BORDA-MOYANO,10,11,15,5,1,21,21,0,21,0,0,0,6,10,1,2,2,0,0,1,13,7,21
20201027,27OCT2020:00:00:00,UFU DURAND,22,23,36,9,0,45,45,0,45,0,3,2,7,13,7,7,4,2,0,11,27,7,45
20201027,27OCT2020:00:00:00,UFU ELIZALDE,44,28,29,43,0,72,58,14,70,2,38,18,8,4,4,0,0,0,0,4,42,12,58
20201027,27OCT2020:00:00:00,UFU FERNANDEZ,41,21,43,19,0,62,38,24,60,2,0,1,16,12,10,12,5,6,0,6,27,5,38
20201027,27OCT2020:00:00:00,UFU FERRER,26,33,24,35,0,59,57,2,57,2,0,1,22,16,6,12,2,0,0,12,38,7,57
20201027,27OCT2020:00:00:00,UFU GRIERSON,46,29,36,39,0,75,73,2,73,2,5,3,22,24,14,4,3,0,0,8,36,29,73
20201027,27OCT2020:00:00:00,UFU GUTIERREZ,49,24,44,29,0,73,67,6,73,0,17,15,10,20,6,4,1,0,0,1,49,17,67
20201027,27OCT2020:00:00:00,UFU MUÑIZ,105,97,115,87,0,202,106,96,110,92,7,9,52,48,38,29,9,10,0,12,76,18,106
20201027,27OCT2020:00:00:00,UFU PENNA,10,19,15,14,0,29,15,14,29,0,0,0,6,6,3,3,8,3,0,1,14,0,15
20201027,27OCT2020:00:00:00,UFU PIROVANO,21,15,22,10,4,36,34,2,34,2,0,0,4,14,7,6,2,3,0,3,26,5,34
20201027,27OCT2020:00:00:00,UFU PIÑERO,23,21,28,13,3,44,42,2,44,0,0,3,13,17,4,4,1,2,0,7,29,6,42
20201027,27OCT2020:00:00:00,UFU RAMOS MEJIA,23,13,19,17,0,36,32,4,32,4,2,0,11,8,4,3,5,3,0,15,13,4,32
20201027,27OCT2020:00:00:00,UFU RIVADAVIA,27,30,27,26,4,57,53,4,53,4,0,2,15,13,15,7,2,3,0,7,39,5,53
20201027,27OCT2020:00:00:00,UFU SANTOJANNI,26,21,25,22,0,47,47,0,47,0,0,1,5,14,13,7,6,1,0,9,34,4,47
20201027,27OCT2020:00:00:00,UFU TORNU,41,40,61,18,2,81,73,8,75,6,5,3,26,21,19,4,3,0,0,7,35,31,73
20201027,27OCT2020:00:00:00,UFU VELEZ SARSFIELD,33,29,40,22,0,62,60,2,60,2,0,0,26,9,14,8,4,1,0,6,40,14,60
20201027,27OCT2020:00:00:00,UFU ZUBIZARRETA,20,16,11,25,0,36,30,6,34,2,4,2,2,7,9,4,5,3,0,11,19,0,30
20201028,28OCT2020:00:00:00,UFU ALVAREZ,46,30,65,11,0,76,72,4,72,4,8,1,22,16,13,10,4,2,0,8,55,9,72
20201028,28OCT2020:00:00:00,UFU ARGERICH,29,20,21,28,0,49,39,10,39,10,2,2,14,1,10,14,5,1,0,8,21,10,39
20201028,28OCT2020:00:00:00,UFU BORDA-MOYANO,15,4,7,10,2,19,19,0,19,0,0,0,3,4,2,4,4,2,0,3,13,3,19
20201028,28OCT2020:00:00:00,UFU DURAND,37,30,51,16,0,67,59,8,59,8,7,2,13,17,14,8,4,2,0,13,37,9,59
20201028,28OCT2020:00:00:00,UFU ELIZALDE,33,21,19,33,2,54,46,8,50,4,31,10,4,7,1,1,0,0,0,2,38,6,46
20201028,28OCT2020:00:00:00,UFU FERNANDEZ,33,18,29,22,0,51,37,14,49,2,0,1,10,16,11,11,1,1,0,7,22,8,37
20201028,28OCT2020:00:00:00,UFU FERRER,27,19,23,23,0,46,40,6,40,6,0,0,8,21,11,3,2,1,0,11,25,4,40
20201028,28OCT2020:00:00:00,UFU GRIERSON,35,37,37,35,0,72,70,2,70,2,1,1,17,19,18,13,3,0,0,9,56,5,70
20201028,28OCT2020:00:00:00,UFU GUTIERREZ,34,32,45,21,0,66,62,4,66,0,21,9,11,12,6,5,2,0,0,0,47,15,62
20201028,28OCT2020:00:00:00,UFU MUÑIZ,110,122,91,136,5,232,134,98,142,90,7,6,61,62,51,26,11,8,0,18,97,19,134
20201028,28OCT2020:00:00:00,UFU PENNA,13,11,14,8,2,24,22,2,24,0,0,0,1,7,3,4,7,2,0,2,12,8,22
20201028,28OCT2020:00:00:00,UFU PIROVANO,29,23,41,7,4,52,46,6,48,4,0,2,12,9,5,9,6,9,0,2,36,8,46
20201028,28OCT2020:00:00:00,UFU PIÑERO,14,19,21,7,5,33,31,2,31,2,0,1,6,8,7,7,3,1,0,5,25,1,31
20201028,28OCT2020:00:00:00,UFU RAMOS MEJIA,44,32,58,18,0,76,68,8,72,4,5,7,14,23,8,11,6,2,0,7,51,10,68
20201028,28OCT2020:00:00:00,UFU RIVADAVIA,44,27,40,27,4,71,57,14,61,10,0,0,23,21,9,7,8,3,0,1,44,12,57
20201028,28OCT2020:00:00:00,UFU SANTOJANNI,35,30,42,23,0,65,61,4,61,4,1,7,12,11,11,9,4,10,0,9,44,8,61
20201028,28OCT2020:00:00:00,UFU TORNU,19,25,34,10,0,44,40,4,40,4,0,1,7,17,6,10,3,0,0,11,22,7,40
20201028,28OCT2020:00:00:00,UFU VELEZ SARSFIELD,19,7,20,6,0,26,26,0,26,0,0,0,9,4,5,3,3,2,0,3,21,2,26
20201028,28OCT2020:00:00:00,UFU ZUBIZARRETA,14,9,20,2,1,23,21,2,23,0,0,0,5,5,6,1,3,3,0,6,12,3,21
20201029,29OCT2020:00:00:00,UFU ALVAREZ,45,47,60,30,2,92,86,6,88,4,3,4,21,30,17,12,4,1,0,7,53,26,86
20201029,29OCT2020:00:00:00,UFU ARGERICH,38,23,34,23,4,61,41,20,41,20,3,8,13,16,9,8,2,2,0,6,20,15,41
20201029,29OCT2020:00:00:00,UFU BORDA-MOYANO,16,23,27,10,2,39,39,0,39,0,0,3,10,4,8,10,4,0,0,0,21,18,39
20201029,29OCT2020:00:00:00,UFU DURAND,21,28,44,5,0,49,45,4,45,4,2,1,9,19,10,5,1,2,0,11,16,18,45
20201029,29OCT2020:00:00:00,UFU ELIZALDE,27,15,14,28,0,42,34,8,38,4,21,9,9,2,0,0,1,0,0,1,23,10,34
20201029,29OCT2020:00:00:00,UFU FERNANDEZ,36,45,48,32,1,81,43,38,81,0,0,0,13,40,6,12,7,3,0,7,28,8,43
20201029,29OCT2020:00:00:00,UFU FERRER,18,26,14,29,1,44,42,2,42,2,0,0,17,16,6,2,3,0,0,15,13,14,42
20201029,29OCT2020:00:00:00,UFU GRIERSON,46,25,32,39,0,71,67,4,67,4,0,2,18,11,13,20,4,3,0,12,51,4,67
20201029,29OCT2020:00:00:00,UFU GUTIERREZ,30,15,26,18,1,45,45,0,45,0,7,6,7,17,4,2,1,1,0,6,24,15,45
20201029,29OCT2020:00:00:00,UFU MUÑIZ,190,196,162,214,10,386,276,110,292,94,8,13,99,118,72,43,20,13,0,21,140,115,276
20201029,29OCT2020:00:00:00,UFU PENNA,14,11,16,9,0,25,21,4,23,2,0,0,8,8,1,4,2,2,0,7,9,5,21
20201029,29OCT2020:00:00:00,UFU PIROVANO,19,18,31,6,0,37,33,4,37,0,0,2,7,11,10,4,2,1,0,4,19,9,33
20201029,29OCT2020:00:00:00,UFU PIÑERO,13,20,15,14,4,33,27,6,31,2,0,1,7,7,7,9,1,1,0,2,19,6,27
20201029,29OCT2020:00:00:00,UFU RAMOS MEJIA,33,24,42,14,1,57,55,2,55,2,7,3,12,9,9,5,7,5,0,16,27,12,55
20201029,29OCT2020:00:00:00,UFU RIVADAVIA,52,26,46,26,6,78,76,2,76,2,0,0,14,31,22,7,2,2,0,9,54,12,76
20201029,29OCT2020:00:00:00,UFU SANTOJANNI,37,36,44,29,0,73,65,8,69,4,1,3,18,14,17,7,6,7,0,9,51,5,65
20201029,29OCT2020:00:00:00,UFU TORNU,36,28,54,8,2,64,56,8,62,2,0,6,19,18,12,3,5,1,0,11,31,14,56
20201029,29OCT2020:00:00:00,UFU VELEZ SARSFIELD,41,39,56,24,0,80,74,6,76,4,0,0,32,15,17,7,8,1,0,10,50,14,74
20201029,29OCT2020:00:00:00,UFU ZUBIZARRETA,11,4,12,3,0,15,11,4,11,4,0,0,3,4,1,4,2,1,0,5,5,1,11
20201030,30OCT2020:00:00:00,UFU ALVAREZ,40,29,51,16,2,69,59,10,61,8,1,1,17,22,10,9,7,2,0,15,33,11,59
20201030,30OCT2020:00:00:00,UFU ARGERICH,25,24,20,21,8,49,25,24,25,24,3,3,13,13,3,8,3,3,0,3,15,7,25
20201030,30OCT2020:00:00:00,UFU BORDA-MOYANO,8,9,7,10,0,17,15,2,15,2,0,0,2,6,3,1,0,5,0,3,8,4,15
20201030,30OCT2020:00:00:00,UFU DURAND,38,25,51,10,2,63,57,6,57,6,2,1,8,27,8,11,6,0,0,14,36,7,57
20201030,30OCT2020:00:00:00,UFU ELIZALDE,27,19,12,34,0,46,30,16,46,0,17,16,3,1,5,2,1,1,0,1,21,8,30
20201030,30OCT2020:00:00:00,UFU FERNANDEZ,36,29,48,16,1,65,61,4,61,4,0,0,17,20,11,9,7,1,0,6,45,10,61
20201030,30OCT2020:00:00:00,UFU FERRER,18,25,19,24,0,43,35,8,35,8,0,2,10,10,10,6,5,0,0,7,20,8,35
20201030,30OCT2020:00:00:00,UFU GRIERSON,43,39,44,38,0,82,74,8,74,8,1,7,18,20,21,6,5,4,0,15,54,5,74
20201030,30OCT2020:00:00:00,UFU GUTIERREZ,20,16,29,7,0,36,30,6,36,0,4,5,10,9,6,2,0,0,0,1,25,3,30
20201030,30OCT2020:00:00:00,UFU MUÑIZ,148,175,142,168,13,323,161,162,181,142,5,6,91,90,59,40,22,10,0,16,130,15,161
20201030,30OCT2020:00:00:00,UFU PENNA,13,11,13,11,0,24,14,10,16,8,0,0,3,8,2,7,4,0,0,3,8,3,14
20201030,30OCT2020:00:00:00,UFU PIROVANO,45,25,52,16,2,70,66,4,68,2,3,2,12,26,9,8,8,2,0,6,51,9,66
20201030,30OCT2020:00:00:00,UFU PIÑERO,20,14,21,10,3,34,30,4,30,4,0,0,12,11,3,5,2,1,0,7,21,2,30
20201030,30OCT2020:00:00:00,UFU RAMOS MEJIA,24,28,39,8,5,52,48,4,52,0,0,1,12,9,16,9,4,1,0,3,33,12,48
20201030,30OCT2020:00:00:00,UFU RIVADAVIA,29,32,34,24,3,61,57,4,57,4,0,0,19,16,18,5,1,2,0,3,50,4,57
20201030,30OCT2020:00:00:00,UFU SANTOJANNI,36,21,28,29,0,57,48,9,50,7,4,0,10,12,16,8,7,0,0,4,44,0,48
20201030,30OCT2020:00:00:00,UFU TORNU,23,17,36,4,0,40,30,10,40,0,0,0,10,13,7,4,3,3,0,3,20,6,30
20201030,30OCT2020:00:00:00,UFU VELEZ SARSFIELD,16,20,30,6,0,36,32,4,34,2,0,2,12,10,4,2,3,3,0,4,21,7,32
20201030,30OCT2020:00:00:00,UFU ZUBIZARRETA,12,7,7,12,0,19,13,6,13,6,0,0,5,6,2,0,5,1,0,3,7,3,13
20201031,31OCT2020:00:00:00,UFU ALVAREZ,32,18,35,15,0,50,44,6,44,6,1,3,11,10,11,5,7,2,0,6,31,7,44
20201031,31OCT2020:00:00:00,UFU BORDA-MOYANO,25,10,31,4,0,35,33,2,33,2,0,0,6,4,9,3,4,9,0,1,25,7,33
20201031,31OCT2020:00:00:00,UFU DURAND,23,13,32,4,0,36,34,2,34,2,0,2,13,2,6,5,4,4,0,10,20,4,34
20201031,31OCT2020:00:00:00,UFU ELIZALDE,28,27,16,39,0,55,41,14,49,6,29,9,5,9,3,0,0,0,0,2,22,17,41
20201031,31OCT2020:00:00:00,UFU FERNANDEZ,16,9,20,5,0,25,23,2,23,2,0,0,11,2,6,3,3,0,0,0,19,4,23
20201031,31OCT2020:00:00:00,UFU FERRER,19,26,23,20,2,45,41,4,41,4,2,0,12,10,13,5,1,2,0,9,29,3,41
20201031,31OCT2020:00:00:00,UFU GRIERSON,24,32,30,21,5,56,48,8,52,4,1,6,13,18,5,9,4,0,0,15,31,2,48
20201031,31OCT2020:00:00:00,UFU GUTIERREZ,28,19,27,20,0,47,33,14,43,4,16,3,5,15,2,6,0,0,0,0,30,3,33
20201031,31OCT2020:00:00:00,UFU MUÑIZ,109,135,136,101,7,244,84,160,148,96,11,6,72,76,38,22,12,7,0,6,70,8,84
20201031,31OCT2020:00:00:00,UFU PENNA,16,10,11,15,0,26,24,2,24,2,0,0,7,9,3,4,2,1,0,4,16,4,24
20201031,31OCT2020:00:00:00,UFU PIROVANO,7,9,12,2,2,16,16,0,16,0,1,0,5,6,3,1,0,0,0,3,10,3,16
20201031,31OCT2020:00:00:00,UFU PIÑERO,20,19,33,6,0,39,34,5,34,5,0,2,12,8,6,8,2,1,0,6,17,10,34
20201031,31OCT2020:00:00:00,UFU RAMOS MEJIA,19,12,26,5,0,31,29,2,31,0,1,3,6,7,8,3,3,0,0,8,14,7,29
20201031,31OCT2020:00:00:00,UFU RIVADAVIA,35,21,43,13,0,56,54,2,54,2,0,0,15,15,9,7,8,2,0,10,36,7,54
20201031,31OCT2020:00:00:00,UFU SANTOJANNI,14,20,21,13,0,34,30,4,32,2,0,0,6,10,6,7,3,2,0,6,22,2,30
20201031,31OCT2020:00:00:00,UFU TORNU,15,10,8,15,2,25,23,2,23,2,1,6,3,3,10,1,0,1,0,3,17,3,23
20201031,31OCT2020:00:00:00,UFU VELEZ SARSFIELD,21,12,22,11,0,33,31,2,31,2,0,0,10,8,4,8,0,3,0,8,17,6,31
20201031,31OCT2020:00:00:00,UFU ZUBIZARRETA,35,29,43,21,0,64,34,30,40,24,2,0,15,17,21,4,4,1,0,4,29,1,34
20201101,01NOV2020:00:00:00,UFU ALVAREZ,13,33,37,7,2,46,46,0,46,0,3,0,19,12,4,4,3,1,0,4,13,29,46
20201101,01NOV2020:00:00:00,UFU BORDA-MOYANO,1,8,9,0,0,9,9,0,9,0,0,0,2,0,0,0,4,3,0,0,5,4,9
20201101,01NOV2020:00:00:00,UFU DURAND,21,14,29,6,0,35,33,2,33,2,2,4,9,10,4,2,1,3,0,12,19,2,33
20201101,01NOV2020:00:00:00,UFU ELIZALDE,33,21,16,38,0,54,28,26,48,6,30,10,0,6,5,3,0,0,0,1,20,7,28
20201101,01NOV2020:00:00:00,UFU FERNANDEZ,11,8,18,1,0,19,9,10,19,0,0,0,0,8,3,2,2,4,0,2,2,5,9
20201101,01NOV2020:00:00:00,UFU FERRER,12,15,18,9,0,27,23,4,23,4,2,0,7,8,3,3,3,1,0,5,17,1,23
20201101,01NOV2020:00:00:00,UFU GRIERSON,8,19,11,14,2,27,23,4,25,2,0,2,4,7,8,4,1,1,0,4,16,3,23
20201101,01NOV2020:00:00:00,UFU GUTIERREZ,22,11,16,17,0,33,33,0,33,0,12,4,5,8,4,0,0,0,0,4,26,3,33
20201101,01NOV2020:00:00:00,UFU MUÑIZ,65,71,64,70,2,136,58,78,82,54,9,1,43,33,26,14,9,1,0,10,41,7,58
20201101,01NOV2020:00:00:00,UFU PENNA,11,5,8,8,0,16,14,2,14,2,0,4,4,4,1,2,1,0,0,3,7,4,14
20201101,01NOV2020:00:00:00,UFU PIROVANO,8,6,11,3,0,14,14,0,14,0,0,1,1,8,2,2,0,0,0,0,14,0,14
20201101,01NOV2020:00:00:00,UFU PIÑERO,12,11,11,12,0,23,19,4,21,2,0,0,11,1,5,3,3,0,0,1,14,4,19
20201101,01NOV2020:00:00:00,UFU RAMOS MEJIA,6,14,12,7,1,20,18,2,20,0,0,2,9,4,5,0,0,0,0,4,10,4,18
20201101,01NOV2020:00:00:00,UFU RIVADAVIA,23,22,35,10,0,45,41,4,41,4,4,0,9,8,11,7,6,0,0,10,23,8,41
20201101,01NOV2020:00:00:00,UFU SANTOJANNI,15,19,21,13,0,34,34,0,34,0,0,0,10,13,5,2,3,1,0,8,25,1,34
20201101,01NOV2020:00:00:00,UFU TORNU,16,8,11,13,0,24,22,2,22,2,0,1,7,6,8,2,0,0,0,4,13,5,22
20201101,01NOV2020:00:00:00,UFU VELEZ SARSFIELD,23,12,25,10,0,35,33,2,33,2,0,0,13,6,6,4,1,5,0,11,20,2,33
20201101,01NOV2020:00:00:00,UFU ZUBIZARRETA,31,24,42,13,0,55,35,20,43,12,4,8,8,9,12,6,4,4,0,10,22,3,35
20201102,02NOV2020:00:00:00,UFU ALVAREZ,81,55,97,37,2,136,136,0,136,0,4,6,24,36,29,23,10,4,0,10,46,80,136
20201102,02NOV2020:00:00:00,UFU ARGERICH,23,40,42,19,2,63,45,18,45,18,1,2,19,9,15,6,6,5,0,8,27,10,45
20201102,02NOV2020:00:00:00,UFU BORDA-MOYANO,10,9,14,5,0,19,19,0,19,0,0,0,1,1,11,4,2,0,0,0,11,8,19
20201102,02NOV2020:00:00:00,UFU DURAND,31,29,47,13,0,60,58,2,58,2,1,2,13,12,12,6,11,3,0,18,33,7,58
20201102,02NOV2020:00:00:00,UFU ELIZALDE,27,27,5,49,0,54,34,20,42,12,30,9,4,2,6,2,1,0,0,0,32,2,34
20201102,02NOV2020:00:00:00,UFU FERNANDEZ,27,43,51,18,1,70,40,30,62,8,0,2,27,13,10,12,4,2,0,6,26,8,40
20201102,02NOV2020:00:00:00,UFU FERRER,31,18,29,20,0,49,43,6,45,4,0,0,15,16,9,7,0,2,0,11,27,5,43
20201102,02NOV2020:00:00:00,UFU GRIERSON,40,34,48,26,0,74,72,2,72,2,3,4,21,13,17,8,8,0,0,9,60,3,72
20201102,02NOV2020:00:00:00,UFU GUTIERREZ,54,32,37,49,0,86,84,2,86,0,25,23,9,14,9,6,0,0,0,4,57,22,84
20201102,02NOV2020:00:00:00,UFU MUÑIZ,164,147,160,142,9,311,185,126,199,112,2,12,68,77,46,78,16,12,0,20,112,53,185
20201102,02NOV2020:00:00:00,UFU PENNA,18,14,23,7,2,32,28,4,28,4,0,0,3,7,11,6,4,1,0,2,21,5,28
20201102,02NOV2020:00:00:00,UFU PIROVANO,10,17,17,10,0,27,21,6,27,0,2,0,2,2,5,6,4,6,0,1,15,5,21
20201102,02NOV2020:00:00:00,UFU PIÑERO,39,35,48,22,4,74,56,18,60,14,0,5,14,19,11,10,7,8,0,12,37,7,56
20201102,02NOV2020:00:00:00,UFU RAMOS MEJIA,24,31,44,11,0,55,47,8,53,2,3,2,14,15,11,4,3,3,0,13,27,7,47
20201102,02NOV2020:00:00:00,UFU RIVADAVIA,66,44,53,36,21,110,54,56,56,54,0,4,29,37,18,13,5,4,0,8,31,14,54
20201102,02NOV2020:00:00:00,UFU SANTOJANNI,33,27,30,26,4,60,52,8,54,6,0,2,9,13,12,11,6,7,0,4,44,4,52
20201102,02NOV2020:00:00:00,UFU TORNU,29,28,38,19,0,57,47,10,47,10,2,4,17,12,8,8,1,5,0,4,37,5,47
20201102,02NOV2020:00:00:00,UFU VELEZ SARSFIELD,22,18,27,11,2,40,36,4,40,0,0,1,14,8,6,4,5,2,0,7,25,4,36
20201102,02NOV2020:00:00:00,UFU ZUBIZARRETA,10,11,10,11,0,21,19,2,21,0,0,0,3,1,10,3,2,2,0,1,17,1,19
20201103,03NOV2020:00:00:00,UFU ALVAREZ,77,48,79,40,6,125,115,10,117,8,4,4,28,31,20,25,9,4,0,4,23,88,115
20201103,03NOV2020:00:00:00,UFU ARGERICH,38,35,39,28,6,73,57,16,59,14,8,0,16,30,8,5,4,2,0,4,9,44,57
20201103,03NOV2020:00:00:00,UFU BORDA-MOYANO,12,2,6,7,1,14,14,0,14,0,0,0,2,7,3,0,2,0,0,0,11,3,14
20201103,03NOV2020:00:00:00,UFU DURAND,22,24,40,6,0,46,46,0,46,0,2,4,9,15,6,8,2,0,0,8,35,3,46
20201103,03NOV2020:00:00:00,UFU ELIZALDE,33,32,32,33,0,65,51,14,59,6,33,17,4,8,3,0,0,0,0,3,41,7,51
20201103,03NOV2020:00:00:00,UFU FERNANDEZ,30,36,41,25,0,66,56,10,66,0,0,2,23,18,12,6,4,1,0,6,41,9,56
20201103,03NOV2020:00:00:00,UFU FERRER,22,14,17,19,0,36,32,4,32,4,0,0,8,12,6,8,2,0,0,6,21,5,32
20201103,03NOV2020:00:00:00,UFU GRIERSON,33,47,49,29,2,80,80,0,80,0,2,3,24,22,18,7,4,0,0,10,59,10,80
20201103,03NOV2020:00:00:00,UFU GUTIERREZ,55,34,47,42,0,89,81,8,89,0,29,10,15,23,7,2,1,2,0,4,57,19,81
20201103,03NOV2020:00:00:00,UFU MUÑIZ,121,141,124,129,9,262,138,124,154,108,5,11,70,60,44,44,16,12,0,17,106,15,138
20201103,03NOV2020:00:00:00,UFU PENNA,19,13,18,14,0,32,24,8,26,6,0,3,1,5,11,4,8,0,0,3,18,3,24
20201103,03NOV2020:00:00:00,UFU PIROVANO,18,19,23,14,0,37,35,2,37,0,0,0,2,10,13,3,3,6,0,2,30,3,35
20201103,03NOV2020:00:00:00,UFU PIÑERO,25,29,40,14,0,54,38,16,40,14,2,4,14,11,16,4,2,1,0,9,25,4,38
20201103,03NOV2020:00:00:00,UFU RAMOS MEJIA,26,14,31,9,0,40,36,4,36,4,1,3,13,4,11,4,4,0,0,5,17,13,36
20201103,03NOV2020:00:00:00,UFU RIVADAVIA,29,34,38,25,0,63,53,10,53,10,0,0,26,13,7,9,5,3,0,3,43,7,53
20201103,03NOV2020:00:00:00,UFU SANTOJANNI,28,27,36,18,1,55,49,6,51,4,4,1,15,11,8,8,7,1,0,6,40,3,49
20201103,03NOV2020:00:00:00,UFU TORNU,34,31,44,17,4,65,57,8,57,8,0,4,16,17,12,11,2,3,0,4,35,18,57
20201103,03NOV2020:00:00:00,UFU VELEZ SARSFIELD,38,17,45,10,0,55,55,0,55,0,2,1,7,18,14,5,6,2,0,4,32,19,55
20201103,03NOV2020:00:00:00,UFU ZUBIZARRETA,16,13,22,7,0,29,23,6,27,2,2,1,4,9,5,3,4,1,0,4,19,0,23
20201104,04NOV2020:00:00:00,UFU ALVAREZ,69,51,83,37,0,120,118,2,118,2,3,2,24,23,26,15,10,17,0,11,65,42,118
20201104,04NOV2020:00:00:00,UFU ARGERICH,35,31,35,25,6,66,52,14,54,12,0,2,30,12,13,4,4,1,0,5,25,22,52
20201104,04NOV2020:00:00:00,UFU BORDA-MOYANO,19,10,12,15,2,29,27,2,27,2,0,2,0,9,14,4,0,0,0,0,16,11,27
20201104,04NOV2020:00:00:00,UFU DURAND,38,37,53,21,1,75,73,2,73,2,7,0,15,18,22,9,3,1,0,19,32,22,73
20201104,04NOV2020:00:00:00,UFU ELIZALDE,55,28,27,56,0,83,45,38,71,12,29,20,5,12,11,6,0,0,0,1,29,15,45
20201104,04NOV2020:00:00:00,UFU FERNANDEZ,48,54,91,11,0,102,48,54,92,10,0,1,42,26,11,11,7,4,0,9,23,16,48
20201104,04NOV2020:00:00:00,UFU FERRER,16,15,17,14,0,31,29,2,29,2,0,0,6,12,5,2,6,0,0,4,17,8,29
20201104,04NOV2020:00:00:00,UFU GRIERSON,33,29,30,27,5,62,62,0,62,0,2,4,16,14,13,7,5,1,0,5,51,5,62
20201104,04NOV2020:00:00:00,UFU GUTIERREZ,62,20,53,29,0,82,78,4,78,4,26,20,5,19,6,4,2,0,0,3,48,27,78
20201104,04NOV2020:00:00:00,UFU MUÑIZ,144,198,147,181,14,342,168,174,178,164,6,11,112,77,46,58,26,6,0,9,92,67,168
20201104,04NOV2020:00:00:00,UFU PENNA,10,14,13,11,0,24,24,0,24,0,0,0,4,10,4,2,3,1,0,6,15,3,24
20201104,04NOV2020:00:00:00,UFU PIROVANO,59,39,78,20,0,98,96,2,96,2,0,0,27,28,16,16,2,9,0,6,47,42,96
20201104,04NOV2020:00:00:00,UFU PIÑERO,51,39,57,32,1,90,76,14,84,6,2,2,24,29,13,13,5,2,0,6,39,31,76
20201104,04NOV2020:00:00:00,UFU RAMOS MEJIA,40,30,51,19,0,70,70,0,70,0,4,2,25,14,10,9,2,4,0,6,40,24,70
20201104,04NOV2020:00:00:00,UFU RIVADAVIA,51,50,59,36,6,101,85,16,89,12,0,5,32,29,12,12,7,4,0,8,56,20,85
20201104,04NOV2020:00:00:00,UFU SANTOJANNI,29,23,25,27,0,52,50,2,52,0,2,1,8,17,12,5,5,2,0,8,36,6,50
20201104,04NOV2020:00:00:00,UFU TORNU,36,34,41,27,2,70,68,2,68,2,2,5,17,21,17,2,3,3,0,9,29,30,68
20201104,04NOV2020:00:00:00,UFU VELEZ SARSFIELD,33,16,36,13,0,49,49,0,49,0,0,0,15,14,8,10,2,0,0,4,31,14,49
20201104,04NOV2020:00:00:00,UFU ZUBIZARRETA,20,12,20,12,0,32,28,4,30,2,3,1,8,10,5,5,0,0,0,3,22,3,28
20201105,05NOV2020:00:00:00,UFU ALVAREZ,31,33,49,15,0,64,62,2,62,2,0,6,12,12,11,11,5,7,0,7,42,13,62
20201105,05NOV2020:00:00:00,UFU ARGERICH,26,20,34,12,0,46,32,14,34,12,3,0,9,14,8,5,3,4,0,4,22,6,32
20201105,05NOV2020:00:00:00,UFU BORDA-MOYANO,5,17,18,4,0,22,22,0,22,0,0,0,3,12,5,0,2,0,0,0,15,7,22
20201105,05NOV2020:00:00:00,UFU DURAND,36,14,43,5,2,50,44,6,44,6,3,3,5,21,11,2,5,0,0,8,33,3,44
20201105,05NOV2020:00:00:00,UFU ELIZALDE,47,22,14,53,2,69,49,20,61,8,40,13,6,4,3,2,1,0,0,0,40,9,49
20201105,05NOV2020:00:00:00,UFU FERNANDEZ,32,51,71,8,4,83,43,40,81,2,0,4,32,22,13,6,4,2,0,9,28,6,43
20201105,05NOV2020:00:00:00,UFU FERRER,17,30,27,20,0,47,45,2,45,2,0,0,16,17,7,4,3,0,0,10,28,7,45
20201105,05NOV2020:00:00:00,UFU GRIERSON,13,29,20,21,1,42,40,2,40,2,3,2,6,19,5,4,2,1,0,6,28,6,40
20201105,05NOV2020:00:00:00,UFU GUTIERREZ,71,39,83,27,0,110,84,26,88,22,17,19,21,30,18,4,1,0,0,2,58,24,84
20201105,05NOV2020:00:00:00,UFU MUÑIZ,119,160,127,142,10,279,151,128,175,104,4,14,66,76,60,38,15,6,0,16,111,24,151
20201105,05NOV2020:00:00:00,UFU PENNA,4,1,3,2,0,5,5,0,5,0,0,0,0,2,2,1,0,0,0,1,4,0,5
20201105,05NOV2020:00:00:00,UFU PIROVANO,34,13,40,7,0,47,45,2,45,2,0,4,7,14,11,10,0,1,0,6,30,9,45
20201105,05NOV2020:00:00:00,UFU PIÑERO,37,29,38,28,0,66,46,20,56,10,1,6,21,13,7,11,7,0,0,6,34,6,46
20201105,05NOV2020:00:00:00,UFU RAMOS MEJIA,13,30,33,9,1,43,39,4,43,0,0,0,13,12,4,9,4,1,0,9,20,10,39
20201105,05NOV2020:00:00:00,UFU RIVADAVIA,62,42,52,40,12,104,102,2,102,2,0,0,46,25,10,14,5,4,0,12,72,17,102
20201105,05NOV2020:00:00:00,UFU SANTOJANNI,33,25,28,28,2,58,50,8,54,4,1,3,17,5,11,11,4,6,0,4,42,4,50
20201105,05NOV2020:00:00:00,UFU TORNU,30,29,40,19,0,59,47,12,49,10,0,2,14,19,11,11,1,1,0,5,35,7,47
20201209,09DEC2020:00:00:00,UFU PIÑERO,41,36,60,15,2,77,65,12,65,12,8,3,16,17,8,13,8,4,0,6,47,3,65
20201209,09DEC2020:00:00:00,UFU RAMOS MEJIA,19,14,23,8,2,33,31,2,33,0,0,2,9,10,3,5,0,4,0,5,23,3,31
20201209,09DEC2020:00:00:00,UFU RIVADAVIA,123,113,182,49,5,236,190,46,196,40,0,0,81,83,36,22,6,8,0,14,132,44,190
20201209,09DEC2020:00:00:00,UFU SANTOJANNI,35,40,38,35,2,75,69,6,69,6,0,4,18,15,12,16,6,4,0,15,46,8,69
20201209,09DEC2020:00:00:00,UFU TORNU,40,26,50,16,0,66,58,8,58,8,0,0,21,16,16,7,1,5,0,3,21,34,58
20201209,09DEC2020:00:00:00,UFU VELEZ SARSFIELD,23,35,46,12,0,58,54,4,54,4,0,1,6,21,15,4,9,2,0,4,44,6,54
20201209,09DEC2020:00:00:00,UFU ZUBIZARRETA,10,14,19,5,0,24,24,0,24,0,0,2,3,5,4,4,5,1,0,1,22,1,24
20201210,10DEC2020:00:00:00,UFU ALVAREZ,90,101,146,45,0,191,175,16,175,16,8,12,57,47,30,22,7,8,0,6,20,149,175
20201210,10DEC2020:00:00:00,UFU ARGERICH,60,48,70,34,4,108,78,30,78,30,3,7,27,17,16,15,16,7,0,3,52,23,78
20201210,10DEC2020:00:00:00,UFU BORDA-MOYANO,8,13,13,8,0,21,19,2,19,2,2,1,4,6,2,2,3,1,0,2,13,4,19
20201210,10DEC2020:00:00:00,UFU DURAND,35,24,56,3,0,59,57,2,57,2,6,3,18,13,11,3,4,1,0,11,41,5,57
20201210,10DEC2020:00:00:00,UFU ELIZALDE,29,35,17,43,4,64,52,12,58,6,35,11,4,10,2,2,0,0,0,0,40,12,52
20201210,10DEC2020:00:00:00,UFU FERNANDEZ,50,46,87,9,0,96,94,2,94,2,0,2,22,38,11,10,6,7,0,17,61,16,94
20201210,10DEC2020:00:00:00,UFU FERRER,30,23,40,13,0,53,49,4,49,4,0,1,17,15,7,7,4,2,0,12,33,4,49
20201210,10DEC2020:00:00:00,UFU GRIERSON,26,31,30,24,3,57,55,2,55,2,0,2,20,11,13,7,2,2,0,1,2,52,55
20201210,10DEC2020:00:00:00,UFU GUTIERREZ,42,18,27,33,0,60,46,14,54,6,28,7,9,8,7,1,0,0,0,1,35,10,46
20201210,10DEC2020:00:00:00,UFU MUÑIZ,196,231,218,194,15,427,193,234,199,228,19,23,107,84,60,74,38,22,0,23,159,11,193
20201210,10DEC2020:00:00:00,UFU PENNA,9,9,11,7,0,18,10,8,12,6,0,1,5,6,4,0,2,0,0,0,9,1,10
20201210,10DEC2020:00:00:00,UFU PIROVANO,49,36,71,14,0,85,81,4,83,2,0,1,30,23,11,8,8,4,0,12,58,11,81
20201210,10DEC2020:00:00:00,UFU PIÑERO,30,31,34,24,3,61,51,10,53,8,0,6,19,20,10,3,3,0,0,6,40,4,51
20201210,10DEC2020:00:00:00,UFU RAMOS MEJIA,23,14,23,14,0,37,27,10,33,4,0,0,8,10,9,7,3,0,0,3,19,5,27
20201210,10DEC2020:00:00:00,UFU RIVADAVIA,133,94,171,51,5,227,203,24,203,24,0,4,69,76,32,20,21,5,0,9,139,54,203
20201210,10DEC2020:00:00:00,UFU SANTOJANNI,28,26,18,32,4,54,38,16,48,6,4,1,19,19,4,7,0,0,0,11,23,4,38
20201210,10DEC2020:00:00:00,UFU TORNU,35,40,54,21,0,75,75,0,75,0,0,2,17,16,15,17,3,5,0,7,54,14,75
20201210,10DEC2020:00:00:00,UFU VELEZ SARSFIELD,22,27,42,7,0,49,45,4,47,2,0,2,8,15,10,7,4,3,0,8,33,4,45
20201210,10DEC2020:00:00:00,UFU ZUBIZARRETA,13,14,23,4,0,27,23,4,23,4,0,0,5,4,5,1,9,3,0,0,20,3,23
20201211,11DEC2020:00:00:00,UFU ALVAREZ,94,80,139,30,5,174,156,18,160,14,20,6,38,47,27,15,8,13,0,8,55,93,156
20201211,11DEC2020:00:00:00,UFU ARGERICH,34,43,51,26,0,77,55,22,55,22,9,2,23,22,13,4,1,3,0,4,41,10,55
20201211,11DEC2020:00:00:00,UFU BORDA-MOYANO,10,5,10,5,0,15,15,0,15,0,0,2,4,5,2,0,2,0,0,1,11,3,15
20201211,11DEC2020:00:00:00,UFU DURAND,31,31,54,8,0,62,60,2,60,2,0,1,15,20,11,5,7,3,0,14,32,14,60
20201211,11DEC2020:00:00:00,UFU ELIZALDE,43,32,13,58,4,75,61,14,65,10,38,13,8,10,0,4,0,2,0,4,42,15,61
20201211,11DEC2020:00:00:00,UFU FERNANDEZ,38,29,55,12,0,67,65,2,65,2,0,1,20,21,6,11,4,4,0,15,42,8,65
20201211,11DEC2020:00:00:00,UFU FERRER,23,27,29,21,0,50,48,2,48,2,0,1,19,9,10,7,0,4,0,3,40,5,48
20201211,11DEC2020:00:00:00,UFU GRIERSON,38,31,44,25,0,69,69,0,69,0,0,4,21,20,12,7,3,2,0,3,16,50,69
20201211,11DEC2020:00:00:00,UFU GUTIERREZ,54,24,54,24,0,78,76,2,76,2,19,17,10,16,7,8,0,1,0,2,53,20,76
20201211,11DEC2020:00:00:00,UFU MUÑIZ,189,200,198,182,9,389,179,210,187,202,1,28,93,84,70,64,37,12,0,8,156,14,179
20201211,11DEC2020:00:00:00,UFU PENNA,11,12,16,3,4,23,15,8,19,4,0,0,12,6,2,3,0,0,0,0,13,2,15
20201211,11DEC2020:00:00:00,UFU PIROVANO,56,45,77,20,4,101,91,10,95,6,0,2,30,31,16,7,11,4,0,12,60,16,91
20201211,11DEC2020:00:00:00,UFU PIÑERO,19,16,19,12,4,35,23,12,23,12,0,3,12,12,6,1,0,1,0,5,17,1,23
20201211,11DEC2020:00:00:00,UFU RAMOS MEJIA,23,15,30,6,2,38,38,0,38,0,2,1,13,5,9,4,3,1,0,4,27,7,38
20201211,11DEC2020:00:00:00,UFU RIVADAVIA,127,110,169,57,11,237,223,14,223,14,0,4,91,68,39,17,14,4,0,21,134,66,223
20201211,11DEC2020:00:00:00,UFU SANTOJANNI,48,41,36,49,4,89,69,20,75,14,8,2,19,22,13,12,9,4,0,9,55,5,69
20201211,11DEC2020:00:00:00,UFU TORNU,32,32,52,12,0,64,60,4,60,4,2,4,5,20,14,7,7,5,0,6,43,11,60
20201211,11DEC2020:00:00:00,UFU VELEZ SARSFIELD,49,32,61,14,6,81,79,2,79,2,0,0,19,24,24,3,7,4,0,8,28,43,79
20201211,11DEC2020:00:00:00,UFU ZUBIZARRETA,25,23,32,16,0,48,48,0,48,0,3,0,16,12,5,5,2,5,0,3,36,9,48
20201212,12DEC2020:00:00:00,UFU ALVAREZ,45,43,64,23,1,88,84,4,84,4,1,3,20,21,17,15,5,6,0,15,56,13,84
20201212,12DEC2020:00:00:00,UFU BORDA-MOYANO,5,2,7,0,0,7,5,2,5,2,0,0,2,2,1,1,1,0,0,0,2,1,5
20201212,12DEC2020:00:00:00,UFU DURAND,23,22,40,5,0,45,45,0,45,0,1,3,13,13,7,5,1,2,0,7,31,7,45
20201212,12DEC2020:00:00:00,UFU ELIZALDE,21,29,25,25,0,50,38,12,46,4,30,11,1,7,1,0,0,0,0,2,28,8,38
20201212,12DEC2020:00:00:00,UFU FERNANDEZ,35,25,52,8,0,60,58,2,58,2,0,3,15,23,2,3,10,4,0,7,38,13,58
20201212,12DEC2020:00:00:00,UFU FERRER,52,33,49,35,1,85,83,2,83,2,0,5,27,13,15,13,9,3,0,14,51,18,83
20201212,12DEC2020:00:00:00,UFU GRIERSON,20,15,18,17,0,35,33,2,35,0,0,0,11,10,9,1,3,1,0,5,23,5,33
20201212,12DEC2020:00:00:00,UFU GUTIERREZ,42,22,29,35,0,64,48,16,58,6,29,5,12,11,5,1,1,0,0,0,40,8,48
20201212,12DEC2020:00:00:00,UFU MUÑIZ,109,144,158,82,13,253,159,94,161,92,5,16,56,61,46,35,28,6,0,6,112,13,159
20201212,12DEC2020:00:00:00,UFU PENNA,12,9,12,9,0,21,21,0,21,0,2,1,2,5,4,3,4,0,0,5,13,1,21
20201212,12DEC2020:00:00:00,UFU PIROVANO,47,39,77,9,0,86,80,6,86,0,4,5,21,15,29,5,4,3,0,6,56,18,80
20201212,12DEC2020:00:00:00,UFU PIÑERO,20,11,16,15,0,31,29,2,29,2,0,3,7,7,3,5,4,2,0,2,25,2,29
20201212,12DEC2020:00:00:00,UFU RAMOS MEJIA,14,16,26,4,0,30,28,2,30,0,2,5,8,7,2,3,3,0,0,5,19,4,28
20201212,12DEC2020:00:00:00,UFU RIVADAVIA,99,69,132,36,0,168,160,8,160,8,0,1,63,48,18,18,12,8,0,13,110,36,160
20201212,12DEC2020:00:00:00,UFU SANTOJANNI,37,40,46,29,2,77,71,6,73,4,2,4,20,18,9,9,6,9,0,13,38,20,71
20201212,12DEC2020:00:00:00,UFU TORNU,34,19,11,31,11,53,51,2,53,0,0,1,14,18,9,9,2,0,0,2,26,23,51
20201212,12DEC2020:00:00:00,UFU VELEZ SARSFIELD,37,46,68,15,0,83,83,0,83,0,0,2,23,22,19,6,7,4,0,7,64,12,83
20201212,12DEC2020:00:00:00,UFU ZUBIZARRETA,36,34,51,18,1,70,60,10,64,6,0,2,22,16,9,5,8,8,0,3,43,14,60
20201213,13DEC2020:00:00:00,UFU ALVAREZ,65,42,80,27,0,107,47,60,47,60,4,7,29,26,12,14,13,2,0,4,31,12,47
20201213,13DEC2020:00:00:00,UFU BORDA-MOYANO,27,1,23,5,0,28,26,2,26,2,0,0,8,3,8,2,4,3,0,0,18,8,26
20201213,13DEC2020:00:00:00,UFU DURAND,25,17,37,5,0,42,40,2,40,2,6,4,10,11,3,4,2,2,0,7,22,11,40
20201213,13DEC2020:00:00:00,UFU ELIZALDE,45,29,22,52,0,74,46,28,62,12,23,29,1,8,10,3,0,0,0,3,34,9,46
20201213,13DEC2020:00:00:00,UFU FERNANDEZ,13,8,18,3,0,21,13,8,21,0,0,0,1,11,4,4,0,1,0,5,6,2,13
20201213,13DEC2020:00:00:00,UFU FERRER,30,20,33,17,0,50,50,0,50,0,0,2,10,7,12,10,6,3,0,10,35,5,50
20201217,17DEC2020:00:00:00,UFU MUÑIZ,325,403,344,368,16,728,378,350,398,330,11,52,265,173,100,73,39,15,0,18,310,50,378
20201217,17DEC2020:00:00:00,UFU PENNA,17,22,23,13,3,39,31,8,35,4,0,0,9,3,12,10,3,2,0,2,23,6,31
20201217,17DEC2020:00:00:00,UFU PIROVANO,109,79,150,36,2,188,178,10,182,6,2,2,54,61,31,13,11,14,0,19,129,30,178
20201217,17DEC2020:00:00:00,UFU PIÑERO,37,28,60,5,0,65,53,12,57,8,2,3,13,20,9,7,10,1,0,15,33,5,53
20201217,17DEC2020:00:00:00,UFU RAMOS MEJIA,34,38,50,21,1,72,62,10,68,4,3,6,14,14,18,7,6,4,0,15,34,13,62
20201217,17DEC2020:00:00:00,UFU RIVADAVIA,218,165,315,61,7,383,345,38,345,38,0,3,119,148,57,27,17,12,0,15,219,109,345
20201217,17DEC2020:00:00:00,UFU SANTOJANNI,74,40,67,47,0,114,106,8,114,0,4,3,19,38,19,13,13,5,0,26,68,12,106
20201217,17DEC2020:00:00:00,UFU TORNU,79,104,147,36,0,183,132,51,132,51,3,8,61,50,25,17,11,8,0,13,86,33,132
20201217,17DEC2020:00:00:00,UFU VELEZ SARSFIELD,86,72,132,26,0,158,154,4,156,2,0,3,44,34,41,21,9,6,0,15,101,38,154
20201217,17DEC2020:00:00:00,UFU ZUBIZARRETA,14,14,21,7,0,28,26,2,28,0,0,0,7,6,6,3,3,3,0,4,21,1,26
20201218,18DEC2020:00:00:00,UFU ALVAREZ,98,74,151,19,2,172,150,22,154,18,7,5,51,36,36,20,13,4,0,19,86,44,150
20201218,18DEC2020:00:00:00,UFU ARGERICH,47,42,56,33,0,89,75,14,75,14,2,6,22,22,15,12,5,5,0,9,52,14,75
20201218,18DEC2020:00:00:00,UFU BORDA-MOYANO,12,16,26,2,0,28,26,2,26,2,0,2,5,7,4,3,6,1,0,0,19,7,26
20201218,18DEC2020:00:00:00,UFU DURAND,40,21,57,4,0,61,61,0,61,0,1,3,9,20,14,5,9,0,0,14,37,10,61
20201218,18DEC2020:00:00:00,UFU ELIZALDE,35,27,19,43,0,62,42,20,52,10,37,9,4,5,5,2,0,0,0,3,29,10,42
20201218,18DEC2020:00:00:00,UFU FERNANDEZ,68,84,126,20,6,152,146,6,146,6,2,8,50,38,30,12,9,3,0,13,99,34,146
20201218,18DEC2020:00:00:00,UFU FERRER,48,32,34,44,2,80,76,4,76,4,0,0,31,17,16,9,5,2,0,13,55,8,76
20201218,18DEC2020:00:00:00,UFU GRIERSON,25,35,26,33,1,60,56,4,56,4,0,0,20,12,19,6,2,1,0,15,37,3,56
20201218,18DEC2020:00:00:00,UFU GUTIERREZ,60,16,59,17,0,76,64,12,72,4,15,16,14,17,5,6,1,2,0,4,44,16,64
20201218,18DEC2020:00:00:00,UFU MUÑIZ,288,296,285,278,21,584,404,180,426,158,11,27,207,140,95,64,27,13,0,12,344,48,404
20201218,18DEC2020:00:00:00,UFU PENNA,8,9,7,9,1,17,15,2,17,0,0,0,5,2,2,3,4,1,0,0,14,1,15
20201218,18DEC2020:00:00:00,UFU PIROVANO,100,73,135,34,4,173,165,8,169,4,0,11,47,55,26,17,7,10,0,20,101,44,165
20201218,18DEC2020:00:00:00,UFU PIÑERO,40,34,45,25,4,74,72,2,74,0,3,1,16,14,21,8,3,8,0,10,43,19,72
20201218,18DEC2020:00:00:00,UFU RAMOS MEJIA,36,25,44,17,0,61,57,4,61,0,4,8,12,14,6,11,2,4,0,8,39,10,57
20201218,18DEC2020:00:00:00,UFU RIVADAVIA,123,133,191,63,2,256,234,22,240,16,4,10,92,76,35,22,15,2,0,26,137,71,234
20201218,18DEC2020:00:00:00,UFU SANTOJANNI,80,64,83,61,0,144,132,12,142,2,4,16,24,34,24,17,15,10,0,7,38,87,132
20201218,18DEC2020:00:00:00,UFU TORNU,60,64,100,24,0,124,110,14,110,14,7,3,38,42,18,12,2,2,0,14,70,26,110
20201218,18DEC2020:00:00:00,UFU VELEZ SARSFIELD,53,47,80,20,0,100,98,2,98,2,0,2,24,14,29,12,8,11,0,7,62,29,98
20201218,18DEC2020:00:00:00,UFU ZUBIZARRETA,16,12,20,8,0,28,28,0,28,0,0,1,5,5,5,4,1,7,0,4,19,5,28
20201219,19DEC2020:00:00:00,UFU ALVAREZ,51,47,80,18,0,98,80,18,80,18,6,5,23,37,10,12,5,0,0,12,34,34,80
20201219,19DEC2020:00:00:00,UFU BORDA-MOYANO,3,2,4,1,0,5,5,0,5,0,0,0,0,0,4,1,0,0,0,0,4,1,5
20201219,19DEC2020:00:00:00,UFU DURAND,49,38,83,4,0,87,81,6,83,4,2,2,24,29,15,8,6,1,0,11,46,24,81
20201219,19DEC2020:00:00:00,UFU ELIZALDE,32,36,27,39,2,68,42,26,62,6,36,18,4,5,1,1,1,2,0,4,30,8,42
20201219,19DEC2020:00:00:00,UFU FERNANDEZ,72,48,103,17,0,120,92,28,120,0,0,1,41,24,22,16,16,0,0,6,63,23,92
20201219,19DEC2020:00:00:00,UFU FERRER,36,33,47,21,1,69,67,2,67,2,0,0,24,20,9,11,3,2,0,12,44,11,67
20201219,19DEC2020:00:00:00,UFU GRIERSON,21,26,23,24,0,47,47,0,47,0,0,1,14,9,12,8,3,0,0,13,29,5,47
20201219,19DEC2020:00:00:00,UFU GUTIERREZ,40,20,39,21,0,60,60,0,60,0,23,5,9,14,5,2,2,0,0,1,32,27,60
20201219,19DEC2020:00:00:00,UFU MUÑIZ,232,239,241,221,9,471,257,214,269,202,13,13,147,130,71,49,34,14,0,16,210,30,257
20201219,19DEC2020:00:00:00,UFU PENNA,18,12,19,11,0,30,28,2,28,2,1,1,11,6,8,1,0,2,0,4,19,5,28
20201219,19DEC2020:00:00:00,UFU PIROVANO,85,68,131,22,0,153,147,6,151,2,0,1,33,63,40,11,3,2,0,15,95,37,147
20201219,19DEC2020:00:00:00,UFU PIÑERO,36,14,35,14,1,50,44,6,46,4,0,2,13,11,12,5,2,5,0,6,27,11,44
20201219,19DEC2020:00:00:00,UFU RAMOS MEJIA,33,26,43,11,5,59,51,8,53,6,1,5,18,14,5,7,7,2,0,9,30,12,51
20201219,19DEC2020:00:00:00,UFU RIVADAVIA,86,97,158,25,0,183,175,8,175,8,0,2,69,53,32,9,12,6,0,14,101,59,175
20201219,19DEC2020:00:00:00,UFU SANTOJANNI,32,38,33,37,0,70,60,10,70,0,6,7,9,10,10,9,10,9,0,7,46,7,60
20201219,19DEC2020:00:00:00,UFU TORNU,36,33,31,33,5,69,51,18,67,2,2,3,15,16,17,12,2,2,0,8,31,12,51
20201219,19DEC2020:00:00:00,UFU VELEZ SARSFIELD,67,54,100,21,0,121,119,2,121,0,0,6,36,24,18,27,7,3,0,16,53,50,119
20201219,19DEC2020:00:00:00,UFU ZUBIZARRETA,73,45,89,29,0,118,112,6,116,2,2,9,31,20,19,19,9,9,0,18,72,22,112
20201220,20DEC2020:00:00:00,UFU ALVAREZ,90,72,140,22,0,162,70,92,70,92,8,6,25,57,19,22,16,9,0,8,31,31,70
20201220,20DEC2020:00:00:00,UFU BORDA-MOYANO,0,6,5,1,0,6,6,0,6,0,0,0,0,2,2,1,0,1,0,0,4,2,6
20201220,20DEC2020:00:00:00,UFU DURAND,33,40,71,2,0,73,71,2,71,2,4,3,13,30,14,7,2,0,0,14,42,15,71
20201220,20DEC2020:00:00:00,UFU ELIZALDE,30,25,13,42,0,55,39,16,51,4,23,15,4,3,6,2,2,0,0,0,35,4,39
20201220,20DEC2020:00:00:00,UFU FERNANDEZ,53,47,83,17,0,100,42,58,100,0,0,4,22,25,32,6,7,4,0,10,21,11,42
20201220,20DEC2020:00:00:00,UFU FERRER,35,33,48,18,2,68,66,2,66,2,0,1,18,24,15,9,1,0,0,6,51,9,66
20201220,20DEC2020:00:00:00,UFU GRIERSON,30,28,25,33,0,58,56,2,58,0,0,1,20,5,22,5,4,1,0,16,33,7,56
20201220,20DEC2020:00:00:00,UFU GUTIERREZ,30,24,34,20,0,54,50,4,54,0,12,14,5,7,11,5,0,0,0,2,34,14,50
20201220,20DEC2020:00:00:00,UFU MUÑIZ,164,180,171,168,5,344,162,182,176,168,5,18,106,101,61,27,18,8,0,8,124,30,162
20201220,20DEC2020:00:00:00,UFU PENNA,17,13,22,8,0,30,22,8,22,8,0,0,6,6,8,5,5,0,0,1,15,6,22
20201220,20DEC2020:00:00:00,UFU PIROVANO,71,73,107,35,2,144,136,8,140,4,0,5,37,48,21,20,7,6,0,9,95,27,136
20201220,20DEC2020:00:00:00,UFU PIÑERO,22,30,29,22,1,52,50,2,52,0,0,1,13,23,4,5,5,1,0,7,39,3,50
20201220,20DEC2020:00:00:00,UFU RAMOS MEJIA,18,13,18,10,3,31,23,8,27,4,1,0,8,10,4,1,5,2,0,5,12,6,23
20201220,20DEC2020:00:00:00,UFU RIVADAVIA,57,57,86,28,0,114,100,14,100,14,0,0,30,45,17,14,4,4,0,13,71,16,100
20201220,20DEC2020:00:00:00,UFU SANTOJANNI,29,26,30,25,0,55,51,4,53,2,1,4,8,20,10,7,3,2,0,4,40,7,51
20201220,20DEC2020:00:00:00,UFU TORNU,35,17,23,23,6,52,50,2,52,0,0,4,17,14,10,5,2,0,0,11,25,14,50
20201220,20DEC2020:00:00:00,UFU VELEZ SARSFIELD,45,49,73,21,0,94,92,2,94,0,0,0,20,15,31,18,7,3,0,12,54,26,92
20201220,20DEC2020:00:00:00,UFU ZUBIZARRETA,53,46,73,25,1,99,93,6,97,2,0,5,29,12,20,15,11,7,0,7,44,42,93
20201221,21DEC2020:00:00:00,UFU ALVAREZ,126,102,179,48,1,228,112,116,112,116,8,21,58,69,36,13,15,8,0,13,67,32,112
20201221,21DEC2020:00:00:00,UFU ARGERICH,32,33,48,15,2,65,52,13,52,13,4,3,21,17,7,6,3,4,0,3,38,11,52
20201221,21DEC2020:00:00:00,UFU BORDA-MOYANO,24,8,24,8,0,32,30,2,30,2,0,0,8,10,8,1,5,0,0,0,25,4,30
20201213,13DEC2020:00:00:00,UFU GRIERSON,7,7,9,4,1,14,14,0,14,0,0,0,5,2,3,2,2,0,0,3,10,1,14
20201213,13DEC2020:00:00:00,UFU GUTIERREZ,30,15,27,16,2,45,35,10,45,0,11,8,5,11,7,3,0,0,0,0,29,6,35
20201213,13DEC2020:00:00:00,UFU MUÑIZ,106,124,128,90,12,230,100,130,130,100,5,17,58,64,33,29,14,10,0,3,84,13,100
20201213,13DEC2020:00:00:00,UFU PENNA,12,10,14,8,0,22,22,0,22,0,0,1,2,7,2,3,5,2,0,3,15,4,22
20201213,13DEC2020:00:00:00,UFU PIROVANO,63,42,90,15,0,105,99,6,105,0,0,1,41,32,17,10,0,4,0,23,52,24,99
20201213,13DEC2020:00:00:00,UFU PIÑERO,29,10,30,7,2,39,39,0,39,0,0,5,11,8,7,4,4,0,0,11,27,1,39
20201213,13DEC2020:00:00:00,UFU RAMOS MEJIA,17,10,22,5,0,27,25,2,25,2,2,2,7,5,6,4,1,0,0,2,20,3,25
20201213,13DEC2020:00:00:00,UFU RIVADAVIA,74,53,112,15,0,127,115,12,115,12,0,2,50,44,12,7,8,4,0,6,79,26,115
20201213,13DEC2020:00:00:00,UFU SANTOJANNI,25,24,23,26,0,49,45,4,49,0,2,8,10,7,6,6,5,5,0,12,25,8,45
20201213,13DEC2020:00:00:00,UFU TORNU,27,21,20,25,3,48,44,4,46,2,2,1,15,16,6,2,6,0,0,7,26,11,44
20201213,13DEC2020:00:00:00,UFU VELEZ SARSFIELD,41,34,58,17,0,75,75,0,75,0,0,1,19,19,8,9,12,7,0,15,46,14,75
20201213,13DEC2020:00:00:00,UFU ZUBIZARRETA,43,41,61,23,0,84,64,20,70,14,6,10,11,28,12,5,10,2,0,10,41,13,64
20201214,14DEC2020:00:00:00,UFU ALVAREZ,98,72,129,39,2,170,142,28,142,28,5,7,46,40,38,20,12,2,0,10,99,33,142
20201214,14DEC2020:00:00:00,UFU ARGERICH,50,55,63,40,2,105,79,26,83,22,3,7,27,28,8,20,11,1,0,4,44,30,79
20201214,14DEC2020:00:00:00,UFU BORDA-MOYANO,10,11,12,7,2,21,21,0,21,0,0,0,4,3,5,8,1,0,0,4,12,5,21
20201214,14DEC2020:00:00:00,UFU DURAND,34,32,56,10,0,66,66,0,66,0,1,4,25,16,8,6,5,1,0,6,40,20,66
20201214,14DEC2020:00:00:00,UFU ELIZALDE,51,38,22,65,2,89,63,26,77,12,41,20,5,9,10,3,1,0,0,4,48,11,63
20201214,14DEC2020:00:00:00,UFU FERNANDEZ,76,79,116,36,3,155,113,42,127,28,0,2,46,45,25,15,6,16,0,10,83,20,113
20201214,14DEC2020:00:00:00,UFU FERRER,36,22,33,25,0,58,56,2,56,2,0,0,23,21,5,3,4,2,0,10,41,5,56
20201214,14DEC2020:00:00:00,UFU GRIERSON,16,19,20,15,0,35,35,0,35,0,0,1,10,8,7,8,1,0,0,5,29,1,35
20201214,14DEC2020:00:00:00,UFU GUTIERREZ,71,31,45,57,0,102,90,12,102,0,30,31,6,19,9,4,1,2,0,1,70,19,90
20201214,14DEC2020:00:00:00,UFU MUÑIZ,145,198,181,149,13,343,235,108,247,96,2,17,79,105,55,41,31,13,0,13,201,21,235
20201214,14DEC2020:00:00:00,UFU PENNA,20,14,25,9,0,34,32,2,32,2,0,0,12,7,6,4,3,2,0,7,22,3,32
20201214,14DEC2020:00:00:00,UFU PIROVANO,71,69,106,32,2,140,132,8,136,4,0,5,29,43,22,17,10,14,0,17,98,17,132
20201214,14DEC2020:00:00:00,UFU PIÑERO,25,31,38,14,4,56,52,4,52,4,0,0,25,17,5,6,3,0,0,13,35,4,52
20201214,14DEC2020:00:00:00,UFU RAMOS MEJIA,40,35,53,22,0,75,65,10,67,8,3,1,24,16,13,6,7,5,0,13,41,11,65
20201214,14DEC2020:00:00:00,UFU RIVADAVIA,142,111,184,62,7,253,194,59,194,59,2,7,78,83,36,28,10,9,0,15,142,36,194
20201214,14DEC2020:00:00:00,UFU SANTOJANNI,47,42,42,45,2,89,77,12,85,4,2,3,24,22,11,10,6,11,0,13,59,5,77
20201214,14DEC2020:00:00:00,UFU TORNU,43,43,79,7,0,86,82,4,82,4,7,2,17,27,10,8,5,10,0,3,45,34,82
20201214,14DEC2020:00:00:00,UFU VELEZ SARSFIELD,41,49,77,13,0,90,90,0,90,0,0,0,14,34,17,12,6,7,0,6,64,20,90
20201214,14DEC2020:00:00:00,UFU ZUBIZARRETA,17,16,15,18,0,33,31,2,31,2,0,2,6,12,6,6,1,0,0,0,19,12,31
20201215,15DEC2020:00:00:00,UFU ALVAREZ,68,51,82,37,0,119,99,20,99,20,5,3,28,30,26,13,10,4,0,8,69,22,99
20201215,15DEC2020:00:00:00,UFU ARGERICH,18,32,33,17,0,50,38,12,38,12,0,4,15,13,5,4,7,2,0,1,28,8,38
20201215,15DEC2020:00:00:00,UFU BORDA-MOYANO,6,4,5,5,0,10,10,0,10,0,0,1,0,1,4,1,1,2,0,2,5,3,10
20201215,15DEC2020:00:00:00,UFU DURAND,15,13,28,0,0,28,28,0,28,0,0,2,5,9,3,8,1,0,0,2,16,10,28
20201215,15DEC2020:00:00:00,UFU ELIZALDE,37,28,25,40,0,65,43,22,55,10,33,13,4,7,5,3,0,0,0,2,33,8,43
20201215,15DEC2020:00:00:00,UFU FERNANDEZ,59,45,83,21,0,104,36,68,104,0,0,0,34,32,13,11,8,6,0,7,16,13,36
20201215,15DEC2020:00:00:00,UFU FERRER,34,29,35,28,0,63,62,1,62,1,0,2,21,21,8,8,2,1,0,13,44,5,62
20201215,15DEC2020:00:00:00,UFU GRIERSON,26,24,16,30,4,50,46,4,46,4,0,2,15,15,7,7,4,0,0,0,0,46,46
20201215,15DEC2020:00:00:00,UFU GUTIERREZ,34,16,24,26,0,50,44,6,50,0,22,9,5,7,6,0,1,0,0,1,28,15,44
20201215,15DEC2020:00:00:00,UFU MUÑIZ,184,220,209,181,14,404,242,162,244,160,4,24,115,96,75,53,23,14,0,18,211,13,242
20201215,15DEC2020:00:00:00,UFU PENNA,10,6,10,6,0,16,14,2,16,0,0,0,2,2,3,3,6,0,0,0,11,3,14
20201215,15DEC2020:00:00:00,UFU PIROVANO,18,22,26,14,0,40,36,4,36,4,0,0,9,2,4,3,11,11,0,10,15,11,36
20201215,15DEC2020:00:00:00,UFU PIÑERO,5,9,10,4,0,14,14,0,14,0,0,1,4,2,3,2,1,1,0,3,11,0,14
20201215,15DEC2020:00:00:00,UFU RAMOS MEJIA,28,26,38,16,0,54,48,6,52,2,6,4,11,15,5,7,5,1,0,7,33,8,48
20201215,15DEC2020:00:00:00,UFU RIVADAVIA,91,69,119,37,4,160,149,11,149,11,0,5,61,41,21,16,14,2,0,19,102,28,149
20201215,15DEC2020:00:00:00,UFU SANTOJANNI,20,17,23,14,0,37,35,2,35,2,0,3,15,8,4,3,3,1,0,5,25,5,35
20201215,15DEC2020:00:00:00,UFU TORNU,21,22,30,13,0,43,41,2,41,2,1,4,10,6,12,4,4,2,0,3,32,6,41
20201215,15DEC2020:00:00:00,UFU VELEZ SARSFIELD,28,24,37,15,0,52,48,4,52,0,0,0,7,18,12,8,4,3,0,0,31,17,48
20201215,15DEC2020:00:00:00,UFU ZUBIZARRETA,7,6,12,1,0,13,13,0,13,0,0,0,3,4,3,1,0,2,0,3,8,2,13
20201216,16DEC2020:00:00:00,UFU ALVAREZ,44,37,64,16,1,81,73,8,75,6,6,3,19,26,12,10,4,1,0,10,22,41,73
20201216,16DEC2020:00:00:00,UFU ARGERICH,21,16,19,18,0,37,31,6,31,6,2,1,14,5,7,2,3,3,0,0,25,5,31
20201216,16DEC2020:00:00:00,UFU BORDA-MOYANO,14,16,12,17,1,30,30,0,30,0,0,0,8,13,1,4,4,0,0,2,23,5,30
20201216,16DEC2020:00:00:00,UFU ELIZALDE,30,12,17,25,0,42,24,18,40,2,25,7,4,3,3,0,0,0,0,0,24,0,24
20201216,16DEC2020:00:00:00,UFU FERRER,36,49,49,36,0,85,81,4,81,4,0,2,34,20,13,9,5,2,0,18,53,10,81
20201216,16DEC2020:00:00:00,UFU MUÑIZ,231,328,263,280,16,559,367,192,387,172,8,30,177,143,82,74,33,12,0,18,293,55,367
20201216,16DEC2020:00:00:00,UFU PENNA,3,0,2,1,0,3,3,0,3,0,0,0,0,1,0,2,0,0,0,0,3,0,3
20201216,16DEC2020:00:00:00,UFU RAMOS MEJIA,19,23,34,8,0,42,34,8,40,2,0,1,14,12,1,4,8,2,0,6,20,8,34
20201216,16DEC2020:00:00:00,UFU RIVADAVIA,75,52,96,28,3,127,123,4,123,4,0,2,35,42,15,13,10,10,0,10,82,31,123
20201217,17DEC2020:00:00:00,UFU ALVAREZ,86,65,106,45,0,151,147,4,147,4,3,2,37,49,31,13,9,7,0,14,93,40,147
20201217,17DEC2020:00:00:00,UFU ARGERICH,63,86,79,70,0,149,135,14,135,14,8,5,41,38,24,23,7,3,0,6,94,34,135
20201217,17DEC2020:00:00:00,UFU BORDA-MOYANO,27,22,27,20,2,49,47,2,47,2,0,2,6,17,8,10,4,2,0,0,41,6,47
20201217,17DEC2020:00:00:00,UFU DURAND,56,57,103,10,0,113,109,4,109,4,1,3,32,42,21,12,2,0,0,26,66,17,109
20201217,17DEC2020:00:00:00,UFU ELIZALDE,52,35,44,43,0,87,59,28,77,10,43,22,7,10,5,0,0,0,0,4,43,12,59
20201217,17DEC2020:00:00:00,UFU FERNANDEZ,120,88,174,31,3,208,200,8,202,6,2,0,71,70,25,20,10,10,0,12,136,52,200
20201217,17DEC2020:00:00:00,UFU FERRER,40,47,55,32,0,87,87,0,87,0,0,1,28,17,18,6,15,2,0,4,71,12,87
20201217,17DEC2020:00:00:00,UFU GRIERSON,50,57,50,57,0,107,103,4,103,4,0,8,30,35,16,15,2,1,0,12,32,59,103
20201217,17DEC2020:00:00:00,UFU GUTIERREZ,56,29,50,35,0,85,75,10,85,0,22,17,9,16,9,4,8,0,0,1,55,19,75
20201124,24NOV2020:00:00:00,UFU RIVADAVIA,51,60,73,36,2,111,105,6,107,4,0,0,34,34,21,10,7,5,0,12,72,20,105
20201124,24NOV2020:00:00:00,UFU SANTOJANNI,43,27,29,38,3,70,68,2,70,0,3,2,15,19,15,7,8,1,0,13,52,3,68
20201124,24NOV2020:00:00:00,UFU TORNU,33,31,47,17,0,64,54,10,54,10,2,3,27,10,11,5,5,1,0,3,42,9,54
20201124,24NOV2020:00:00:00,UFU VELEZ SARSFIELD,27,29,43,13,0,56,56,0,56,0,3,3,10,11,16,9,4,0,0,4,40,12,56
20201124,24NOV2020:00:00:00,UFU ZUBIZARRETA,36,25,36,24,1,61,53,8,53,8,3,6,12,13,12,9,4,2,0,9,42,2,53
20201125,25NOV2020:00:00:00,UFU ALVAREZ,58,28,64,20,2,86,82,4,82,4,2,3,23,16,19,10,7,6,0,5,56,20,82
20201125,25NOV2020:00:00:00,UFU ARGERICH,31,34,41,23,1,65,49,16,49,16,7,2,10,16,13,6,8,3,0,3,34,12,49
20201125,25NOV2020:00:00:00,UFU BORDA-MOYANO,10,20,21,2,7,30,30,0,30,0,0,0,4,6,7,4,6,3,0,0,23,6,30
20201125,25NOV2020:00:00:00,UFU DURAND,30,23,47,6,0,53,51,2,51,2,2,4,6,16,14,5,4,2,0,8,34,9,51
20201125,25NOV2020:00:00:00,UFU ELIZALDE,18,32,15,34,1,50,38,12,46,4,27,10,2,4,4,3,0,0,0,1,35,2,38
20201125,25NOV2020:00:00:00,UFU FERNANDEZ,26,24,40,10,0,50,44,6,48,2,0,1,17,20,5,4,3,0,0,9,29,6,44
20201125,25NOV2020:00:00:00,UFU FERRER,19,19,18,20,0,38,32,6,32,6,0,1,11,16,5,4,1,0,0,6,25,1,32
20201125,25NOV2020:00:00:00,UFU GRIERSON,25,23,23,25,0,48,42,6,42,6,0,2,8,14,8,10,3,3,0,3,31,8,42
20201125,25NOV2020:00:00:00,UFU GUTIERREZ,73,41,62,52,0,114,102,12,108,6,28,24,15,30,15,2,0,0,0,3,72,26,102
20201125,25NOV2020:00:00:00,UFU MUÑIZ,133,136,141,117,11,269,137,132,143,126,6,22,59,64,53,29,30,6,0,17,105,14,137
20201125,25NOV2020:00:00:00,UFU PENNA,25,9,22,8,4,34,20,14,26,8,0,0,7,5,9,5,5,3,0,3,14,3,20
20201125,25NOV2020:00:00:00,UFU PIROVANO,67,37,78,26,0,104,88,16,98,6,5,1,18,26,18,21,10,5,0,5,69,14,88
20201125,25NOV2020:00:00:00,UFU PIÑERO,27,19,28,15,3,46,40,6,42,4,2,0,17,12,6,7,2,0,0,6,28,6,40
20201125,25NOV2020:00:00:00,UFU RAMOS MEJIA,20,19,33,6,0,39,33,6,37,2,1,1,4,10,9,7,7,0,0,3,22,8,33
20201125,25NOV2020:00:00:00,UFU RIVADAVIA,57,56,75,24,14,113,97,16,99,14,0,1,30,40,14,15,4,9,0,8,67,22,97
20201125,25NOV2020:00:00:00,UFU SANTOJANNI,37,17,37,17,0,54,50,4,54,0,4,2,8,18,11,4,5,2,0,4,42,4,50
20201125,25NOV2020:00:00:00,UFU TORNU,24,43,47,18,2,67,57,10,59,8,2,3,15,17,16,11,3,0,0,2,36,19,57
20201125,25NOV2020:00:00:00,UFU VELEZ SARSFIELD,28,23,31,20,0,51,49,2,51,0,0,2,13,6,15,11,2,2,0,5,37,7,49
20201125,25NOV2020:00:00:00,UFU ZUBIZARRETA,20,26,23,20,3,46,44,2,44,2,1,5,12,11,9,8,0,0,0,12,24,8,44
20201126,26NOV2020:00:00:00,UFU ALVAREZ,31,51,71,9,2,82,66,16,70,12,5,5,15,21,12,11,10,3,0,13,38,15,66
20201126,26NOV2020:00:00:00,UFU ARGERICH,28,34,45,17,0,62,52,10,52,10,3,11,9,14,10,9,5,1,0,9,30,12,52
20201126,26NOV2020:00:00:00,UFU BORDA-MOYANO,9,3,5,4,3,12,10,2,10,2,0,3,0,2,5,2,0,0,0,0,9,1,10
20201126,26NOV2020:00:00:00,UFU DURAND,34,26,49,11,0,60,60,0,60,0,2,2,17,26,5,4,3,1,0,13,37,10,60
20201126,26NOV2020:00:00:00,UFU ELIZALDE,26,40,14,52,0,66,36,30,64,2,42,13,4,3,3,1,0,0,0,1,29,6,36
20201126,26NOV2020:00:00:00,UFU FERNANDEZ,34,29,50,13,0,63,59,4,59,4,0,0,28,15,5,12,2,1,0,8,40,11,59
20201126,26NOV2020:00:00:00,UFU FERRER,32,21,18,35,0,53,51,2,51,2,0,1,15,15,10,9,3,0,0,13,36,2,51
20201126,26NOV2020:00:00:00,UFU GRIERSON,29,21,26,24,0,50,46,4,46,4,1,4,16,14,8,2,4,1,0,7,23,16,46
20201126,26NOV2020:00:00:00,UFU GUTIERREZ,53,31,55,29,0,84,72,12,84,0,20,3,19,24,7,6,1,4,0,1,56,15,72
20201126,26NOV2020:00:00:00,UFU MUÑIZ,113,154,145,114,8,267,159,108,159,108,7,10,83,71,43,22,24,7,0,19,124,15,159
20201126,26NOV2020:00:00:00,UFU PENNA,12,3,6,9,0,15,9,6,15,0,0,0,5,1,3,5,0,1,0,1,8,0,9
20201126,26NOV2020:00:00:00,UFU PIROVANO,26,26,37,13,2,52,48,4,50,2,0,0,14,16,11,7,4,0,0,6,37,5,48
20201126,26NOV2020:00:00:00,UFU PIÑERO,28,22,28,22,0,50,42,8,42,8,2,0,14,8,12,9,3,2,0,4,35,3,42
20201126,26NOV2020:00:00:00,UFU RAMOS MEJIA,32,21,31,17,5,53,47,6,49,4,2,4,10,10,11,11,5,0,0,5,32,10,47
20201126,26NOV2020:00:00:00,UFU RIVADAVIA,84,61,100,34,11,145,141,4,141,4,0,4,46,41,28,20,3,3,0,9,97,34,141
20201126,26NOV2020:00:00:00,UFU SANTOJANNI,20,19,22,17,0,39,31,8,37,2,2,0,10,10,4,6,4,3,0,4,25,2,31
20201126,26NOV2020:00:00:00,UFU TORNU,18,39,36,19,2,57,49,8,49,8,1,2,20,18,8,3,1,4,0,5,32,12,49
20201126,26NOV2020:00:00:00,UFU VELEZ SARSFIELD,36,19,33,20,2,55,53,2,53,2,0,0,16,11,10,11,5,2,0,6,37,10,53
20201126,26NOV2020:00:00:00,UFU ZUBIZARRETA,19,17,20,16,0,36,28,8,32,4,0,2,9,7,9,3,6,0,0,6,21,1,28
20201127,27NOV2020:00:00:00,UFU ALVAREZ,43,39,67,15,0,82,78,4,78,4,0,1,26,14,15,14,9,3,0,6,37,35,78
20201127,27NOV2020:00:00:00,UFU ARGERICH,26,12,26,12,0,38,30,8,30,8,0,2,8,17,5,4,2,0,0,2,22,6,30
20201127,27NOV2020:00:00:00,UFU BORDA-MOYANO,15,6,10,11,0,21,17,4,17,4,0,0,4,4,5,5,1,2,0,0,16,1,17
20201127,27NOV2020:00:00:00,UFU DURAND,31,22,40,13,0,53,47,6,49,4,3,3,19,15,6,6,1,0,0,5,35,7,47
20201127,27NOV2020:00:00:00,UFU ELIZALDE,41,34,18,57,0,75,49,26,63,12,41,18,3,5,4,3,1,0,0,3,42,4,49
20201127,27NOV2020:00:00:00,UFU FERNANDEZ,26,29,44,11,0,55,45,10,45,10,0,4,15,18,10,4,3,1,0,4,33,8,45
20201127,27NOV2020:00:00:00,UFU FERRER,27,23,26,24,0,50,44,6,44,6,0,0,16,14,11,5,2,2,0,1,39,4,44
20201127,27NOV2020:00:00:00,UFU GRIERSON,25,33,37,21,0,58,54,4,54,4,3,3,16,18,12,5,1,0,0,5,24,25,54
20201127,27NOV2020:00:00:00,UFU GUTIERREZ,79,49,74,54,0,128,98,30,114,14,16,15,29,20,20,14,8,6,0,0,75,23,98
20201127,27NOV2020:00:00:00,UFU MUÑIZ,161,210,163,203,5,371,137,234,153,218,4,14,98,104,62,52,30,7,0,12,110,15,137
20201127,27NOV2020:00:00:00,UFU PENNA,4,13,13,4,0,17,17,0,17,0,0,0,5,7,2,2,1,0,0,3,13,1,17
20201127,27NOV2020:00:00:00,UFU PIROVANO,47,23,61,7,2,70,66,4,68,2,2,6,15,15,19,6,2,5,0,7,49,10,66
20201127,27NOV2020:00:00:00,UFU PIÑERO,33,20,30,18,5,53,47,6,47,6,0,0,13,16,13,9,1,1,0,8,38,1,47
20201127,27NOV2020:00:00:00,UFU RAMOS MEJIA,43,31,49,25,0,74,72,2,72,2,3,7,22,18,5,15,2,2,0,3,49,20,72
20201127,27NOV2020:00:00:00,UFU RIVADAVIA,75,71,97,43,6,146,124,22,124,22,0,8,46,41,20,14,12,5,0,10,81,28,124
20201127,27NOV2020:00:00:00,UFU SANTOJANNI,27,33,29,27,4,60,48,12,54,6,5,2,11,16,8,9,5,4,0,3,38,7,48
20201127,27NOV2020:00:00:00,UFU TORNU,38,30,54,12,2,68,58,10,58,10,6,6,19,16,4,11,2,4,0,5,37,16,58
20201127,27NOV2020:00:00:00,UFU VELEZ SARSFIELD,41,22,48,15,0,63,59,4,63,0,0,4,12,23,13,8,3,0,0,10,40,9,59
20201127,27NOV2020:00:00:00,UFU ZUBIZARRETA,24,27,35,16,0,51,41,10,41,10,2,2,14,7,10,8,4,4,0,9,28,4,41
20201128,28NOV2020:00:00:00,UFU ALVAREZ,47,42,65,23,1,89,77,12,77,12,0,2,19,27,16,12,8,5,0,0,17,60,77
20201128,28NOV2020:00:00:00,UFU BORDA-MOYANO,12,6,12,6,0,18,18,0,18,0,0,4,0,4,6,0,2,2,0,0,9,9,18
20201128,28NOV2020:00:00:00,UFU DURAND,17,7,21,3,0,24,24,0,24,0,0,3,2,7,7,2,1,2,0,1,17,6,24
20201128,28NOV2020:00:00:00,UFU ELIZALDE,23,20,10,33,0,43,33,10,43,0,27,3,4,7,1,0,1,0,0,0,29,4,33
20201128,28NOV2020:00:00:00,UFU FERNANDEZ,13,28,34,5,2,41,37,4,39,2,0,5,11,11,4,4,3,3,0,8,23,6,37
20201128,28NOV2020:00:00:00,UFU FERRER,22,14,18,18,0,36,30,6,30,6,1,2,9,7,8,5,4,0,0,6,19,5,30
20201128,28NOV2020:00:00:00,UFU GRIERSON,8,10,11,7,0,18,18,0,18,0,0,0,6,3,5,2,2,0,0,9,9,0,18
20201128,28NOV2020:00:00:00,UFU GUTIERREZ,66,29,65,30,0,95,39,56,93,2,14,11,25,24,11,8,2,0,0,1,32,5,39
20201128,28NOV2020:00:00:00,UFU MUÑIZ,105,110,104,107,4,215,105,110,109,106,2,7,77,58,30,25,9,7,0,10,74,21,105
20201128,28NOV2020:00:00:00,UFU PENNA,12,9,8,13,0,21,15,6,21,0,0,0,2,7,8,0,0,4,0,1,11,3,15
20201128,28NOV2020:00:00:00,UFU PIROVANO,24,15,33,6,0,39,33,6,37,2,2,1,9,12,8,4,2,1,0,6,22,5,33
20201128,28NOV2020:00:00:00,UFU PIÑERO,14,14,19,9,0,28,14,14,20,8,0,1,8,6,5,2,6,0,0,1,11,2,14
20201128,28NOV2020:00:00:00,UFU RAMOS MEJIA,17,21,35,3,0,38,28,10,30,8,1,1,12,8,6,4,0,6,0,3,21,4,28
20201128,28NOV2020:00:00:00,UFU RIVADAVIA,37,43,66,14,0,80,76,4,78,2,0,9,20,24,11,9,3,4,0,11,49,15,76
20201128,28NOV2020:00:00:00,UFU SANTOJANNI,23,21,17,27,0,44,36,8,44,0,4,7,1,15,8,6,2,1,0,4,30,2,36
20201128,28NOV2020:00:00:00,UFU TORNU,17,19,22,14,0,36,34,2,34,2,0,3,8,10,6,4,0,5,0,1,26,6,34
20201128,28NOV2020:00:00:00,UFU VELEZ SARSFIELD,23,24,38,9,0,47,47,0,47,0,0,3,15,6,9,6,5,3,0,9,33,5,47
20201128,28NOV2020:00:00:00,UFU ZUBIZARRETA,38,33,48,23,0,71,67,4,67,4,1,4,13,14,15,9,10,5,0,8,39,20,67
20201129,29NOV2020:00:00:00,UFU ALVAREZ,31,14,35,10,0,45,23,22,23,22,2,1,11,9,4,13,2,3,0,5,13,5,23
20201129,29NOV2020:00:00:00,UFU BORDA-MOYANO,4,3,7,0,0,7,7,0,7,0,0,0,3,1,0,3,0,0,0,0,6,1,7
20201129,29NOV2020:00:00:00,UFU DURAND,22,11,27,6,0,33,33,0,33,0,0,0,13,8,7,0,4,1,0,7,20,6,33
20201129,29NOV2020:00:00:00,UFU ELIZALDE,26,23,13,36,0,49,39,10,47,2,21,13,5,2,7,0,1,0,0,0,29,10,39
20201129,29NOV2020:00:00:00,UFU FERNANDEZ,12,14,16,10,0,26,22,4,26,0,0,2,9,5,3,4,0,3,0,1,18,3,22
20201129,29NOV2020:00:00:00,UFU FERRER,20,25,27,18,0,45,37,8,37,8,1,0,17,18,6,3,0,0,0,4,31,2,37
20201129,29NOV2020:00:00:00,UFU GRIERSON,19,18,20,14,3,37,35,2,35,2,0,0,9,10,6,4,5,3,0,11,19,5,35
20201129,29NOV2020:00:00:00,UFU GUTIERREZ,30,19,26,23,0,49,45,4,49,0,7,11,7,9,9,2,2,2,0,2,36,7,45
20201129,29NOV2020:00:00:00,UFU MUÑIZ,80,111,90,99,2,191,97,94,117,74,2,8,54,66,23,24,12,2,0,8,75,14,97
20201129,29NOV2020:00:00:00,UFU PENNA,9,7,9,7,0,16,16,0,16,0,0,2,3,2,2,1,1,5,0,0,14,2,16
20201129,29NOV2020:00:00:00,UFU PIROVANO,20,27,32,15,0,47,43,4,43,4,0,1,11,18,7,5,4,1,0,4,36,3,43
20201129,29NOV2020:00:00:00,UFU PIÑERO,8,10,15,2,1,18,16,2,16,2,0,0,4,5,3,2,4,0,0,0,15,1,16
20201129,29NOV2020:00:00:00,UFU RAMOS MEJIA,10,10,17,2,1,20,20,0,20,0,0,1,5,4,4,1,3,2,0,4,14,2,20
20201129,29NOV2020:00:00:00,UFU RIVADAVIA,53,34,82,5,0,87,75,12,75,12,0,2,27,34,7,11,3,3,0,5,59,8,75
20201129,29NOV2020:00:00:00,UFU SANTOJANNI,20,10,18,12,0,30,24,6,28,2,1,0,6,5,9,6,1,2,0,4,20,0,24
20201129,29NOV2020:00:00:00,UFU TORNU,24,28,10,41,1,52,48,4,50,2,2,0,18,9,4,14,2,3,0,4,34,10,48
20201129,29NOV2020:00:00:00,UFU VELEZ SARSFIELD,19,27,33,13,0,46,46,0,46,0,0,0,17,11,9,2,4,3,0,7,28,11,46
20201129,29NOV2020:00:00:00,UFU ZUBIZARRETA,27,25,31,21,0,52,46,6,46,6,1,11,15,13,6,6,0,0,0,5,29,12,46
20201130,30NOV2020:00:00:00,UFU ALVAREZ,48,67,90,25,0,115,103,12,103,12,1,9,33,20,25,11,9,7,0,12,73,18,103
20201130,30NOV2020:00:00:00,UFU ARGERICH,51,62,60,51,2,113,99,14,99,14,2,1,48,20,25,7,7,3,0,4,64,29,99
20201130,30NOV2020:00:00:00,UFU BORDA-MOYANO,0,22,17,5,0,22,20,2,20,2,0,0,7,4,7,1,3,0,0,0,15,5,20
20201130,30NOV2020:00:00:00,UFU DURAND,35,24,52,7,0,59,59,0,59,0,6,5,14,16,14,0,2,2,0,4,45,10,59
20201130,30NOV2020:00:00:00,UFU ELIZALDE,47,39,28,58,0,86,60,26,68,18,41,23,5,9,5,3,0,0,0,2,50,8,60
20201130,30NOV2020:00:00:00,UFU FERNANDEZ,28,32,45,15,0,60,58,2,58,2,0,1,15,24,7,10,3,0,0,10,40,8,58
20201130,30NOV2020:00:00:00,UFU FERRER,35,27,27,35,0,62,62,0,62,0,0,0,22,18,6,8,6,2,0,3,51,8,62
20201130,30NOV2020:00:00:00,UFU GRIERSON,11,15,20,6,0,26,26,0,26,0,0,0,12,6,2,3,2,1,0,4,18,3,26
20201130,30NOV2020:00:00:00,UFU GUTIERREZ,59,36,40,55,0,95,61,34,65,30,29,10,21,12,13,7,1,2,0,0,52,8,61
20201130,30NOV2020:00:00:00,UFU MUÑIZ,146,240,162,217,7,386,216,170,226,160,3,18,150,84,51,54,19,7,0,13,177,26,216
20201130,30NOV2020:00:00:00,UFU PENNA,7,3,7,3,0,10,8,2,8,2,0,0,1,2,3,2,2,0,0,0,8,0,8
20201130,30NOV2020:00:00:00,UFU PIROVANO,46,39,64,21,0,85,71,14,79,6,0,1,22,24,23,4,5,6,0,4,59,8,71
20201130,30NOV2020:00:00:00,UFU PIÑERO,58,51,69,30,10,109,101,8,103,6,1,7,19,23,27,21,11,0,0,11,88,2,101
20201130,30NOV2020:00:00:00,UFU RAMOS MEJIA,42,15,43,14,0,57,53,4,53,4,7,3,11,14,9,7,3,3,0,2,38,13,53
20201130,30NOV2020:00:00:00,UFU RIVADAVIA,88,67,100,36,19,155,81,74,81,74,0,12,56,41,16,20,6,4,0,3,59,19,81
20201130,30NOV2020:00:00:00,UFU SANTOJANNI,29,33,39,21,2,62,54,8,58,4,0,2,16,18,14,5,3,4,0,6,44,4,54
20201130,30NOV2020:00:00:00,UFU TORNU,31,35,33,31,2,66,54,12,58,8,2,2,17,25,9,2,7,2,0,6,36,12,54
20201130,30NOV2020:00:00:00,UFU VELEZ SARSFIELD,29,21,39,11,0,50,46,4,50,0,0,1,11,11,12,3,8,4,0,9,26,11,46
20201130,30NOV2020:00:00:00,UFU ZUBIZARRETA,19,22,27,14,0,41,37,4,41,0,1,5,13,7,1,9,2,3,0,9,23,5,37
20201201,01DEC2020:00:00:00,UFU ALVAREZ,63,62,109,16,0,125,117,8,119,6,3,12,22,40,17,13,12,6,0,4,53,60,117
20201201,01DEC2020:00:00:00,UFU ARGERICH,17,24,29,12,0,41,29,12,29,12,2,5,13,9,2,1,1,8,0,1,19,9,29
20201201,01DEC2020:00:00:00,UFU BORDA-MOYANO,18,12,22,8,0,30,28,2,28,2,0,1,4,12,7,2,2,2,0,1,24,3,28
20201201,01DEC2020:00:00:00,UFU DURAND,33,26,53,6,0,59,59,0,59,0,3,2,14,28,3,3,4,2,0,5,43,11,59
20201201,01DEC2020:00:00:00,UFU ELIZALDE,36,25,15,46,0,61,43,18,57,4,34,10,3,8,4,2,0,0,0,2,34,7,43
20201201,01DEC2020:00:00:00,UFU FERNANDEZ,28,15,29,12,2,43,39,4,39,4,0,0,16,12,4,7,3,1,0,2,32,5,39
20201201,01DEC2020:00:00:00,UFU FERRER,14,24,16,22,0,38,38,0,38,0,0,0,8,18,5,4,0,3,0,3,31,4,38
20201201,01DEC2020:00:00:00,UFU GRIERSON,27,21,24,24,0,48,48,0,48,0,0,3,15,14,12,3,1,0,0,3,42,3,48
20201201,01DEC2020:00:00:00,UFU GUTIERREZ,61,43,57,47,0,104,72,32,100,4,25,12,16,19,13,11,4,4,0,1,60,11,72
20201201,01DEC2020:00:00:00,UFU MUÑIZ,175,234,155,242,12,409,165,244,175,234,6,13,139,87,73,54,30,7,0,6,131,28,165
20201201,01DEC2020:00:00:00,UFU PENNA,5,4,6,3,0,9,5,4,9,0,0,0,0,3,3,0,2,1,0,0,5,0,5
20201201,01DEC2020:00:00:00,UFU PIROVANO,27,27,38,14,2,54,48,6,48,6,0,2,14,21,15,2,0,0,0,2,38,8,48
20201201,01DEC2020:00:00:00,UFU PIÑERO,28,29,38,12,7,57,47,10,51,6,7,5,8,12,13,5,3,4,0,2,42,2,47
20201201,01DEC2020:00:00:00,UFU RAMOS MEJIA,34,25,46,13,0,59,55,4,57,2,2,8,10,15,18,4,0,2,0,3,45,7,55
20201201,01DEC2020:00:00:00,UFU RIVADAVIA,91,58,87,47,15,149,135,14,137,12,0,9,48,45,19,13,13,2,0,4,107,23,135
20201201,01DEC2020:00:00:00,UFU SANTOJANNI,23,17,21,19,0,40,38,2,40,0,1,1,7,17,8,3,1,2,0,4,31,3,38
20201201,01DEC2020:00:00:00,UFU TORNU,45,32,42,35,0,77,77,0,77,0,2,6,17,27,16,3,1,5,0,6,47,24,77
20201201,01DEC2020:00:00:00,UFU VELEZ SARSFIELD,28,25,41,12,0,53,51,2,53,0,0,1,11,19,9,6,5,2,0,16,31,4,51
20201201,01DEC2020:00:00:00,UFU ZUBIZARRETA,6,6,8,4,0,12,10,2,12,0,2,0,5,1,1,2,1,0,0,2,8,0,10
20201202,02DEC2020:00:00:00,UFU ALVAREZ,59,58,93,23,1,117,105,12,105,12,9,5,26,26,26,11,7,7,0,10,74,21,105
20201202,02DEC2020:00:00:00,UFU ARGERICH,39,28,48,18,1,67,49,18,53,14,3,5,16,11,14,3,6,9,0,3,32,13,49
20201202,02DEC2020:00:00:00,UFU BORDA-MOYANO,25,12,28,9,0,37,31,6,31,6,0,1,14,7,5,4,4,2,0,0,25,6,31
20201202,02DEC2020:00:00:00,UFU DURAND,35,16,46,4,1,51,51,0,51,0,0,3,13,10,10,8,4,3,0,9,35,7,51
20201202,02DEC2020:00:00:00,UFU ELIZALDE,51,36,21,66,0,87,75,12,85,2,45,23,4,8,3,3,1,0,0,3,55,17,75
20201202,02DEC2020:00:00:00,UFU FERNANDEZ,32,27,50,9,0,59,53,6,55,4,0,1,10,19,12,7,7,3,0,12,31,10,53
20201202,02DEC2020:00:00:00,UFU FERRER,25,35,30,30,0,60,58,2,58,2,0,0,13,21,12,9,4,1,0,4,50,4,58
20201202,02DEC2020:00:00:00,UFU GRIERSON,16,26,30,12,0,42,40,2,40,2,0,1,12,10,11,5,2,1,0,7,28,5,40
20201202,02DEC2020:00:00:00,UFU GUTIERREZ,61,37,58,40,0,98,64,34,96,2,22,14,16,29,6,2,5,4,0,4,46,14,64
20201202,02DEC2020:00:00:00,UFU MUÑIZ,155,193,178,164,6,348,150,198,158,190,10,11,67,114,74,45,22,5,0,12,123,15,150
20201202,02DEC2020:00:00:00,UFU PENNA,1,9,9,1,0,10,4,6,8,2,0,0,3,2,2,0,3,0,0,0,3,1,4
20201202,02DEC2020:00:00:00,UFU PIROVANO,40,35,60,15,0,75,65,10,71,4,0,2,19,28,13,10,2,1,0,5,48,12,65
20201202,02DEC2020:00:00:00,UFU PIÑERO,20,27,29,13,5,47,41,6,41,6,2,1,16,12,3,9,3,1,0,5,30,6,41
20201202,02DEC2020:00:00:00,UFU RAMOS MEJIA,38,24,50,12,0,62,58,4,58,4,4,3,14,14,10,4,6,7,0,5,43,10,58
20201202,02DEC2020:00:00:00,UFU RIVADAVIA,85,77,105,55,2,162,124,38,130,32,0,1,53,48,24,15,14,7,0,6,99,19,124
20201202,02DEC2020:00:00:00,UFU SANTOJANNI,35,26,38,23,0,61,59,2,59,2,2,3,11,13,10,6,10,6,0,14,40,5,59
20201202,02DEC2020:00:00:00,UFU TORNU,26,38,43,19,2,64,58,6,62,2,3,1,9,17,15,10,6,3,0,2,36,20,58
20201202,02DEC2020:00:00:00,UFU VELEZ SARSFIELD,22,14,29,7,0,36,36,0,36,0,0,1,9,16,6,3,1,0,0,9,21,6,36
20201202,02DEC2020:00:00:00,UFU ZUBIZARRETA,9,11,11,7,2,20,20,0,20,0,0,1,3,5,5,6,0,0,0,1,7,12,20
20201203,03DEC2020:00:00:00,UFU ALVAREZ,79,57,108,25,3,136,122,14,122,14,6,8,40,33,15,14,11,9,0,6,79,37,122
20201203,03DEC2020:00:00:00,UFU ARGERICH,44,33,54,22,1,77,61,16,63,14,3,5,17,20,9,14,4,5,0,2,48,11,61
20201203,03DEC2020:00:00:00,UFU BORDA-MOYANO,6,6,10,2,0,12,12,0,12,0,0,1,1,2,6,0,2,0,0,0,10,2,12
20201203,03DEC2020:00:00:00,UFU DURAND,12,13,20,5,0,25,23,2,23,2,0,2,9,5,3,3,3,0,0,1,21,1,23
20201203,03DEC2020:00:00:00,UFU ELIZALDE,28,16,13,31,0,44,36,8,42,2,20,10,1,4,2,4,3,0,0,2,28,6,36
20201203,03DEC2020:00:00:00,UFU FERNANDEZ,27,18,37,8,0,45,43,2,43,2,0,0,10,20,5,4,2,4,0,6,28,9,43
20201203,03DEC2020:00:00:00,UFU FERRER,30,27,34,23,0,57,47,10,49,8,0,0,11,20,9,8,7,2,0,7,34,6,47
20201203,03DEC2020:00:00:00,UFU GRIERSON,13,5,14,4,0,18,18,0,18,0,0,1,5,4,6,2,0,0,0,3,14,1,18
20201203,03DEC2020:00:00:00,UFU GUTIERREZ,53,22,41,34,0,75,63,12,69,6,17,9,10,21,13,1,3,1,0,2,45,16,63
20201203,03DEC2020:00:00:00,UFU MUÑIZ,175,220,185,203,7,395,237,158,249,146,10,16,99,133,64,38,23,12,0,19,195,23,237
20201203,03DEC2020:00:00:00,UFU PENNA,6,5,7,4,0,11,7,4,9,2,0,0,1,6,2,0,2,0,0,0,6,1,7
20201203,03DEC2020:00:00:00,UFU PIROVANO,15,8,23,0,0,23,19,4,23,0,0,2,8,7,2,1,3,0,0,0,13,6,19
20201203,03DEC2020:00:00:00,UFU PIÑERO,22,25,32,14,1,47,39,8,39,8,6,3,8,14,5,7,2,2,0,1,32,6,39
20201203,03DEC2020:00:00:00,UFU RAMOS MEJIA,22,17,28,6,5,39,27,12,33,6,5,1,6,13,3,7,3,1,0,3,15,9,27
20201203,03DEC2020:00:00:00,UFU RIVADAVIA,118,90,136,65,7,208,188,20,190,18,0,3,66,72,22,29,11,5,0,12,137,39,188
20201203,03DEC2020:00:00:00,UFU SANTOJANNI,32,34,36,30,0,66,54,12,62,4,6,8,13,15,9,7,6,2,0,9,37,8,54
20201203,03DEC2020:00:00:00,UFU TORNU,5,9,6,8,0,14,12,2,12,2,0,0,2,7,3,2,0,0,0,0,9,3,12
20201203,03DEC2020:00:00:00,UFU VELEZ SARSFIELD,41,35,49,27,0,76,72,4,74,2,2,2,23,21,11,7,6,4,0,6,56,10,72
20201203,03DEC2020:00:00:00,UFU ZUBIZARRETA,13,12,12,13,0,25,23,2,25,0,1,1,3,7,9,1,3,0,0,1,4,18,23
20201204,04DEC2020:00:00:00,UFU ALVAREZ,51,64,87,28,0,115,107,8,107,8,1,7,25,32,20,14,10,6,0,11,82,14,107
20201204,04DEC2020:00:00:00,UFU ARGERICH,22,20,26,16,0,42,26,16,26,16,0,3,9,8,6,10,3,3,0,2,21,3,26
20201204,04DEC2020:00:00:00,UFU BORDA-MOYANO,15,3,7,11,0,18,18,0,18,0,0,0,3,2,9,2,1,1,0,2,15,1,18
20201204,04DEC2020:00:00:00,UFU DURAND,22,14,32,4,0,36,36,0,36,0,0,2,10,9,6,7,0,2,0,6,25,4,36
20201204,04DEC2020:00:00:00,UFU ELIZALDE,42,26,29,39,0,68,48,20,66,2,33,22,3,4,4,2,0,0,0,2,41,5,48
20201204,04DEC2020:00:00:00,UFU FERNANDEZ,15,24,33,6,0,39,37,2,37,2,0,0,14,10,8,2,3,2,0,6,23,8,37
20201204,04DEC2020:00:00:00,UFU FERRER,18,22,24,16,0,40,32,8,32,8,1,5,6,13,6,3,5,1,0,5,25,2,32
20201204,04DEC2020:00:00:00,UFU GRIERSON,20,19,27,12,0,39,39,0,39,0,0,2,10,9,7,5,6,0,0,7,21,11,39
20201204,04DEC2020:00:00:00,UFU GUTIERREZ,44,20,35,29,0,64,50,14,64,0,18,3,13,23,1,4,2,0,0,2,38,10,50
20201204,04DEC2020:00:00:00,UFU MUÑIZ,267,318,301,274,10,585,155,430,167,418,20,14,176,190,92,51,29,13,0,6,132,16,155
20201204,04DEC2020:00:00:00,UFU PENNA,19,5,23,1,0,24,20,4,24,0,0,0,5,3,6,3,5,2,0,2,14,3,20
20201204,04DEC2020:00:00:00,UFU PIROVANO,49,39,67,21,0,88,78,10,82,6,0,1,16,31,12,18,6,4,0,4,63,11,78
20201204,04DEC2020:00:00:00,UFU PIÑERO,25,32,31,17,9,57,49,8,51,6,3,3,17,8,16,5,3,2,0,2,41,6,49
20201204,04DEC2020:00:00:00,UFU RAMOS MEJIA,32,13,32,13,0,45,39,6,39,6,6,1,13,9,7,5,3,1,0,10,24,5,39
20201204,04DEC2020:00:00:00,UFU RIVADAVIA,97,86,138,37,8,183,151,32,151,32,0,5,58,43,39,12,13,13,0,11,109,31,151
20201204,04DEC2020:00:00:00,UFU SANTOJANNI,26,15,31,10,0,41,37,4,39,2,0,2,13,13,6,2,4,1,0,2,33,2,37
20201204,04DEC2020:00:00:00,UFU TORNU,25,29,42,12,0,54,42,12,46,8,0,2,20,13,6,1,11,1,0,2,21,18,42
20201204,04DEC2020:00:00:00,UFU VELEZ SARSFIELD,21,18,32,7,0,39,37,2,39,0,0,1,7,10,10,4,6,1,0,6,24,7,37
20201204,04DEC2020:00:00:00,UFU ZUBIZARRETA,22,16,28,10,0,38,34,4,38,0,2,0,9,6,6,7,8,0,0,0,4,30,34
20201205,05DEC2020:00:00:00,UFU ALVAREZ,47,44,80,11,0,91,79,12,83,8,2,3,15,25,17,10,13,6,0,12,39,27,79
20201205,05DEC2020:00:00:00,UFU BORDA-MOYANO,2,5,2,5,0,7,7,0,7,0,0,2,1,3,1,0,0,0,0,1,5,1,7
20201205,05DEC2020:00:00:00,UFU DURAND,16,15,26,5,0,31,29,2,31,0,4,3,5,4,7,1,4,3,0,4,22,3,29
20201205,05DEC2020:00:00:00,UFU ELIZALDE,9,15,9,15,0,24,20,4,22,2,15,4,1,2,1,1,0,0,0,1,17,2,20
20201205,05DEC2020:00:00:00,UFU FERNANDEZ,15,14,25,4,0,29,29,0,29,0,0,1,7,9,6,3,3,0,0,8,16,5,29
20201205,05DEC2020:00:00:00,UFU FERRER,31,18,32,17,0,49,41,8,41,8,3,3,10,16,6,6,5,0,0,2,33,6,41
20201205,05DEC2020:00:00:00,UFU GRIERSON,17,13,18,12,0,30,28,2,30,0,0,1,6,9,6,6,1,1,0,3,20,5,28
20201205,05DEC2020:00:00:00,UFU GUTIERREZ,26,15,30,11,0,41,33,8,37,4,10,4,8,11,3,4,0,1,0,0,26,7,33
20201205,05DEC2020:00:00:00,UFU MUÑIZ,127,151,179,99,0,278,82,196,84,194,9,13,63,83,52,35,19,4,0,5,69,8,82
20201205,05DEC2020:00:00:00,UFU PENNA,13,4,11,6,0,17,15,2,15,2,0,2,0,7,1,4,3,0,0,2,12,1,15
20201205,05DEC2020:00:00:00,UFU PIROVANO,38,38,55,19,2,76,62,14,70,6,0,3,13,16,16,14,2,12,0,14,38,10,62
20201205,05DEC2020:00:00:00,UFU PIÑERO,23,11,22,12,0,34,30,4,30,4,2,2,10,5,8,1,2,4,0,5,18,7,30
20201205,05DEC2020:00:00:00,UFU RAMOS MEJIA,5,14,16,2,1,19,17,2,19,0,0,1,10,3,2,2,1,0,0,8,8,1,17
20201205,05DEC2020:00:00:00,UFU RIVADAVIA,57,50,93,12,2,107,93,14,93,14,0,2,38,29,12,14,6,6,0,8,65,20,93
20201205,05DEC2020:00:00:00,UFU SANTOJANNI,29,11,14,26,0,40,36,4,40,0,1,7,7,8,7,5,5,0,0,6,23,7,36
20201205,05DEC2020:00:00:00,UFU TORNU,22,26,28,20,0,48,38,10,42,6,2,0,12,13,9,5,6,1,0,5,24,9,38
20201205,05DEC2020:00:00:00,UFU VELEZ SARSFIELD,25,17,31,11,0,42,37,5,37,5,0,1,12,6,10,7,5,1,0,2,32,3,37
20201205,05DEC2020:00:00:00,UFU ZUBIZARRETA,9,9,9,9,0,18,16,2,18,0,0,2,4,7,3,2,0,0,0,3,13,0,16
20201206,06DEC2020:00:00:00,UFU ALVAREZ,63,67,93,37,0,130,44,86,44,86,11,7,32,36,13,16,11,4,0,3,30,11,44
20201206,06DEC2020:00:00:00,UFU DURAND,20,20,27,12,1,40,34,6,38,2,7,0,9,14,5,5,0,0,0,6,21,7,34
20201206,06DEC2020:00:00:00,UFU ELIZALDE,17,12,6,21,2,29,21,8,25,4,9,11,0,7,1,1,0,0,0,0,17,4,21
20201206,06DEC2020:00:00:00,UFU FERNANDEZ,36,10,36,10,0,46,32,14,46,0,0,3,16,12,6,4,5,0,0,4,21,7,32
20201206,06DEC2020:00:00:00,UFU FERRER,10,7,9,8,0,17,15,2,15,2,0,0,3,6,2,4,2,0,0,2,11,2,15
20201206,06DEC2020:00:00:00,UFU GRIERSON,12,8,8,12,0,20,20,0,20,0,0,0,5,7,4,4,0,0,0,2,10,8,20
20201206,06DEC2020:00:00:00,UFU GUTIERREZ,18,12,23,7,0,30,28,2,28,2,9,8,2,8,1,1,1,0,0,0,23,5,28
20201206,06DEC2020:00:00:00,UFU MUÑIZ,88,97,112,73,0,185,73,112,99,86,5,10,60,52,25,18,5,10,0,7,58,8,73
20201206,06DEC2020:00:00:00,UFU PENNA,10,5,10,5,0,15,9,6,13,2,0,0,2,2,4,4,1,2,0,3,3,3,9
20201206,06DEC2020:00:00:00,UFU PIROVANO,30,27,49,6,2,57,55,2,55,2,0,1,12,22,5,9,5,3,0,10,34,11,55
20201206,06DEC2020:00:00:00,UFU PIÑERO,15,12,15,10,2,27,23,4,23,4,1,0,2,7,6,3,2,6,0,2,18,3,23
20201206,06DEC2020:00:00:00,UFU RAMOS MEJIA,2,6,8,0,0,8,8,0,8,0,0,1,1,2,0,2,2,0,0,0,2,6,8
20201206,06DEC2020:00:00:00,UFU RIVADAVIA,44,26,62,8,0,70,58,12,58,12,2,1,24,19,9,6,6,3,0,1,53,4,58
20201206,06DEC2020:00:00:00,UFU SANTOJANNI,12,13,16,9,0,25,23,2,25,0,3,0,4,8,4,2,1,3,0,3,18,2,23
20201206,06DEC2020:00:00:00,UFU TORNU,11,17,10,16,2,28,28,0,28,0,1,1,12,6,2,2,2,2,0,3,18,7,28
20201206,06DEC2020:00:00:00,UFU VELEZ SARSFIELD,16,17,23,10,0,33,33,0,33,0,0,1,6,9,9,2,6,0,0,6,23,4,33
20201206,06DEC2020:00:00:00,UFU ZUBIZARRETA,11,14,19,6,0,25,21,4,23,2,0,2,8,5,5,2,2,1,0,3,16,2,21
20201207,07DEC2020:00:00:00,UFU ALVAREZ,49,43,57,33,2,92,90,2,90,2,6,10,21,18,17,8,10,2,0,8,58,24,90
20201207,07DEC2020:00:00:00,UFU BORDA-MOYANO,17,6,15,8,0,23,21,2,21,2,0,0,8,8,5,1,1,0,0,1,13,7,21
20201207,07DEC2020:00:00:00,UFU DURAND,10,13,20,3,0,23,23,0,23,0,1,1,5,5,7,3,1,0,0,4,16,3,23
20201207,07DEC2020:00:00:00,UFU ELIZALDE,22,17,14,25,0,39,35,4,39,0,19,6,3,5,5,1,0,0,0,0,31,4,35
20201207,07DEC2020:00:00:00,UFU FERNANDEZ,18,13,27,4,0,31,29,2,29,2,0,2,6,11,6,4,0,2,0,7,19,3,29
20201207,07DEC2020:00:00:00,UFU FERRER,15,19,20,14,0,34,30,4,30,4,0,0,9,8,8,4,2,3,0,7,21,2,30
20201207,07DEC2020:00:00:00,UFU GRIERSON,15,11,10,16,0,26,24,2,26,0,0,1,6,6,7,6,0,0,0,5,13,6,24
20201207,07DEC2020:00:00:00,UFU GUTIERREZ,40,19,37,22,0,59,51,8,55,4,17,11,7,12,8,2,2,0,0,2,37,11,51
20201207,07DEC2020:00:00:00,UFU MUÑIZ,101,121,104,117,1,222,130,92,132,90,5,8,70,68,37,17,12,5,0,7,105,18,130
20201207,07DEC2020:00:00:00,UFU PENNA,16,8,17,7,0,24,18,6,18,6,0,4,5,2,2,7,3,1,0,1,12,3,18
20201207,07DEC2020:00:00:00,UFU PIROVANO,33,24,49,8,0,57,55,2,57,0,1,2,16,12,6,9,8,3,0,5,44,6,55
20201207,07DEC2020:00:00:00,UFU PIÑERO,13,8,16,0,5,21,17,4,17,4,2,1,4,1,2,5,6,0,0,1,12,4,17
20201207,07DEC2020:00:00:00,UFU RAMOS MEJIA,19,24,30,13,0,43,33,10,35,8,1,3,15,13,6,0,5,0,0,8,20,5,33
20201207,07DEC2020:00:00:00,UFU RIVADAVIA,72,83,119,34,2,155,109,46,109,46,0,3,71,42,17,15,4,3,0,6,79,20,109
20201207,07DEC2020:00:00:00,UFU SANTOJANNI,24,27,30,21,0,51,49,2,49,2,3,3,13,12,5,6,4,5,0,9,33,7,49
20201207,07DEC2020:00:00:00,UFU TORNU,26,29,25,27,3,55,47,8,53,2,4,2,12,10,15,6,1,5,0,3,31,13,47
20201207,07DEC2020:00:00:00,UFU VELEZ SARSFIELD,38,32,45,25,0,70,64,6,64,6,0,2,17,19,19,6,5,2,0,4,43,17,64
20201207,07DEC2020:00:00:00,UFU ZUBIZARRETA,22,42,49,15,0,64,54,10,58,6,0,3,10,8,18,10,10,5,0,6,42,6,54
20201208,08DEC2020:00:00:00,UFU ALVAREZ,53,47,83,17,0,100,86,14,86,14,10,1,24,30,16,8,5,6,0,3,62,21,86
20201208,08DEC2020:00:00:00,UFU BORDA-MOYANO,2,0,0,2,0,2,2,0,2,0,0,0,0,1,0,0,1,0,0,0,2,0,2
20201208,08DEC2020:00:00:00,UFU DURAND,18,13,28,3,0,31,31,0,31,0,0,0,8,6,9,5,3,0,0,7,19,5,31
20201208,08DEC2020:00:00:00,UFU ELIZALDE,35,22,16,38,3,57,47,10,51,6,20,12,9,5,6,4,1,0,0,2,37,8,47
20201208,08DEC2020:00:00:00,UFU FERNANDEZ,29,11,32,8,0,40,38,2,40,0,0,0,10,13,8,4,3,2,0,5,28,5,38
20201208,08DEC2020:00:00:00,UFU FERRER,17,17,19,15,0,34,30,4,30,4,0,0,6,10,11,3,4,0,0,4,26,0,30
20201208,08DEC2020:00:00:00,UFU GRIERSON,15,14,18,11,0,29,29,0,29,0,2,3,7,3,6,3,5,0,0,7,20,2,29
20201208,08DEC2020:00:00:00,UFU GUTIERREZ,25,27,25,27,0,52,46,6,50,2,20,16,4,8,0,4,0,0,0,0,32,14,46
20201208,08DEC2020:00:00:00,UFU MUÑIZ,126,157,157,126,0,283,165,118,169,114,4,7,89,64,41,37,26,15,0,10,126,29,165
20201208,08DEC2020:00:00:00,UFU PENNA,8,9,9,8,0,17,13,4,13,4,0,0,6,0,1,4,4,2,0,0,11,2,13
20201208,08DEC2020:00:00:00,UFU PIROVANO,31,32,53,10,0,63,61,2,61,2,0,2,20,12,10,12,4,3,0,10,41,10,61
20201208,08DEC2020:00:00:00,UFU PIÑERO,13,14,23,3,1,27,23,4,25,2,3,1,9,10,1,2,1,0,0,5,17,1,23
20201208,08DEC2020:00:00:00,UFU RAMOS MEJIA,11,12,15,8,0,23,19,4,19,4,0,0,3,2,7,6,2,3,0,1,14,4,19
20201208,08DEC2020:00:00:00,UFU RIVADAVIA,57,54,98,13,0,111,109,2,111,0,0,3,28,35,21,12,7,5,0,3,91,13,109
20201208,08DEC2020:00:00:00,UFU SANTOJANNI,27,23,25,23,2,50,42,8,46,4,0,3,14,9,5,12,4,3,0,10,25,7,42
20201208,08DEC2020:00:00:00,UFU TORNU,24,23,19,27,1,47,45,2,45,2,1,2,4,12,11,6,3,8,0,5,28,12,45
20201208,08DEC2020:00:00:00,UFU VELEZ SARSFIELD,34,16,37,11,2,50,48,2,48,2,0,2,15,14,5,1,6,7,0,5,28,15,48
20201208,08DEC2020:00:00:00,UFU ZUBIZARRETA,30,28,37,19,2,58,46,12,50,8,1,4,20,7,13,7,3,3,0,7,30,9,46
20201209,09DEC2020:00:00:00,UFU ALVAREZ,91,102,153,40,0,193,183,10,183,10,2,15,40,39,43,24,27,3,0,4,45,133,183
20201209,09DEC2020:00:00:00,UFU ARGERICH,51,58,80,29,0,109,89,20,89,20,2,5,25,37,18,10,7,5,0,9,59,19,89
20201209,09DEC2020:00:00:00,UFU BORDA-MOYANO,11,1,9,3,0,12,12,0,12,0,0,1,3,1,3,1,1,2,0,0,9,3,12
20201209,09DEC2020:00:00:00,UFU DURAND,30,21,43,8,0,51,47,4,49,2,1,1,13,23,9,1,3,0,0,9,30,8,47
20201209,09DEC2020:00:00:00,UFU ELIZALDE,42,37,13,66,0,79,61,18,69,10,39,16,5,7,10,2,0,0,0,1,51,9,61
20201209,09DEC2020:00:00:00,UFU FERNANDEZ,47,35,70,12,0,82,78,4,78,4,0,7,26,20,17,8,3,1,0,11,48,19,78
20201209,09DEC2020:00:00:00,UFU FERRER,28,27,30,25,0,55,51,4,51,4,0,0,16,16,11,6,6,0,0,8,39,4,51
20201209,09DEC2020:00:00:00,UFU GRIERSON,40,42,54,28,0,82,76,6,76,6,0,5,30,24,14,1,4,4,0,3,21,52,76
20201209,09DEC2020:00:00:00,UFU GUTIERREZ,61,43,57,47,0,104,72,32,86,18,32,26,6,20,15,5,0,0,0,1,56,15,72
20201209,09DEC2020:00:00:00,UFU MUÑIZ,220,231,221,221,9,451,245,206,269,182,15,24,115,107,47,83,38,22,0,13,213,19,245
20201209,09DEC2020:00:00:00,UFU PENNA,16,14,15,15,0,30,24,6,26,4,0,1,8,7,5,4,0,5,0,3,15,5,24
20201209,09DEC2020:00:00:00,UFU PIROVANO,78,59,109,26,2,137,123,14,127,10,0,10,30,28,26,16,16,11,0,20,74,29,123
20210104,04JAN2021:00:00:00,UFU ALVAREZ,116,117,182,51,0,233,125,108,127,106,7,21,55,49,37,33,27,4,0,15,40,70,125
20210104,04JAN2021:00:00:00,UFU ARGERICH,62,44,49,57,0,106,84,22,84,22,0,1,23,37,19,15,11,0,0,12,34,36,84
20210104,04JAN2021:00:00:00,UFU BORDA-MOYANO,37,48,62,21,2,85,77,8,77,8,0,4,16,27,16,11,9,2,0,8,37,32,77
20210104,04JAN2021:00:00:00,UFU DURAND,72,52,94,25,5,124,120,4,122,2,4,5,32,26,19,26,5,7,0,25,50,45,120
20210104,04JAN2021:00:00:00,UFU ELIZALDE,67,54,40,81,0,121,101,20,115,6,65,24,11,13,6,1,1,0,0,3,58,40,101
20210104,04JAN2021:00:00:00,UFU FERNANDEZ,109,82,157,30,4,191,177,14,181,10,0,4,60,61,24,21,17,4,0,37,71,69,177
20210104,04JAN2021:00:00:00,UFU FERRER,51,58,55,54,0,109,105,4,105,4,0,0,38,28,23,8,8,4,0,19,67,19,105
20210104,04JAN2021:00:00:00,UFU GRIERSON,78,59,76,59,2,137,131,6,131,6,0,5,47,26,31,20,6,2,0,39,88,4,131
20210104,04JAN2021:00:00:00,UFU GUTIERREZ,107,47,74,78,2,154,144,10,154,0,58,29,20,14,17,10,6,0,0,4,82,58,144
20210104,04JAN2021:00:00:00,UFU MUÑIZ,185,150,141,179,15,335,217,118,223,112,0,16,70,92,60,64,27,6,0,33,159,25,217
20210104,04JAN2021:00:00:00,UFU PENNA,24,19,29,14,0,43,37,6,37,6,0,2,9,11,6,4,3,8,0,6,18,13,37
20210104,04JAN2021:00:00:00,UFU PIROVANO,112,115,139,60,28,227,211,16,219,8,2,8,69,70,30,21,12,15,0,39,83,88,211
20210104,04JAN2021:00:00:00,UFU PIÑERO,96,76,113,47,12,172,136,36,146,26,0,5,47,40,43,21,10,6,0,34,66,35,136
20210104,04JAN2021:00:00:00,UFU RAMOS MEJIA,101,92,145,45,3,193,179,14,183,10,9,8,58,65,24,16,3,10,0,31,47,101,179
20210104,04JAN2021:00:00:00,UFU RIVADAVIA,187,155,220,116,6,342,252,90,252,90,0,8,108,88,72,40,17,9,0,35,108,107,252
20210104,04JAN2021:00:00:00,UFU SANTOJANNI,124,86,106,100,4,210,202,8,210,0,1,4,72,52,27,38,11,5,0,33,82,87,202
20210104,04JAN2021:00:00:00,UFU TORNU,78,76,128,24,2,154,150,4,152,2,1,7,51,38,23,22,10,2,0,30,56,64,150
20210104,04JAN2021:00:00:00,UFU VELEZ SARSFIELD,53,51,76,28,0,104,104,0,104,0,0,4,31,25,15,12,12,5,0,22,47,35,104
20210104,04JAN2021:00:00:00,UFU ZUBIZARRETA,1,3,3,1,0,4,2,2,2,2,0,0,1,1,1,1,0,0,0,0,2,0,2
20210105,05JAN2021:00:00:00,UFU ALVAREZ,134,118,169,82,1,252,234,18,234,18,9,16,73,67,42,22,16,7,0,41,83,107,234
20210105,05JAN2021:00:00:00,UFU ARGERICH,50,58,67,41,0,108,90,18,90,18,0,13,25,37,10,10,7,6,0,13,38,38,90
20210105,05JAN2021:00:00:00,UFU BORDA-MOYANO,64,44,65,35,8,108,106,2,106,2,0,5,25,23,26,21,3,5,0,12,49,41,106
20210105,05JAN2021:00:00:00,UFU DURAND,43,39,70,12,0,82,82,0,82,0,0,0,27,26,13,9,7,0,0,21,29,32,82
20210105,05JAN2021:00:00:00,UFU ELIZALDE,54,31,19,61,5,85,61,24,81,4,42,22,2,13,3,1,2,0,0,1,38,22,61
20210105,05JAN2021:00:00:00,UFU FERNANDEZ,90,82,153,17,2,172,164,8,164,8,0,3,52,66,20,11,16,4,0,33,65,66,164
20210105,05JAN2021:00:00:00,UFU FERRER,54,59,58,55,0,113,107,6,107,6,0,5,33,29,21,21,4,0,0,26,57,24,107
20210105,05JAN2021:00:00:00,UFU GRIERSON,75,65,75,65,0,140,134,6,134,6,0,3,39,37,29,10,18,4,0,36,48,50,134
20210105,05JAN2021:00:00:00,UFU GUTIERREZ,98,44,61,81,0,142,110,32,140,2,45,33,14,22,18,4,6,0,0,8,51,51,110
20210105,05JAN2021:00:00:00,UFU MUÑIZ,240,217,232,209,16,457,321,136,339,118,3,13,84,152,104,59,24,18,0,45,234,42,321
20210105,05JAN2021:00:00:00,UFU PENNA,30,36,49,15,2,66,62,4,62,4,0,2,15,23,7,5,11,3,0,14,25,23,62
20210105,05JAN2021:00:00:00,UFU PIROVANO,112,83,121,45,29,195,169,26,187,8,0,3,62,59,30,20,13,8,0,22,76,71,169
20210105,05JAN2021:00:00:00,UFU PIÑERO,82,64,97,42,7,146,138,8,140,6,0,7,40,39,36,18,4,2,0,18,93,27,138
20210105,05JAN2021:00:00:00,UFU RAMOS MEJIA,66,65,110,13,8,131,119,12,119,12,2,4,39,32,28,13,7,6,0,26,43,50,119
20210105,05JAN2021:00:00:00,UFU RIVADAVIA,148,117,168,86,11,265,231,34,233,32,0,6,105,68,35,29,13,9,0,42,90,97,231
20210105,05JAN2021:00:00:00,UFU SANTOJANNI,143,130,149,124,0,273,259,14,267,6,1,3,90,75,37,44,14,9,0,43,110,106,259
20210105,05JAN2021:00:00:00,UFU TORNU,78,82,136,24,0,160,136,24,146,14,3,7,53,42,20,18,9,8,0,24,56,56,136
20210105,05JAN2021:00:00:00,UFU VELEZ SARSFIELD,44,55,77,22,0,99,99,0,99,0,0,1,16,26,27,20,4,5,0,32,37,30,99
20210105,05JAN2021:00:00:00,UFU ZUBIZARRETA,33,23,39,17,0,56,56,0,56,0,0,1,17,8,12,6,10,2,0,3,0,53,56
20210106,06JAN2021:00:00:00,UFU ALVAREZ,165,115,210,68,2,280,220,60,224,56,13,10,67,88,45,25,27,5,0,43,92,85,220
20210106,06JAN2021:00:00:00,UFU ARGERICH,56,62,68,47,3,118,94,24,94,24,6,5,30,21,23,11,15,7,0,23,30,39,94
20210106,06JAN2021:00:00:00,UFU BORDA-MOYANO,65,50,83,28,4,115,109,6,109,6,0,6,29,29,26,17,6,2,0,4,62,43,109
20210106,06JAN2021:00:00:00,UFU DURAND,49,57,85,20,1,106,104,2,106,0,2,0,26,37,17,14,7,3,0,28,37,39,104
20210106,06JAN2021:00:00:00,UFU ELIZALDE,70,52,24,95,3,122,92,30,112,10,65,17,16,10,7,7,0,0,0,7,49,36,92
20210106,06JAN2021:00:00:00,UFU FERNANDEZ,121,60,149,30,2,181,145,36,153,28,0,4,50,50,36,19,15,7,0,26,54,65,145
20210106,06JAN2021:00:00:00,UFU FERRER,70,94,82,82,0,164,158,6,158,6,0,7,65,34,29,21,6,2,0,36,65,57,158
20210106,06JAN2021:00:00:00,UFU GRIERSON,65,65,71,59,0,130,124,6,124,6,0,5,45,36,18,18,7,1,0,43,71,10,124
20210106,06JAN2021:00:00:00,UFU GUTIERREZ,121,73,119,71,4,194,124,70,176,18,59,36,22,28,29,15,3,2,0,3,69,52,124
20210106,06JAN2021:00:00:00,UFU MUÑIZ,208,217,209,203,13,425,285,140,291,134,2,7,95,133,88,58,31,11,0,29,229,27,285
20210106,06JAN2021:00:00:00,UFU PENNA,39,23,43,17,2,62,58,4,62,0,0,2,17,5,14,9,6,9,0,12,33,13,58
20210106,06JAN2021:00:00:00,UFU PIROVANO,119,69,163,19,6,188,172,16,182,6,2,2,49,53,34,22,18,8,0,21,83,68,172
20210106,06JAN2021:00:00:00,UFU PIÑERO,118,99,145,44,28,217,209,8,209,8,0,11,56,44,40,40,15,11,0,19,175,15,209
20210106,06JAN2021:00:00:00,UFU RAMOS MEJIA,103,62,130,32,3,165,151,14,155,10,6,5,58,38,28,12,12,6,0,24,63,61,151
20210106,06JAN2021:00:00:00,UFU RIVADAVIA,238,168,256,128,22,406,378,28,380,26,0,8,124,121,57,57,35,4,0,51,158,163,378
20210106,06JAN2021:00:00:00,UFU SANTOJANNI,141,125,152,112,2,266,254,12,264,2,4,7,65,80,39,45,23,3,0,58,96,100,254
20210106,06JAN2021:00:00:00,UFU TORNU,87,96,144,34,5,183,165,18,169,14,4,16,54,48,31,10,18,2,0,26,66,73,165
20210106,06JAN2021:00:00:00,UFU VELEZ SARSFIELD,86,43,106,23,0,129,129,0,129,0,0,3,41,29,22,24,8,2,0,30,55,43,129
20210106,06JAN2021:00:00:00,UFU ZUBIZARRETA,17,7,13,9,2,24,22,2,22,2,0,0,4,8,3,4,5,0,0,3,12,7,22
20210107,07JAN2021:00:00:00,UFU ALVAREZ,112,116,137,84,7,228,210,18,214,14,9,12,57,47,47,31,22,3,0,30,91,89,210
20210107,07JAN2021:00:00:00,UFU ARGERICH,33,38,39,29,3,71,40,31,40,31,4,2,11,18,23,2,5,6,0,7,14,19,40
20210107,07JAN2021:00:00:00,UFU BORDA-MOYANO,30,41,32,37,2,71,69,2,69,2,2,3,14,18,11,13,9,1,0,3,36,30,69
20210107,07JAN2021:00:00:00,UFU DURAND,59,64,113,6,4,123,113,10,113,10,4,2,29,40,19,15,14,0,0,17,51,45,113
20210107,07JAN2021:00:00:00,UFU ELIZALDE,66,78,44,100,0,144,108,36,128,16,59,38,18,11,7,5,6,0,0,3,63,42,108
20210107,07JAN2021:00:00:00,UFU FERNANDEZ,124,80,164,38,2,204,198,6,202,2,0,3,61,59,24,32,18,7,0,32,89,77,198
20210107,07JAN2021:00:00:00,UFU FERRER,67,63,61,69,0,130,122,8,122,8,0,0,41,35,31,19,4,0,0,16,62,44,122
20210107,07JAN2021:00:00:00,UFU GRIERSON,67,40,51,54,2,107,101,6,103,4,0,16,27,19,30,13,2,0,0,25,64,12,101
20210107,07JAN2021:00:00:00,UFU GUTIERREZ,48,38,47,39,0,86,74,12,86,0,26,19,11,19,7,2,2,0,0,8,33,32,74
20210107,07JAN2021:00:00:00,UFU MUÑIZ,184,200,177,185,22,384,298,86,314,70,0,4,117,90,68,68,20,17,0,37,216,44,298
20210107,07JAN2021:00:00:00,UFU PENNA,34,33,48,19,0,67,59,8,61,6,0,4,19,12,15,10,4,3,0,8,32,19,59
20210107,07JAN2021:00:00:00,UFU PIROVANO,114,105,167,50,2,219,213,6,213,6,0,0,70,73,29,28,16,3,0,33,90,90,213
20210107,07JAN2021:00:00:00,UFU PIÑERO,92,82,119,49,6,174,166,8,168,6,0,4,35,56,28,22,18,11,0,28,121,15,166
20210107,07JAN2021:00:00:00,UFU RAMOS MEJIA,89,84,131,40,2,173,159,14,165,8,4,7,49,60,18,26,5,4,0,31,58,70,159
20210107,07JAN2021:00:00:00,UFU RIVADAVIA,223,165,226,147,15,388,356,32,356,32,0,7,115,110,77,57,16,6,0,38,158,157,356
20210107,07JAN2021:00:00:00,UFU SANTOJANNI,140,145,127,148,10,285,265,20,277,8,4,16,80,62,52,44,20,7,0,20,63,182,265
20210107,07JAN2021:00:00:00,UFU TORNU,108,92,156,42,2,200,182,18,182,18,1,3,70,52,20,32,14,8,0,32,71,79,182
20210107,07JAN2021:00:00:00,UFU VELEZ SARSFIELD,95,76,138,32,1,171,167,4,169,2,0,3,32,47,29,31,13,16,0,43,70,54,167
20210107,07JAN2021:00:00:00,UFU ZUBIZARRETA,32,30,42,18,2,62,56,6,56,6,0,1,20,11,6,13,7,4,0,6,28,22,56
20210108,08JAN2021:00:00:00,UFU ALVAREZ,161,122,195,76,12,283,261,22,261,22,6,10,66,83,23,35,43,17,0,23,54,184,261
20210108,08JAN2021:00:00:00,UFU ARGERICH,42,35,48,27,2,77,59,18,59,18,2,3,22,22,9,11,3,5,0,6,26,27,59
20210108,08JAN2021:00:00:00,UFU BORDA-MOYANO,78,63,86,53,2,141,139,2,139,2,0,13,32,21,39,18,13,5,0,5,79,55,139
20210108,08JAN2021:00:00:00,UFU DURAND,101,72,158,15,0,173,163,10,163,10,2,13,51,54,24,10,17,2,0,27,68,68,163
20210108,08JAN2021:00:00:00,UFU ELIZALDE,71,35,33,73,0,106,84,22,94,12,43,21,12,9,13,8,0,0,0,5,49,30,84
20210108,08JAN2021:00:00:00,UFU FERNANDEZ,81,72,123,30,0,153,143,10,145,8,0,1,54,55,18,15,6,4,0,21,64,58,143
20210108,08JAN2021:00:00:00,UFU FERRER,83,71,70,81,3,154,144,10,146,8,0,0,57,67,19,10,1,0,0,26,67,50,144
20210108,08JAN2021:00:00:00,UFU GRIERSON,67,59,68,58,0,126,120,6,120,6,0,2,31,30,28,19,12,4,0,39,65,16,120
20210108,08JAN2021:00:00:00,UFU GUTIERREZ,77,50,76,51,0,127,109,18,127,0,46,30,15,18,9,7,0,2,0,1,54,53,109
20210108,08JAN2021:00:00:00,UFU MUÑIZ,191,205,178,207,11,396,280,116,288,108,2,6,114,123,72,49,20,10,0,42,218,20,280
20210108,08JAN2021:00:00:00,UFU PENNA,34,44,60,14,4,78,72,6,76,2,0,5,30,11,12,15,5,0,0,16,27,29,72
20210108,08JAN2021:00:00:00,UFU PIROVANO,127,97,178,46,0,224,204,20,214,10,0,5,80,59,36,25,12,7,0,31,89,83,204
20210108,08JAN2021:00:00:00,UFU PIÑERO,122,91,135,55,23,213,197,16,201,12,3,10,66,43,38,35,9,9,0,32,146,19,197
20210108,08JAN2021:00:00:00,UFU RAMOS MEJIA,100,109,146,51,12,209,197,12,197,12,9,15,58,67,26,16,13,5,0,27,69,101,197
20210108,08JAN2021:00:00:00,UFU RIVADAVIA,168,136,172,98,34,304,286,18,288,16,0,10,98,84,41,41,26,4,0,31,143,111,286
20210108,08JAN2021:00:00:00,UFU SANTOJANNI,155,150,167,136,2,305,293,12,299,6,2,14,85,87,53,29,31,4,0,7,14,272,293
20210108,08JAN2021:00:00:00,UFU TORNU,83,72,112,39,4,155,141,14,141,14,3,5,44,38,21,33,10,1,0,31,52,58,141
20210108,08JAN2021:00:00:00,UFU VELEZ SARSFIELD,82,46,98,28,2,128,120,8,124,4,0,3,36,31,25,24,6,3,0,30,57,33,120
20210108,08JAN2021:00:00:00,UFU ZUBIZARRETA,33,38,37,28,6,71,69,2,69,2,0,2,20,13,12,13,8,3,0,8,35,26,69
20210109,09JAN2021:00:00:00,UFU ALVAREZ,110,64,138,36,0,174,164,10,164,10,10,4,44,32,45,23,10,6,0,15,22,127,164
20210109,09JAN2021:00:00:00,UFU BORDA-MOYANO,33,26,32,25,2,59,59,0,59,0,0,0,9,23,9,7,9,2,0,6,27,26,59
20210109,09JAN2021:00:00:00,UFU DURAND,52,42,83,11,0,94,92,2,92,2,5,5,31,24,8,9,7,5,0,23,32,37,92
20210109,09JAN2021:00:00:00,UFU ELIZALDE,64,34,29,69,0,98,70,28,90,8,62,16,3,6,3,6,2,0,0,1,40,29,70
20210109,09JAN2021:00:00:00,UFU FERNANDEZ,95,73,150,16,2,168,156,12,156,12,0,4,45,39,32,27,9,12,0,26,63,67,156
20210109,09JAN2021:00:00:00,UFU FERRER,57,60,41,74,2,117,111,6,111,6,2,0,51,27,18,13,3,3,0,16,53,42,111
20210109,09JAN2021:00:00:00,UFU GRIERSON,51,42,50,43,0,93,93,0,93,0,0,1,25,25,15,10,12,5,0,27,54,12,93
20210109,09JAN2021:00:00:00,UFU GUTIERREZ,55,32,39,46,2,87,81,6,87,0,34,14,4,18,8,9,0,0,0,4,41,35,81
20210109,09JAN2021:00:00:00,UFU MUÑIZ,175,166,164,166,11,341,251,90,265,76,0,9,100,78,83,44,21,6,0,38,165,47,251
20210109,09JAN2021:00:00:00,UFU PENNA,36,26,47,15,0,62,56,6,60,2,0,0,16,14,17,5,8,2,0,8,26,22,56
20210109,09JAN2021:00:00:00,UFU PIROVANO,115,87,173,29,0,202,198,4,200,2,0,0,58,66,36,26,9,7,0,24,85,89,198
20210109,09JAN2021:00:00:00,UFU PIÑERO,50,44,60,34,0,94,81,13,81,13,0,0,19,21,18,24,12,0,0,10,61,10,81
20210109,09JAN2021:00:00:00,UFU RAMOS MEJIA,59,48,58,43,6,107,97,10,97,10,8,7,24,20,21,12,5,10,0,15,37,45,97
20210109,09JAN2021:00:00:00,UFU RIVADAVIA,146,102,194,50,4,248,228,20,228,20,0,2,69,84,40,28,8,17,0,34,102,92,228
20210109,09JAN2021:00:00:00,UFU SANTOJANNI,113,79,100,88,4,192,182,10,184,8,4,9,46,52,37,20,17,7,0,20,89,73,182
20210109,09JAN2021:00:00:00,UFU TORNU,82,41,62,30,31,123,109,14,113,10,10,7,33,31,21,13,8,0,0,15,51,43,109
20210109,09JAN2021:00:00:00,UFU VELEZ SARSFIELD,99,87,152,34,0,186,184,2,186,0,0,7,63,44,27,17,16,12,0,38,87,59,184
20210109,09JAN2021:00:00:00,UFU ZUBIZARRETA,110,89,140,59,0,199,185,14,187,12,0,8,62,30,43,35,10,11,0,23,96,66,185
20210110,10JAN2021:00:00:00,UFU ALVAREZ,32,13,31,14,0,45,39,6,39,6,5,0,2,9,7,11,1,10,0,3,23,13,39
20210110,10JAN2021:00:00:00,UFU BORDA-MOYANO,15,23,16,22,0,38,38,0,38,0,0,4,13,9,12,0,0,0,0,0,21,17,38
20210110,10JAN2021:00:00:00,UFU ELIZALDE,45,40,16,68,1,85,63,22,75,10,43,23,2,6,8,2,1,0,0,4,36,23,63
20210110,10JAN2021:00:00:00,UFU FERNANDEZ,99,60,142,17,0,159,147,12,159,0,0,7,31,51,29,16,18,7,0,26,59,62,147
20210110,10JAN2021:00:00:00,UFU FERRER,56,44,51,49,0,100,98,2,98,2,0,3,18,31,25,13,7,3,0,7,49,42,98
20210110,10JAN2021:00:00:00,UFU GRIERSON,61,43,55,47,2,104,100,4,102,2,0,3,32,20,27,12,10,0,0,20,61,19,100
20210110,10JAN2021:00:00:00,UFU GUTIERREZ,49,39,47,41,0,88,84,4,86,2,21,28,12,17,7,1,0,2,0,4,44,36,84
20210110,10JAN2021:00:00:00,UFU MUÑIZ,116,113,95,117,17,229,167,62,179,50,0,4,64,45,58,38,18,2,0,18,126,23,167
20210110,10JAN2021:00:00:00,UFU PENNA,18,8,16,10,0,26,20,6,26,0,0,2,2,10,5,4,3,0,0,0,12,8,20
20210110,10JAN2021:00:00:00,UFU PIROVANO,70,62,114,16,2,132,130,2,132,0,0,0,41,33,30,15,8,5,0,26,49,55,130
20210110,10JAN2021:00:00:00,UFU PIÑERO,75,49,96,27,1,124,118,6,120,4,0,7,34,28,13,27,11,4,0,23,84,11,118
20210110,10JAN2021:00:00:00,UFU RAMOS MEJIA,33,40,51,21,1,73,69,4,69,4,4,4,13,16,18,10,2,6,0,17,28,24,69
20210110,10JAN2021:00:00:00,UFU RIVADAVIA,128,95,170,45,8,223,199,24,199,24,0,2,74,54,33,24,16,20,0,27,95,75,199
20210110,10JAN2021:00:00:00,UFU SANTOJANNI,97,91,116,66,6,188,178,10,182,6,2,6,29,74,29,26,16,6,0,4,1,173,178
20210110,10JAN2021:00:00:00,UFU TORNU,45,30,39,30,6,75,73,2,75,0,7,7,16,17,11,13,2,2,0,15,30,27,73
20210110,10JAN2021:00:00:00,UFU VELEZ SARSFIELD,76,70,116,30,0,146,144,2,146,0,0,6,41,35,22,18,17,7,0,38,59,47,144
20210110,10JAN2021:00:00:00,UFU ZUBIZARRETA,106,91,152,45,0,197,173,24,173,24,0,14,56,43,26,27,18,13,0,20,93,60,173
20210111,11JAN2021:00:00:00,UFU ALVAREZ,146,164,213,70,27,310,174,136,176,134,11,8,86,77,59,30,28,11,0,26,78,70,174
20210111,11JAN2021:00:00:00,UFU ARGERICH,71,35,68,37,1,106,94,12,94,12,6,2,34,24,17,12,9,2,0,14,38,40,94
20210114,14JAN2021:00:00:00,UFU PENNA,30,29,37,19,3,59,45,14,57,2,0,0,4,14,24,12,5,0,0,4,27,14,45
20210114,14JAN2021:00:00:00,UFU PIROVANO,100,109,180,27,2,209,189,20,205,4,0,4,64,57,38,21,16,9,0,29,79,81,189
20210114,14JAN2021:00:00:00,UFU PIÑERO,90,76,101,52,13,166,158,8,160,6,1,10,38,28,42,31,12,4,0,17,128,13,158
20210114,14JAN2021:00:00:00,UFU RAMOS MEJIA,128,121,150,89,10,249,229,20,245,4,3,17,61,50,62,28,21,7,0,26,135,66,229
20210114,14JAN2021:00:00:00,UFU RIVADAVIA,166,99,186,59,20,265,261,4,261,4,0,3,89,54,37,46,33,3,0,41,124,91,261
20210114,14JAN2021:00:00:00,UFU SANTOJANNI,105,87,94,96,2,192,182,10,190,2,1,14,57,46,33,20,17,4,0,25,85,72,182
20210114,14JAN2021:00:00:00,UFU TORNU,70,62,110,22,0,132,116,16,118,14,4,5,20,38,22,23,15,5,0,9,60,47,116
20210114,14JAN2021:00:00:00,UFU VELEZ SARSFIELD,70,59,93,34,2,129,103,26,125,4,0,5,29,32,16,18,15,14,0,11,53,39,103
20210114,14JAN2021:00:00:00,UFU ZUBIZARRETA,73,60,97,25,11,133,129,4,131,2,0,0,62,36,11,17,4,3,0,12,71,46,129
20210115,15JAN2021:00:00:00,UFU ALVAREZ,162,99,173,52,36,261,245,16,247,14,9,11,58,71,45,35,23,9,0,29,113,103,245
20210115,15JAN2021:00:00:00,UFU ARGERICH,36,42,45,32,1,78,64,14,66,12,1,6,21,17,8,10,4,11,0,14,20,28,64
20210115,15JAN2021:00:00:00,UFU BORDA-MOYANO,57,59,68,46,2,116,116,0,116,0,0,5,24,34,21,16,10,6,0,2,63,41,116
20210115,15JAN2021:00:00:00,UFU DURAND,79,86,139,19,7,165,163,2,163,2,3,5,40,61,26,11,17,2,0,25,78,59,163
20210115,15JAN2021:00:00:00,UFU ELIZALDE,68,56,34,88,2,124,84,40,114,10,67,27,7,8,10,5,0,0,0,3,51,30,84
20210115,15JAN2021:00:00:00,UFU FERNANDEZ,204,152,279,72,5,356,158,198,340,16,2,7,110,107,54,38,24,14,0,33,62,63,158
20210115,15JAN2021:00:00:00,UFU FERRER,49,49,48,48,2,98,92,6,92,6,0,0,19,28,23,17,9,2,0,19,40,33,92
20210115,15JAN2021:00:00:00,UFU GRIERSON,73,56,50,72,7,129,125,4,125,4,0,5,43,27,21,22,5,6,0,36,79,10,125
20210115,15JAN2021:00:00:00,UFU GUTIERREZ,67,31,62,36,0,98,88,10,98,0,40,14,17,9,10,8,0,0,0,3,47,38,88
20210115,15JAN2021:00:00:00,UFU MUÑIZ,251,277,224,279,25,528,300,228,340,188,2,17,144,141,86,84,31,23,0,30,197,33,300
20210115,15JAN2021:00:00:00,UFU PENNA,31,25,39,12,5,56,50,6,54,2,0,0,19,17,2,8,4,6,0,4,19,18,50
20210115,15JAN2021:00:00:00,UFU PIROVANO,132,115,176,56,15,247,199,48,241,6,2,4,52,57,70,30,19,13,0,22,98,79,199
20210115,15JAN2021:00:00:00,UFU PIÑERO,101,86,102,76,9,187,171,16,173,14,0,12,52,42,34,29,11,7,0,20,138,12,171
20210115,15JAN2021:00:00:00,UFU RAMOS MEJIA,79,57,94,28,14,136,124,12,132,4,8,2,41,37,23,11,13,1,0,16,56,52,124
20210115,15JAN2021:00:00:00,UFU RIVADAVIA,190,143,215,81,37,333,299,34,315,18,0,7,113,74,50,56,23,10,0,34,142,122,299
20210115,15JAN2021:00:00:00,UFU SANTOJANNI,109,95,102,91,11,204,196,8,198,6,0,5,66,44,35,34,12,8,0,29,86,81,196
20210115,15JAN2021:00:00:00,UFU TORNU,81,77,108,42,8,158,146,12,146,12,6,7,47,33,32,17,7,9,0,21,63,62,146
20210115,15JAN2021:00:00:00,UFU VELEZ SARSFIELD,67,51,83,35,0,118,112,6,116,2,0,0,34,40,24,12,6,2,0,32,45,35,112
20210115,15JAN2021:00:00:00,UFU ZUBIZARRETA,99,80,115,48,16,179,179,0,179,0,0,6,47,34,37,32,19,4,0,25,92,62,179
20210116,16JAN2021:00:00:00,UFU ALVAREZ,131,108,193,38,8,239,215,24,215,24,7,18,66,59,39,21,16,13,0,30,99,86,215
20210116,16JAN2021:00:00:00,UFU ARGERICH,10,9,9,10,0,19,19,0,19,0,2,0,3,8,6,0,0,0,0,1,12,6,19
20210116,16JAN2021:00:00:00,UFU BORDA-MOYANO,22,25,30,17,0,47,43,4,43,4,0,2,9,18,6,2,6,4,0,1,24,18,43
20210116,16JAN2021:00:00:00,UFU DURAND,46,33,78,1,0,79,79,0,79,0,4,4,26,24,8,8,3,2,0,16,31,32,79
20210116,16JAN2021:00:00:00,UFU ELIZALDE,44,44,25,63,0,88,54,34,80,8,61,17,6,0,3,1,0,0,0,1,29,24,54
20210116,16JAN2021:00:00:00,UFU FERNANDEZ,98,104,166,34,2,202,142,60,194,8,0,2,66,65,33,11,18,7,0,31,54,57,142
20210116,16JAN2021:00:00:00,UFU FERRER,54,39,58,33,2,93,91,2,91,2,0,2,20,29,21,15,4,2,0,14,43,34,91
20210116,16JAN2021:00:00:00,UFU GRIERSON,66,52,53,58,7,118,98,20,116,2,0,4,32,36,18,13,9,6,0,18,67,13,98
20210116,16JAN2021:00:00:00,UFU GUTIERREZ,34,39,43,30,0,73,57,16,69,4,31,16,5,7,2,10,2,0,0,2,32,23,57
20210116,16JAN2021:00:00:00,UFU MUÑIZ,129,149,141,132,5,278,198,80,204,74,0,11,72,85,43,35,15,17,0,32,149,17,198
20210116,16JAN2021:00:00:00,UFU PENNA,21,23,22,17,5,44,44,0,44,0,0,0,5,7,12,5,4,11,0,6,25,13,44
20210116,16JAN2021:00:00:00,UFU PIROVANO,91,77,142,24,2,168,158,10,164,4,0,1,56,48,23,21,11,8,0,26,60,72,158
20210116,16JAN2021:00:00:00,UFU PIÑERO,52,63,75,20,20,115,101,14,101,14,0,0,39,23,19,22,9,3,0,18,70,13,101
20210116,16JAN2021:00:00:00,UFU RAMOS MEJIA,29,47,50,24,2,76,70,6,74,2,4,9,13,14,9,14,4,9,0,14,27,29,70
20210116,16JAN2021:00:00:00,UFU RIVADAVIA,145,137,255,26,1,282,194,88,196,86,0,4,101,80,36,43,14,4,0,18,92,82,194
20210116,16JAN2021:00:00:00,UFU SANTOJANNI,96,70,74,88,4,166,162,4,166,0,0,10,55,28,26,30,8,9,0,23,67,72,162
20210116,16JAN2021:00:00:00,UFU TORNU,46,28,25,9,40,74,66,8,74,0,0,3,27,12,10,10,9,3,0,14,26,26,66
20210116,16JAN2021:00:00:00,UFU VELEZ SARSFIELD,72,83,117,37,1,155,145,10,153,2,0,3,44,39,26,25,10,8,0,35,63,47,145
20210116,16JAN2021:00:00:00,UFU ZUBIZARRETA,105,103,154,52,2,208,200,8,204,4,0,12,60,42,45,27,8,14,0,21,102,77,200
20210117,17JAN2021:00:00:00,UFU ALVAREZ,87,89,139,22,15,176,164,12,164,12,14,13,47,37,23,11,25,6,0,17,77,69,164
20210117,17JAN2021:00:00:00,UFU BORDA-MOYANO,9,6,5,9,1,15,15,0,15,0,0,0,2,7,1,3,2,0,0,2,10,3,15
20210117,17JAN2021:00:00:00,UFU ELIZALDE,62,46,20,86,2,108,70,38,92,16,66,17,4,14,5,2,0,0,0,3,38,29,70
20210117,17JAN2021:00:00:00,UFU FERNANDEZ,102,70,140,32,0,172,102,70,172,0,0,6,50,49,36,13,8,10,0,18,45,39,102
20210117,17JAN2021:00:00:00,UFU FERRER,37,32,33,33,3,69,67,2,67,2,0,0,24,11,12,13,6,3,0,18,30,19,67
20210117,17JAN2021:00:00:00,UFU GRIERSON,94,80,82,86,6,174,130,44,170,4,0,6,52,41,24,27,15,9,0,25,75,30,130
20210117,17JAN2021:00:00:00,UFU GUTIERREZ,30,26,29,27,0,56,48,8,56,0,21,17,5,7,0,2,4,0,0,2,28,17,48
20210117,17JAN2021:00:00:00,UFU MUÑIZ,118,132,102,142,6,250,164,86,186,64,0,7,63,66,57,35,9,13,0,32,117,15,164
20210117,17JAN2021:00:00:00,UFU PENNA,32,19,31,20,0,51,45,6,45,6,0,0,16,12,11,8,4,0,0,3,26,16,45
20210117,17JAN2021:00:00:00,UFU PIROVANO,67,53,100,16,4,120,94,26,118,2,0,3,34,41,13,11,14,4,0,23,34,37,94
20210117,17JAN2021:00:00:00,UFU PIÑERO,32,36,43,25,0,68,66,2,68,0,0,0,10,22,18,14,4,0,0,8,56,2,66
20210117,17JAN2021:00:00:00,UFU RAMOS MEJIA,21,29,42,8,0,50,48,2,48,2,0,2,15,10,8,9,6,0,0,10,16,22,48
20210117,17JAN2021:00:00:00,UFU RIVADAVIA,119,101,186,29,5,220,213,7,213,7,0,0,96,65,26,12,17,4,0,31,95,86,213
20210117,17JAN2021:00:00:00,UFU SANTOJANNI,47,49,54,42,0,96,88,8,94,2,0,3,18,26,18,15,14,2,0,20,34,34,88
20210117,17JAN2021:00:00:00,UFU TORNU,35,42,37,4,36,77,73,4,75,2,0,4,18,12,13,20,6,4,0,17,26,30,73
20210117,17JAN2021:00:00:00,UFU VELEZ SARSFIELD,73,58,110,21,0,131,129,2,131,0,0,3,33,37,27,19,8,4,0,28,57,44,129
20210117,17JAN2021:00:00:00,UFU ZUBIZARRETA,83,64,104,42,1,147,131,16,137,10,0,3,43,35,23,14,13,16,0,24,61,46,131
20210118,18JAN2021:00:00:00,UFU ALVAREZ,159,131,172,73,45,290,148,142,186,104,5,10,70,80,58,34,21,12,0,15,62,71,148
20210118,18JAN2021:00:00:00,UFU ARGERICH,41,39,52,28,0,80,62,18,66,14,4,3,26,14,18,5,8,2,0,7,21,34,62
20210118,18JAN2021:00:00:00,UFU BORDA-MOYANO,67,69,67,63,6,136,122,14,122,14,0,3,39,24,28,18,16,8,0,4,76,42,122
20210118,18JAN2021:00:00:00,UFU DURAND,102,59,133,28,0,161,151,10,151,10,1,9,40,50,27,15,9,10,0,28,61,62,151
20210118,18JAN2021:00:00:00,UFU ELIZALDE,64,52,28,88,0,116,84,32,112,4,52,36,5,13,5,3,1,1,0,1,59,24,84
20210118,18JAN2021:00:00:00,UFU FERNANDEZ,269,186,378,75,2,455,173,282,447,8,0,2,141,139,82,54,28,9,0,28,70,75,173
20210118,18JAN2021:00:00:00,UFU FERRER,55,51,59,45,2,106,104,2,104,2,0,0,38,20,25,15,6,2,0,23,43,38,104
20210118,18JAN2021:00:00:00,UFU GRIERSON,99,58,72,79,6,157,139,18,141,16,0,4,57,36,31,15,10,4,0,35,94,10,139
20210118,18JAN2021:00:00:00,UFU GUTIERREZ,90,66,74,80,2,156,130,26,152,4,70,37,16,15,5,6,7,0,0,4,74,52,130
20210118,18JAN2021:00:00:00,UFU MUÑIZ,267,296,280,233,50,563,415,148,477,86,0,5,138,182,93,81,37,27,0,52,312,51,415
20210118,18JAN2021:00:00:00,UFU PENNA,46,14,28,25,7,60,54,6,56,4,0,0,15,14,13,9,7,2,0,6,33,15,54
20210118,18JAN2021:00:00:00,UFU PIROVANO,134,103,183,48,6,237,217,20,227,10,2,0,79,56,35,19,23,23,0,25,89,102,217
20210118,18JAN2021:00:00:00,UFU PIÑERO,126,75,133,25,43,201,165,36,183,18,7,2,53,52,33,39,13,2,0,17,130,17,165
20210118,18JAN2021:00:00:00,UFU RAMOS MEJIA,72,64,85,48,3,136,130,6,134,2,7,6,29,23,17,31,9,14,0,21,51,58,130
20210118,18JAN2021:00:00:00,UFU RIVADAVIA,174,131,185,97,23,305,161,144,165,140,0,6,67,107,39,49,24,13,0,18,75,67,161
20210118,18JAN2021:00:00:00,UFU SANTOJANNI,118,109,98,121,8,227,195,32,219,8,14,4,76,55,31,23,18,6,0,35,75,85,195
20210118,18JAN2021:00:00:00,UFU TORNU,50,40,70,19,1,90,76,14,78,12,4,6,30,21,11,10,4,4,0,13,38,25,76
20210118,18JAN2021:00:00:00,UFU VELEZ SARSFIELD,69,54,88,32,3,123,121,2,121,2,0,3,34,25,30,13,14,4,0,35,50,36,121
20210118,18JAN2021:00:00:00,UFU ZUBIZARRETA,110,108,140,78,0,218,214,4,218,0,0,7,67,57,30,29,11,17,0,29,112,73,214
20210119,19JAN2021:00:00:00,UFU ALVAREZ,121,129,173,51,26,250,222,28,222,28,2,17,78,60,52,25,7,9,0,25,78,119,222
20210119,19JAN2021:00:00:00,UFU ARGERICH,59,51,74,32,4,110,78,32,92,18,3,2,25,29,21,15,8,7,0,7,34,37,78
20210119,19JAN2021:00:00:00,UFU BORDA-MOYANO,59,54,54,59,0,113,107,6,107,6,2,7,18,33,24,19,5,5,0,11,64,32,107
20210119,19JAN2021:00:00:00,UFU DURAND,88,55,119,24,0,143,137,6,137,6,5,3,25,44,39,14,11,2,0,32,56,49,137
20210119,19JAN2021:00:00:00,UFU ELIZALDE,97,58,47,104,4,155,119,36,147,8,72,35,15,18,5,7,2,1,0,4,76,39,119
20210119,19JAN2021:00:00:00,UFU FERNANDEZ,208,150,282,70,6,358,174,184,344,14,0,2,110,109,59,54,14,10,0,21,84,69,174
20210119,19JAN2021:00:00:00,UFU FERRER,76,56,61,71,0,132,122,10,122,10,0,5,30,40,31,13,7,6,0,22,50,50,122
20210119,19JAN2021:00:00:00,UFU GRIERSON,83,55,60,75,3,138,118,20,134,4,0,5,37,28,25,25,12,6,0,26,66,26,118
20210119,19JAN2021:00:00:00,UFU GUTIERREZ,74,67,71,70,0,141,133,8,141,0,77,30,8,9,13,2,2,0,0,9,66,58,133
20210119,19JAN2021:00:00:00,UFU MUÑIZ,205,259,210,212,42,464,296,168,330,134,0,4,138,133,94,47,34,14,0,43,218,35,296
20210119,19JAN2021:00:00:00,UFU PENNA,31,22,29,22,2,53,41,12,49,4,0,4,5,11,10,18,4,1,0,5,28,8,41
20210119,19JAN2021:00:00:00,UFU PIROVANO,98,72,120,36,14,170,158,12,162,8,0,1,38,60,27,19,10,15,0,24,72,62,158
20210119,19JAN2021:00:00:00,UFU PIÑERO,78,85,100,46,17,163,133,30,153,10,0,5,44,37,40,10,15,12,0,22,97,14,133
20210119,19JAN2021:00:00:00,UFU RAMOS MEJIA,68,72,120,17,3,140,124,16,134,6,1,11,38,22,33,15,18,2,0,14,60,50,124
20210119,19JAN2021:00:00:00,UFU RIVADAVIA,174,145,163,68,88,319,273,46,285,34,0,12,91,81,56,52,22,5,0,38,123,111,273
20210119,19JAN2021:00:00:00,UFU SANTOJANNI,107,98,107,96,2,205,195,10,203,2,6,9,62,45,52,23,6,2,0,38,77,80,195
20210119,19JAN2021:00:00:00,UFU TORNU,65,67,76,47,9,132,118,14,120,12,1,1,34,32,28,26,5,5,0,19,47,52,118
20210119,19JAN2021:00:00:00,UFU VELEZ SARSFIELD,93,67,121,33,6,160,146,14,156,4,0,5,41,38,29,23,19,5,0,24,71,51,146
20210119,19JAN2021:00:00:00,UFU ZUBIZARRETA,84,62,96,49,1,146,146,0,146,0,0,6,34,40,30,11,16,9,0,28,77,41,146
20210120,20JAN2021:00:00:00,UFU ALVAREZ,127,112,184,39,16,239,199,40,201,38,7,12,65,69,34,25,19,8,0,3,39,157,199
20210120,20JAN2021:00:00:00,UFU ARGERICH,58,55,78,27,8,113,101,12,101,12,6,2,30,19,23,15,16,2,0,10,46,44,101
20210120,20JAN2021:00:00:00,UFU BORDA-MOYANO,86,71,69,86,2,157,157,0,157,0,2,1,42,43,28,29,10,2,0,6,91,60,157
20210120,20JAN2021:00:00:00,UFU DURAND,83,80,140,20,3,163,153,10,155,8,3,15,51,43,25,19,3,4,0,24,70,58,153
20210120,20JAN2021:00:00:00,UFU ELIZALDE,57,51,18,88,2,108,82,26,92,16,50,19,14,11,9,5,0,0,0,2,53,27,82
20210120,20JAN2021:00:00:00,UFU FERNANDEZ,95,100,156,39,0,195,69,126,177,18,0,2,59,64,28,23,14,5,0,10,15,44,69
20210120,20JAN2021:00:00:00,UFU FERRER,45,45,51,39,0,90,86,4,86,4,0,3,22,28,23,9,2,3,0,12,41,33,86
20210120,20JAN2021:00:00:00,UFU GRIERSON,62,59,52,64,5,121,117,4,119,2,0,7,44,21,31,11,6,1,0,41,64,12,117
20210120,20JAN2021:00:00:00,UFU GUTIERREZ,48,45,58,35,0,93,91,2,93,0,44,32,8,6,2,0,1,0,0,3,49,38,91
20210120,20JAN2021:00:00:00,UFU MUÑIZ,204,276,218,229,33,480,304,176,358,122,0,15,121,135,86,63,34,26,0,28,254,22,304
20210120,20JAN2021:00:00:00,UFU PENNA,38,37,50,25,0,75,68,7,72,3,0,7,18,14,9,13,6,8,0,7,42,19,68
20210120,20JAN2021:00:00:00,UFU PIROVANO,98,101,165,30,4,199,171,28,189,10,0,3,55,57,45,17,11,11,0,24,76,71,171
20210120,20JAN2021:00:00:00,UFU PIÑERO,59,49,67,10,31,108,108,0,108,0,0,2,32,38,20,12,2,2,0,13,86,8,108
20210120,20JAN2021:00:00:00,UFU RAMOS MEJIA,102,88,133,49,8,190,178,12,186,4,7,7,47,45,39,18,11,16,0,17,79,82,178
20210120,20JAN2021:00:00:00,UFU RIVADAVIA,160,137,195,72,30,297,267,30,287,10,0,11,86,84,37,44,32,3,0,24,134,108,267
20210120,20JAN2021:00:00:00,UFU SANTOJANNI,88,77,89,72,4,165,153,12,159,6,4,11,39,50,20,27,8,6,0,29,64,60,153
20210120,20JAN2021:00:00:00,UFU TORNU,89,65,111,39,4,154,132,22,150,4,2,1,43,36,26,29,10,7,0,15,32,85,132
20210120,20JAN2021:00:00:00,UFU VELEZ SARSFIELD,82,62,107,35,2,144,132,12,142,2,0,5,38,26,27,21,21,6,0,20,65,47,132
20210120,20JAN2021:00:00:00,UFU ZUBIZARRETA,115,103,135,75,8,218,214,4,218,0,0,7,61,52,36,34,13,15,0,22,112,80,214
20210121,21JAN2021:00:00:00,UFU ALVAREZ,137,106,178,42,23,243,223,20,223,20,7,18,67,65,42,28,12,4,0,29,105,89,223
20210121,21JAN2021:00:00:00,UFU ARGERICH,34,46,37,43,0,80,60,20,62,18,6,2,17,15,13,16,3,8,0,7,30,23,60
20210121,21JAN2021:00:00:00,UFU BORDA-MOYANO,74,55,66,63,0,129,129,0,129,0,8,7,24,36,20,20,11,3,0,3,73,53,129
20210121,21JAN2021:00:00:00,UFU DURAND,86,49,118,13,4,135,125,10,125,10,3,5,27,48,25,13,14,0,0,18,58,48,125
20210121,21JAN2021:00:00:00,UFU ELIZALDE,71,50,33,88,0,121,95,26,109,12,53,39,3,9,10,6,1,0,0,2,59,34,95
20210121,21JAN2021:00:00:00,UFU FERNANDEZ,112,122,191,38,5,234,94,140,228,6,0,2,53,76,44,35,16,8,0,13,44,37,94
20210121,21JAN2021:00:00:00,UFU FERRER,47,34,34,45,2,81,79,2,79,2,0,2,20,22,14,9,7,7,0,16,31,32,79
20210121,21JAN2021:00:00:00,UFU GRIERSON,60,73,61,65,7,133,127,6,127,6,0,7,44,35,25,11,7,4,0,26,61,40,127
20210121,21JAN2021:00:00:00,UFU GUTIERREZ,26,35,37,24,0,61,59,2,61,0,26,10,8,12,4,1,0,0,0,2,35,22,59
20210121,21JAN2021:00:00:00,UFU MUÑIZ,197,263,220,210,30,460,282,178,320,140,0,10,103,142,90,63,36,16,0,21,222,39,282
20210121,21JAN2021:00:00:00,UFU PENNA,30,39,51,18,0,69,61,8,63,6,0,3,21,14,14,14,3,0,0,14,35,12,61
20210111,11JAN2021:00:00:00,UFU BORDA-MOYANO,39,68,59,48,0,107,91,16,91,16,0,8,30,33,17,12,5,2,0,4,34,34,91
20210111,11JAN2021:00:00:00,UFU DURAND,88,64,133,19,0,152,140,12,140,12,4,2,39,39,30,21,13,4,0,23,60,57,140
20210111,11JAN2021:00:00:00,UFU ELIZALDE,51,42,28,63,2,93,77,16,93,0,42,18,10,17,2,3,1,0,0,2,45,30,77
20210111,11JAN2021:00:00:00,UFU FERNANDEZ,107,79,159,24,3,186,178,8,180,6,0,5,53,60,34,12,14,8,0,38,67,73,178
20210111,11JAN2021:00:00:00,UFU FERRER,50,65,52,57,6,115,111,4,111,4,0,0,30,45,24,5,10,1,0,15,56,40,111
20210111,11JAN2021:00:00:00,UFU GRIERSON,69,59,67,55,6,128,110,18,110,18,0,1,43,30,24,20,3,7,0,38,60,12,110
20210111,11JAN2021:00:00:00,UFU GUTIERREZ,81,53,57,77,0,134,112,22,132,2,48,39,11,21,7,5,3,0,0,4,56,52,112
20210111,11JAN2021:00:00:00,UFU MUÑIZ,207,202,176,208,25,409,279,130,315,94,2,10,99,106,86,66,23,17,0,31,163,42,279
20210111,11JAN2021:00:00:00,UFU PENNA,24,24,29,18,1,48,44,4,44,4,0,0,9,14,7,10,5,3,0,7,16,15,44
20210111,11JAN2021:00:00:00,UFU PIROVANO,118,97,167,45,3,215,207,8,209,6,0,2,65,76,33,20,11,8,0,37,89,81,207
20210111,11JAN2021:00:00:00,UFU PIÑERO,106,68,108,41,25,174,138,36,158,16,7,15,51,30,27,16,15,13,0,16,115,7,138
20210111,11JAN2021:00:00:00,UFU RAMOS MEJIA,68,79,99,41,7,147,127,20,133,14,4,7,34,40,32,15,6,9,0,24,47,56,127
20210111,11JAN2021:00:00:00,UFU RIVADAVIA,175,155,207,103,20,330,230,100,232,98,0,5,117,94,53,38,15,8,0,25,112,93,230
20210111,11JAN2021:00:00:00,UFU SANTOJANNI,121,115,133,100,3,236,224,12,230,6,2,9,78,48,42,35,19,3,0,27,43,153,224
20210111,11JAN2021:00:00:00,UFU TORNU,39,48,66,21,0,87,71,16,77,10,1,4,24,23,10,17,6,2,0,22,24,25,71
20210111,11JAN2021:00:00:00,UFU VELEZ SARSFIELD,53,73,104,21,1,126,124,2,126,0,0,4,44,37,20,9,6,6,0,43,45,36,124
20210111,11JAN2021:00:00:00,UFU ZUBIZARRETA,48,46,57,25,12,94,74,20,94,0,0,3,13,10,18,25,17,8,0,10,39,25,74
20210112,12JAN2021:00:00:00,UFU ALVAREZ,151,143,190,79,25,294,266,28,270,24,5,21,85,54,51,33,25,20,0,41,93,132,266
20210112,12JAN2021:00:00:00,UFU ARGERICH,54,43,58,39,0,97,73,24,75,22,4,3,22,32,9,17,9,1,0,11,31,31,73
20210112,12JAN2021:00:00:00,UFU BORDA-MOYANO,64,30,64,28,2,94,92,2,92,2,0,7,22,19,24,15,7,0,0,2,61,29,92
20210112,12JAN2021:00:00:00,UFU DURAND,131,70,178,20,3,201,193,8,199,2,2,1,65,52,36,26,10,9,0,36,81,76,193
20210112,12JAN2021:00:00:00,UFU ELIZALDE,67,56,41,81,1,123,97,26,113,10,49,34,4,16,8,6,5,1,0,4,60,33,97
20210112,12JAN2021:00:00:00,UFU FERNANDEZ,202,153,302,43,10,355,225,130,347,8,0,3,117,116,66,30,20,3,0,42,94,89,225
20210112,12JAN2021:00:00:00,UFU FERRER,47,44,47,44,0,91,89,2,89,2,0,2,29,24,18,5,11,2,0,18,44,27,89
20210112,12JAN2021:00:00:00,UFU GRIERSON,69,49,59,58,1,118,110,8,112,6,0,6,35,36,23,12,5,1,0,32,67,11,110
20210112,12JAN2021:00:00:00,UFU GUTIERREZ,70,59,74,55,0,129,113,16,127,2,42,38,17,10,16,2,2,2,0,10,60,43,113
20210112,12JAN2021:00:00:00,UFU MUÑIZ,252,206,222,196,40,458,288,170,336,122,7,15,109,111,91,73,40,12,0,26,221,41,288
20210112,12JAN2021:00:00:00,UFU PENNA,24,30,42,12,0,54,52,2,54,0,0,2,7,14,11,9,7,4,0,11,29,12,52
20210112,12JAN2021:00:00:00,UFU PIROVANO,129,100,164,56,9,229,201,28,221,8,0,8,49,61,40,35,21,15,0,23,96,82,201
20210112,12JAN2021:00:00:00,UFU PIÑERO,98,114,134,56,22,212,170,42,208,4,10,4,51,57,26,29,27,8,0,14,142,14,170
20210112,12JAN2021:00:00:00,UFU RAMOS MEJIA,80,55,97,32,6,135,131,4,133,2,13,11,30,32,21,15,6,7,0,26,40,62,131
20210112,12JAN2021:00:00:00,UFU RIVADAVIA,152,127,142,91,46,279,263,16,267,12,0,4,79,87,46,27,30,6,0,36,127,98,263
20210112,12JAN2021:00:00:00,UFU SANTOJANNI,127,111,107,122,9,238,208,30,232,6,6,16,60,27,49,34,36,10,0,51,79,78,208
20210112,12JAN2021:00:00:00,UFU TORNU,66,69,83,46,6,135,121,14,121,14,0,4,33,40,24,17,17,0,0,25,45,51,121
20210112,12JAN2021:00:00:00,UFU VELEZ SARSFIELD,87,56,115,28,0,143,141,2,143,0,0,5,28,29,20,22,31,8,0,32,64,45,141
20210112,12JAN2021:00:00:00,UFU ZUBIZARRETA,126,68,133,48,13,194,190,4,192,2,0,2,54,50,41,28,9,10,0,26,95,69,190
20210113,13JAN2021:00:00:00,UFU ALVAREZ,146,120,172,45,49,266,228,38,228,38,5,12,75,57,38,44,28,7,0,27,105,94,228
20210113,13JAN2021:00:00:00,UFU ARGERICH,57,46,69,30,4,103,71,32,73,30,6,4,10,28,20,12,8,15,0,12,24,35,71
20210113,13JAN2021:00:00:00,UFU BORDA-MOYANO,85,49,92,38,4,134,122,12,122,12,6,9,38,32,18,21,6,4,0,2,73,46,122
20210113,13JAN2021:00:00:00,UFU DURAND,92,62,131,20,3,154,154,0,154,0,3,10,42,46,14,20,13,6,0,27,65,61,154
20210113,13JAN2021:00:00:00,UFU ELIZALDE,39,54,27,64,2,93,61,32,85,8,48,17,8,6,6,6,1,1,0,6,37,18,61
20210113,13JAN2021:00:00:00,UFU FERNANDEZ,211,159,312,53,5,370,164,206,352,18,0,6,103,148,49,31,24,9,0,27,73,64,164
20210113,13JAN2021:00:00:00,UFU FERRER,65,44,59,50,0,109,101,8,103,6,0,1,33,36,17,15,6,1,0,19,43,39,101
20210113,13JAN2021:00:00:00,UFU GRIERSON,72,64,82,49,5,136,128,8,130,6,0,8,49,31,20,21,3,4,0,33,77,18,128
20210113,13JAN2021:00:00:00,UFU GUTIERREZ,104,47,92,57,2,151,131,20,151,0,54,40,15,24,9,7,2,0,0,10,69,52,131
20210113,13JAN2021:00:00:00,UFU MUÑIZ,211,222,202,206,25,433,277,156,307,126,2,13,129,100,81,62,35,11,0,27,213,37,277
20210113,13JAN2021:00:00:00,UFU PENNA,23,18,24,17,0,41,39,2,39,2,0,2,10,8,7,5,5,4,0,6,20,13,39
20210113,13JAN2021:00:00:00,UFU PIROVANO,145,91,158,67,11,236,202,34,228,8,1,5,53,82,47,27,17,4,0,22,96,83,202
20210113,13JAN2021:00:00:00,UFU PIÑERO,79,97,115,48,13,176,172,4,172,4,0,1,39,61,35,21,14,5,0,28,126,18,172
20210113,13JAN2021:00:00:00,UFU RAMOS MEJIA,90,76,131,31,4,166,156,10,160,6,6,17,38,51,25,20,5,4,0,16,74,66,156
20210113,13JAN2021:00:00:00,UFU RIVADAVIA,220,127,212,77,58,347,329,18,335,12,0,6,111,95,55,40,26,14,0,52,145,128,329
20210113,13JAN2021:00:00:00,UFU SANTOJANNI,126,62,123,63,2,188,176,12,188,0,0,6,40,55,29,30,15,13,0,28,70,78,176
20210113,13JAN2021:00:00:00,UFU TORNU,77,85,119,38,5,162,153,9,157,5,4,5,53,30,21,28,14,7,0,30,55,67,153
20210113,13JAN2021:00:00:00,UFU VELEZ SARSFIELD,91,77,120,46,2,168,134,34,168,0,6,4,37,40,29,29,15,8,0,38,59,37,134
20210113,13JAN2021:00:00:00,UFU ZUBIZARRETA,120,87,141,57,9,207,191,16,205,2,0,6,67,52,19,30,14,19,0,24,96,71,191
20210114,14JAN2021:00:00:00,UFU ALVAREZ,148,97,172,48,25,245,213,32,221,24,6,9,68,79,31,23,20,9,0,30,101,82,213
20210114,14JAN2021:00:00:00,UFU ARGERICH,44,39,60,23,0,83,59,24,61,22,5,0,28,12,17,8,9,4,0,10,25,24,59
20210114,14JAN2021:00:00:00,UFU BORDA-MOYANO,102,79,89,88,4,181,169,12,169,12,5,6,20,45,36,41,16,12,0,2,102,65,169
20210114,14JAN2021:00:00:00,UFU DURAND,103,75,152,20,6,178,176,2,176,2,2,3,48,69,27,18,7,4,0,28,82,66,176
20210114,14JAN2021:00:00:00,UFU ELIZALDE,95,64,56,103,0,159,99,60,157,2,79,36,8,23,5,8,0,0,0,4,61,34,99
20210114,14JAN2021:00:00:00,UFU FERNANDEZ,223,148,301,64,6,371,191,180,365,6,0,7,92,153,43,39,27,10,0,39,67,85,191
20210114,14JAN2021:00:00:00,UFU FERRER,62,48,60,49,1,110,99,11,99,11,0,0,20,38,21,18,12,1,0,14,48,37,99
20210114,14JAN2021:00:00:00,UFU GRIERSON,72,64,70,62,4,136,120,16,132,4,0,5,39,31,25,21,8,7,0,19,88,13,120
20210114,14JAN2021:00:00:00,UFU GUTIERREZ,61,45,65,39,2,106,92,14,104,2,31,24,15,15,13,4,4,0,0,5,57,30,92
20210114,14JAN2021:00:00:00,UFU MUÑIZ,261,220,247,215,19,481,295,186,351,130,3,15,131,111,75,92,35,19,0,27,238,30,295
20201221,21DEC2020:00:00:00,UFU DURAND,51,49,92,8,0,100,96,4,96,4,3,3,28,36,13,11,1,5,0,15,59,21,96
20201221,21DEC2020:00:00:00,UFU ELIZALDE,36,27,22,38,3,63,29,34,49,14,34,11,8,6,3,1,0,0,0,1,23,5,29
20201221,21DEC2020:00:00:00,UFU FERNANDEZ,78,56,114,16,4,134,134,0,134,0,0,2,48,42,16,12,10,4,0,25,74,35,134
20201221,21DEC2020:00:00:00,UFU FERRER,47,48,50,45,0,95,89,6,93,2,0,0,30,27,11,14,9,4,0,16,62,11,89
20201221,21DEC2020:00:00:00,UFU GRIERSON,51,50,46,53,2,101,101,0,101,0,0,4,27,27,16,18,7,2,0,36,59,6,101
20201221,21DEC2020:00:00:00,UFU GUTIERREZ,54,49,65,38,0,103,89,14,95,8,32,21,9,26,7,2,6,0,0,2,60,27,89
20201221,21DEC2020:00:00:00,UFU MUÑIZ,258,250,235,271,2,508,364,144,396,112,12,27,121,173,80,58,22,15,0,23,292,49,364
20201221,21DEC2020:00:00:00,UFU PENNA,31,8,31,8,0,39,35,4,37,2,0,2,4,13,3,10,7,0,0,4,23,8,35
20201221,21DEC2020:00:00:00,UFU PIROVANO,81,78,118,29,12,159,141,18,157,2,0,3,53,44,29,13,13,4,0,13,105,23,141
20201221,21DEC2020:00:00:00,UFU PIÑERO,51,47,72,18,8,98,88,10,94,4,0,1,33,30,15,10,3,6,0,12,66,9,88
20201221,21DEC2020:00:00:00,UFU RAMOS MEJIA,55,27,76,6,0,82,74,8,80,2,7,3,19,22,12,3,12,4,0,16,40,18,74
20201221,21DEC2020:00:00:00,UFU RIVADAVIA,136,113,188,43,18,249,229,20,229,20,0,0,86,79,39,23,14,8,0,26,109,94,229
20201221,21DEC2020:00:00:00,UFU SANTOJANNI,34,31,28,35,2,65,53,12,65,0,2,4,9,17,18,5,5,5,0,5,43,5,53
20201221,21DEC2020:00:00:00,UFU TORNU,64,44,76,32,0,108,100,8,100,8,0,4,36,27,19,9,12,1,0,12,64,24,100
20201221,21DEC2020:00:00:00,UFU VELEZ SARSFIELD,51,40,77,14,0,91,87,4,89,2,0,4,22,18,20,22,4,1,0,12,59,16,87
20201221,21DEC2020:00:00:00,UFU ZUBIZARRETA,4,7,7,4,0,11,11,0,11,0,0,0,0,5,3,2,1,0,0,1,10,0,11
20201222,22DEC2020:00:00:00,UFU ALVAREZ,107,71,157,19,2,178,164,14,164,14,7,10,44,50,28,15,15,9,0,5,44,115,164
20201222,22DEC2020:00:00:00,UFU ARGERICH,43,22,35,28,2,65,38,27,38,27,4,7,13,21,6,7,3,4,0,3,25,10,38
20201222,22DEC2020:00:00:00,UFU BORDA-MOYANO,12,16,18,10,0,28,28,0,28,0,0,0,8,8,10,1,1,0,0,0,21,7,28
20201222,22DEC2020:00:00:00,UFU DURAND,74,57,127,4,0,131,129,2,129,2,3,4,27,63,19,4,7,4,0,26,73,30,129
20201222,22DEC2020:00:00:00,UFU ELIZALDE,41,35,40,35,1,76,62,14,72,4,20,20,7,17,5,5,2,0,0,1,51,10,62
20201222,22DEC2020:00:00:00,UFU FERNANDEZ,90,67,136,21,0,157,131,26,149,8,0,0,41,46,32,25,4,9,0,20,87,24,131
20201222,22DEC2020:00:00:00,UFU FERRER,27,37,37,27,0,64,62,2,62,2,0,0,25,12,14,11,2,0,0,8,46,8,62
20201222,22DEC2020:00:00:00,UFU GRIERSON,63,50,51,58,4,113,97,16,97,16,0,8,40,27,23,13,2,0,0,9,42,46,97
20201222,22DEC2020:00:00:00,UFU GUTIERREZ,66,33,77,22,0,99,73,26,87,12,21,17,9,35,10,6,1,0,0,4,45,24,73
20201222,22DEC2020:00:00:00,UFU MUÑIZ,355,385,332,394,14,740,368,372,400,340,14,33,226,227,113,78,31,18,0,23,312,32,368
20201222,22DEC2020:00:00:00,UFU PENNA,22,11,16,16,1,33,27,6,29,4,0,1,8,14,5,3,2,0,0,3,14,10,27
20201222,22DEC2020:00:00:00,UFU PIROVANO,57,38,87,8,0,95,89,6,93,2,0,4,43,16,16,10,5,1,0,12,54,23,89
20201222,22DEC2020:00:00:00,UFU PIÑERO,38,37,54,15,6,75,59,16,59,16,0,4,27,18,13,11,1,1,0,12,42,4,59
20201222,22DEC2020:00:00:00,UFU RAMOS MEJIA,36,28,51,12,1,64,53,11,55,9,0,1,15,22,11,8,5,2,0,9,33,11,53
20201222,22DEC2020:00:00:00,UFU RIVADAVIA,105,122,194,30,3,227,197,30,199,28,0,12,87,75,34,7,8,4,0,15,114,65,197
20201222,22DEC2020:00:00:00,UFU SANTOJANNI,35,48,47,36,0,83,57,26,79,4,0,6,15,24,18,11,7,2,0,15,36,6,57
20201222,22DEC2020:00:00:00,UFU TORNU,49,74,97,26,0,123,105,18,107,16,5,9,34,36,24,7,6,2,0,14,61,30,105
20201222,22DEC2020:00:00:00,UFU VELEZ SARSFIELD,24,20,34,10,0,44,44,0,44,0,0,0,8,14,7,2,7,6,0,10,25,9,44
20201222,22DEC2020:00:00:00,UFU ZUBIZARRETA,10,13,18,5,0,23,21,2,23,0,0,2,2,4,5,7,0,3,0,7,8,6,21
20201223,23DEC2020:00:00:00,UFU ALVAREZ,96,71,132,31,4,167,153,14,153,14,0,9,56,60,20,9,7,6,0,26,88,39,153
20201223,23DEC2020:00:00:00,UFU ARGERICH,48,31,39,35,5,79,70,9,70,9,3,1,24,12,18,3,15,3,0,3,28,39,70
20201223,23DEC2020:00:00:00,UFU BORDA-MOYANO,15,14,22,7,0,29,29,0,29,0,0,0,9,8,5,2,4,1,0,1,24,4,29
20201223,23DEC2020:00:00:00,UFU DURAND,65,68,115,18,0,133,133,0,133,0,1,8,35,48,6,9,15,11,0,24,81,28,133
20201223,23DEC2020:00:00:00,UFU ELIZALDE,31,28,22,37,0,59,39,20,53,6,34,10,2,7,5,1,0,0,0,0,34,5,39
20201223,23DEC2020:00:00:00,UFU FERNANDEZ,66,44,94,16,0,110,106,4,108,2,0,8,14,29,24,21,10,4,0,12,69,25,106
20201223,23DEC2020:00:00:00,UFU FERRER,43,34,44,33,0,77,70,7,72,5,0,0,23,29,9,10,5,1,0,16,47,7,70
20201223,23DEC2020:00:00:00,UFU GRIERSON,74,58,82,48,2,132,126,6,126,6,0,10,35,26,28,23,9,1,0,33,71,22,126
20201223,23DEC2020:00:00:00,UFU GUTIERREZ,41,27,49,19,0,68,60,8,68,0,16,3,15,19,7,4,3,1,0,3,38,19,60
20201223,23DEC2020:00:00:00,UFU MUÑIZ,280,340,268,336,16,620,416,204,436,184,14,43,161,199,80,89,30,4,0,33,327,55,416
20201223,23DEC2020:00:00:00,UFU PENNA,22,10,24,7,1,32,28,4,28,4,0,1,9,6,8,5,3,0,0,5,17,6,28
20201223,23DEC2020:00:00:00,UFU PIROVANO,54,45,87,10,2,99,91,8,97,2,0,4,32,33,14,8,3,5,0,19,49,23,91
20201223,23DEC2020:00:00:00,UFU PIÑERO,59,42,62,29,10,101,83,18,85,16,1,6,22,29,22,7,4,10,0,20,57,6,83
20201223,23DEC2020:00:00:00,UFU RAMOS MEJIA,58,61,104,15,0,119,101,18,105,14,2,1,37,40,21,9,9,0,0,25,50,26,101
20201223,23DEC2020:00:00:00,UFU RIVADAVIA,122,93,155,52,8,215,195,20,195,20,2,5,55,76,35,19,12,11,0,19,125,51,195
20201223,23DEC2020:00:00:00,UFU SANTOJANNI,51,56,61,43,3,107,97,10,105,2,10,8,22,20,28,9,10,0,0,28,45,24,97
20201223,23DEC2020:00:00:00,UFU TORNU,69,67,116,20,0,136,128,8,128,8,6,8,30,38,30,16,6,2,0,32,56,40,128
20201223,23DEC2020:00:00:00,UFU VELEZ SARSFIELD,12,11,20,3,0,23,23,0,23,0,0,0,11,2,6,3,0,1,0,3,16,4,23
20201223,23DEC2020:00:00:00,UFU ZUBIZARRETA,24,16,22,18,0,40,38,2,38,2,0,3,5,12,12,4,0,4,0,0,0,38,38
20201224,24DEC2020:00:00:00,UFU ALVAREZ,3,2,5,0,0,5,5,0,5,0,0,1,0,2,2,0,0,0,0,1,4,0,5
20201224,24DEC2020:00:00:00,UFU BORDA-MOYANO,3,1,3,1,0,4,4,0,4,0,0,0,0,1,0,3,0,0,0,0,4,0,4
20201224,24DEC2020:00:00:00,UFU DURAND,12,8,15,5,0,20,20,0,20,0,0,1,7,7,1,2,1,1,0,6,11,3,20
20201224,24DEC2020:00:00:00,UFU MUÑIZ,154,150,161,134,9,304,124,180,134,170,6,13,63,81,63,55,16,7,0,12,97,15,124
20201224,24DEC2020:00:00:00,UFU PIÑERO,23,18,31,9,1,41,41,0,41,0,0,0,12,11,9,2,4,3,0,7,31,2,41
20201225,25DEC2020:00:00:00,UFU BORDA-MOYANO,1,6,7,0,0,7,7,0,7,0,0,0,2,2,1,0,2,0,0,0,5,2,7
20201225,25DEC2020:00:00:00,UFU DURAND,14,6,18,2,0,20,0,20,0,20,0,2,2,6,4,2,4,0,0,0,0,0,0
20201225,25DEC2020:00:00:00,UFU MUÑIZ,13,21,17,17,0,34,30,4,30,4,0,1,6,13,5,5,4,0,0,11,16,3,30
20201225,25DEC2020:00:00:00,UFU PIÑERO,9,8,16,0,1,17,15,2,15,2,0,0,6,6,4,1,0,0,0,5,9,1,15
20201225,25DEC2020:00:00:00,UFU RAMOS MEJIA,1,0,0,1,0,1,1,0,1,0,0,0,1,0,0,0,0,0,0,1,0,0,1
20201226,26DEC2020:00:00:00,UFU ALVAREZ,113,70,154,29,0,183,164,19,164,19,2,10,40,54,31,20,24,2,0,31,53,80,164
20201226,26DEC2020:00:00:00,UFU BORDA-MOYANO,20,16,23,13,0,36,34,2,34,2,0,3,7,3,9,11,3,0,0,3,22,9,34
20201226,26DEC2020:00:00:00,UFU DURAND,90,78,152,13,3,168,150,18,150,18,1,2,46,49,31,24,9,6,0,57,61,32,150
20201226,26DEC2020:00:00:00,UFU ELIZALDE,42,31,15,58,0,73,53,20,71,2,44,14,4,8,1,0,2,0,0,1,39,13,53
20201226,26DEC2020:00:00:00,UFU FERNANDEZ,52,57,93,16,0,109,109,0,109,0,0,3,36,25,18,13,11,3,0,25,50,34,109
20201226,26DEC2020:00:00:00,UFU FERRER,50,46,58,38,0,96,86,10,86,10,0,1,43,22,11,10,8,1,0,27,49,10,86
20201226,26DEC2020:00:00:00,UFU GRIERSON,45,39,45,39,0,84,84,0,84,0,0,5,15,28,15,8,7,6,0,26,49,9,84
20201226,26DEC2020:00:00:00,UFU GUTIERREZ,56,22,39,39,0,78,68,10,72,6,29,19,6,14,5,4,1,0,0,4,47,17,68
20201226,26DEC2020:00:00:00,UFU MUÑIZ,67,115,86,95,1,182,170,12,176,6,6,3,54,48,34,23,7,7,0,33,128,9,170
20201226,26DEC2020:00:00:00,UFU PENNA,22,13,23,12,0,35,25,10,27,8,0,0,7,7,7,11,1,2,0,6,16,3,25
20201226,26DEC2020:00:00:00,UFU PIROVANO,79,54,116,13,4,133,81,52,131,2,0,6,28,47,24,17,9,2,0,12,45,24,81
20201226,26DEC2020:00:00:00,UFU PIÑERO,28,30,36,22,0,58,58,0,58,0,0,0,10,20,12,5,6,5,0,13,40,5,58
20201226,26DEC2020:00:00:00,UFU RAMOS MEJIA,16,14,15,14,1,30,26,4,28,2,2,1,10,8,3,5,1,0,0,4,17,5,26
20201226,26DEC2020:00:00:00,UFU RIVADAVIA,99,117,179,28,9,216,158,58,158,58,0,7,71,52,31,32,19,4,0,26,93,38,158
20201226,26DEC2020:00:00:00,UFU SANTOJANNI,65,48,59,52,2,113,95,18,111,2,9,9,27,22,23,13,7,3,0,29,52,14,95
20201226,26DEC2020:00:00:00,UFU TORNU,46,58,53,15,36,104,98,6,100,4,1,3,30,27,17,13,8,5,0,31,49,18,98
20201226,26DEC2020:00:00:00,UFU VELEZ SARSFIELD,57,44,69,31,1,101,99,2,101,0,0,2,16,42,18,16,4,3,0,27,54,18,99
20201226,26DEC2020:00:00:00,UFU ZUBIZARRETA,102,102,143,61,0,204,196,8,200,4,2,14,71,42,28,35,4,8,0,24,22,150,196
20201227,27DEC2020:00:00:00,UFU ALVAREZ,110,76,166,20,0,186,60,126,60,126,10,9,35,59,37,16,14,6,0,16,28,16,60
20201227,27DEC2020:00:00:00,UFU BORDA-MOYANO,8,8,4,11,1,16,16,0,16,0,0,0,4,4,4,0,2,2,0,0,13,3,16
20201227,27DEC2020:00:00:00,UFU DURAND,48,35,74,9,0,83,79,4,81,2,1,5,25,25,17,5,5,0,0,26,44,9,79
20201227,27DEC2020:00:00:00,UFU ELIZALDE,48,52,30,70,0,100,82,18,94,6,52,20,4,12,9,3,0,0,0,2,65,15,82
20201227,27DEC2020:00:00:00,UFU FERNANDEZ,50,31,76,5,0,81,59,22,73,8,0,0,23,21,16,2,7,12,0,11,31,17,59
20201227,27DEC2020:00:00:00,UFU FERRER,25,23,24,22,2,48,46,2,46,2,0,0,10,16,12,4,3,3,0,16,24,6,46
20201227,27DEC2020:00:00:00,UFU GRIERSON,31,29,41,19,0,60,60,0,60,0,0,1,19,5,23,6,5,1,0,24,35,1,60
20201227,27DEC2020:00:00:00,UFU GUTIERREZ,18,18,24,12,0,36,32,4,36,0,9,8,3,9,5,1,1,0,0,2,26,4,32
20201227,27DEC2020:00:00:00,UFU MUÑIZ,87,120,105,97,5,207,115,92,125,82,0,5,55,75,28,22,14,8,0,26,78,11,115
20201227,27DEC2020:00:00:00,UFU PENNA,11,6,12,5,0,17,13,4,13,4,0,0,5,2,9,1,0,0,0,5,7,1,13
20201227,27DEC2020:00:00:00,UFU PIROVANO,34,29,49,14,0,63,55,8,61,2,0,1,20,24,9,7,2,0,0,9,41,5,55
20201227,27DEC2020:00:00:00,UFU PIÑERO,33,32,45,18,2,65,53,12,53,12,2,5,17,18,12,7,3,1,0,17,32,3,53
20201227,27DEC2020:00:00:00,UFU RAMOS MEJIA,13,12,22,3,0,25,19,6,19,6,0,0,6,9,4,2,0,4,0,9,5,5,19
20201227,27DEC2020:00:00:00,UFU RIVADAVIA,92,71,131,29,3,163,149,14,149,14,0,4,57,57,11,21,7,6,0,34,90,24,149
20201227,27DEC2020:00:00:00,UFU SANTOJANNI,19,14,22,11,0,33,29,4,29,4,0,2,3,10,9,5,2,2,0,11,12,6,29
20201227,27DEC2020:00:00:00,UFU TORNU,31,40,39,3,29,71,67,4,69,2,0,0,13,25,13,9,8,3,0,11,39,17,67
20201227,27DEC2020:00:00:00,UFU VELEZ SARSFIELD,38,40,60,18,0,78,76,2,78,0,0,2,14,22,23,8,4,5,0,31,35,10,76
20201227,27DEC2020:00:00:00,UFU ZUBIZARRETA,63,80,112,31,0,143,123,20,129,14,2,4,47,34,18,15,16,7,0,20,83,20,123
20201228,28DEC2020:00:00:00,UFU ALVAREZ,116,91,147,56,4,207,195,12,195,12,7,8,64,43,38,26,12,9,0,28,79,88,195
20201228,28DEC2020:00:00:00,UFU ARGERICH,48,25,46,27,0,73,57,16,57,16,6,0,13,16,11,12,6,9,0,6,31,20,57
20201228,28DEC2020:00:00:00,UFU BORDA-MOYANO,19,19,24,13,1,38,36,2,36,2,0,2,10,8,7,6,3,2,0,1,27,8,36
20201228,28DEC2020:00:00:00,UFU DURAND,36,49,74,11,0,85,81,4,81,4,0,1,23,16,16,19,5,5,0,23,40,18,81
20201228,28DEC2020:00:00:00,UFU ELIZALDE,52,44,30,66,0,96,72,24,92,4,46,19,6,10,7,3,3,2,0,4,54,14,72
20201228,28DEC2020:00:00:00,UFU FERNANDEZ,84,51,110,25,0,135,133,2,133,2,0,3,38,47,21,22,1,3,0,24,78,31,133
20201228,28DEC2020:00:00:00,UFU FERRER,47,58,56,47,2,105,103,2,103,2,0,2,39,23,14,21,6,0,0,20,75,8,103
20201228,28DEC2020:00:00:00,UFU GRIERSON,74,55,77,51,1,129,125,4,125,4,0,5,36,30,29,18,9,2,0,33,73,19,125
20201228,28DEC2020:00:00:00,UFU GUTIERREZ,64,31,44,51,0,95,79,16,93,2,22,20,16,17,11,7,1,1,0,1,57,21,79
20201228,28DEC2020:00:00:00,UFU MUÑIZ,195,238,190,233,10,433,317,116,349,84,5,15,118,121,87,53,23,11,0,37,248,32,317
20201228,28DEC2020:00:00:00,UFU PENNA,24,14,23,15,0,38,34,4,34,4,0,2,13,9,6,4,4,0,0,8,22,4,34
20201228,28DEC2020:00:00:00,UFU PIROVANO,92,74,134,30,2,166,138,28,166,0,0,3,46,56,18,25,13,5,0,22,87,29,138
20201228,28DEC2020:00:00:00,UFU PIÑERO,66,48,69,34,11,114,88,26,92,22,0,6,31,21,21,20,11,4,0,26,51,10,88
20201228,28DEC2020:00:00:00,UFU RAMOS MEJIA,77,57,93,29,12,134,114,20,118,16,3,17,37,31,11,21,11,3,0,35,60,19,114
20201228,28DEC2020:00:00:00,UFU RIVADAVIA,123,117,168,68,4,240,170,70,170,70,0,7,86,57,36,31,13,10,0,35,85,49,170
20201228,28DEC2020:00:00:00,UFU SANTOJANNI,71,46,86,31,0,117,105,12,115,2,2,6,30,28,26,11,8,6,0,26,68,11,105
20201228,28DEC2020:00:00:00,UFU TORNU,70,50,82,34,4,120,100,20,100,20,1,4,44,23,20,9,12,7,0,26,52,22,100
20201228,28DEC2020:00:00:00,UFU VELEZ SARSFIELD,29,21,40,10,0,50,44,6,50,0,0,1,14,12,11,6,4,2,0,12,27,5,44
20201228,28DEC2020:00:00:00,UFU ZUBIZARRETA,37,49,65,21,0,86,76,10,76,10,2,7,20,12,20,16,6,3,0,16,42,18,76
20201229,29DEC2020:00:00:00,UFU ALVAREZ,116,108,171,51,2,224,208,16,208,16,3,10,46,56,51,30,19,9,0,43,87,78,208
20201229,29DEC2020:00:00:00,UFU ARGERICH,30,35,38,25,2,65,51,14,57,8,4,3,18,20,10,3,5,2,0,9,34,8,51
20201229,29DEC2020:00:00:00,UFU BORDA-MOYANO,28,28,30,25,1,56,54,2,54,2,0,5,17,16,8,4,6,0,0,4,42,8,54
20201229,29DEC2020:00:00:00,UFU DURAND,47,35,74,8,0,82,80,2,80,2,2,7,25,16,11,11,9,1,0,16,50,14,80
20201229,29DEC2020:00:00:00,UFU ELIZALDE,52,39,23,65,3,91,71,20,85,6,33,25,6,11,5,6,5,0,0,4,56,11,71
20201229,29DEC2020:00:00:00,UFU FERNANDEZ,81,61,122,16,4,142,132,10,138,4,0,2,40,47,13,24,14,2,0,30,53,49,132
20201229,29DEC2020:00:00:00,UFU FERRER,53,57,71,39,0,110,108,2,108,2,0,0,32,36,21,10,11,0,0,22,74,12,108
20201229,29DEC2020:00:00:00,UFU GRIERSON,79,57,67,66,3,136,134,2,136,0,0,10,39,27,33,17,7,3,0,39,86,9,134
20201229,29DEC2020:00:00:00,UFU GUTIERREZ,79,30,54,54,1,109,73,36,107,2,36,14,9,26,22,2,0,0,0,0,54,19,73
20201229,29DEC2020:00:00:00,UFU MUÑIZ,199,235,198,224,12,434,262,172,290,144,5,22,110,118,95,45,26,13,0,39,205,18,262
20201229,29DEC2020:00:00:00,UFU PENNA,24,20,35,7,2,44,36,8,38,6,0,3,8,15,8,5,5,0,0,9,21,6,36
20201229,29DEC2020:00:00:00,UFU PIROVANO,85,97,135,36,11,182,172,10,178,4,0,12,50,51,16,18,25,10,0,40,91,41,172
20201229,29DEC2020:00:00:00,UFU PIÑERO,77,63,93,33,14,140,104,36,110,30,3,0,36,36,23,18,14,10,0,22,77,5,104
20201229,29DEC2020:00:00:00,UFU RAMOS MEJIA,56,64,74,37,9,120,104,16,106,14,4,6,52,26,13,5,9,5,0,27,56,21,104
20201229,29DEC2020:00:00:00,UFU RIVADAVIA,122,63,124,52,9,185,165,20,169,16,0,5,61,53,36,10,7,13,0,32,79,53,165
20201229,29DEC2020:00:00:00,UFU SANTOJANNI,69,78,89,58,0,147,143,4,147,0,7,9,42,24,23,20,13,9,0,38,63,42,143
20201229,29DEC2020:00:00:00,UFU TORNU,77,51,79,46,3,128,114,14,114,14,8,9,34,33,20,11,12,1,0,22,70,22,114
20201229,29DEC2020:00:00:00,UFU VELEZ SARSFIELD,38,40,64,14,0,78,72,6,78,0,0,2,22,27,8,10,4,5,0,17,41,14,72
20201229,29DEC2020:00:00:00,UFU ZUBIZARRETA,20,11,26,5,0,31,29,2,29,2,0,0,10,7,10,3,0,1,0,2,16,11,29
20201230,30DEC2020:00:00:00,UFU ALVAREZ,128,98,174,52,0,226,210,16,214,12,4,12,75,54,24,26,18,13,0,22,45,143,210
20201230,30DEC2020:00:00:00,UFU ARGERICH,40,46,44,40,2,86,69,17,69,17,0,4,25,14,14,18,9,2,0,6,32,31,69
20201230,30DEC2020:00:00:00,UFU BORDA-MOYANO,59,48,54,49,4,107,103,4,103,4,0,0,28,37,16,14,5,7,0,8,57,38,103
20201230,30DEC2020:00:00:00,UFU DURAND,54,45,90,9,0,99,99,0,99,0,6,2,26,37,14,4,7,3,0,26,38,35,99
20201230,30DEC2020:00:00:00,UFU ELIZALDE,55,48,45,57,1,103,87,16,97,6,42,15,7,29,4,4,2,0,0,1,56,30,87
20201230,30DEC2020:00:00:00,UFU FERNANDEZ,86,63,117,26,6,149,137,12,141,8,0,4,54,48,17,17,7,2,0,24,50,63,137
20201230,30DEC2020:00:00:00,UFU FERRER,38,54,57,35,0,92,90,2,90,2,0,2,32,23,13,13,9,0,0,20,55,15,90
20201230,30DEC2020:00:00:00,UFU GRIERSON,89,57,80,65,1,146,146,0,146,0,0,4,53,41,25,16,4,3,0,44,87,14,146
20210214,14FEB2021:00:00:00,UFU ARGERICH,10,11,14,7,0,21,19,2,21,0,0,0,4,6,4,0,5,2,0,4,6,9,19
20201230,30DEC2020:00:00:00,UFU GUTIERREZ,68,32,74,26,0,100,80,20,90,10,23,15,21,28,7,4,2,0,0,1,43,34,80
20201230,30DEC2020:00:00:00,UFU MUÑIZ,220,211,193,229,9,431,273,158,295,136,5,21,100,132,83,46,24,20,0,44,193,34,273
20201230,30DEC2020:00:00:00,UFU PENNA,51,31,53,27,2,82,70,12,70,12,0,6,22,18,15,16,2,3,0,15,35,20,70
20201230,30DEC2020:00:00:00,UFU PIROVANO,131,125,179,43,34,256,216,40,242,14,0,8,94,70,37,27,14,6,0,29,97,90,216
20201230,30DEC2020:00:00:00,UFU PIÑERO,68,42,73,33,4,110,98,12,102,8,0,4,42,27,16,11,10,0,0,17,71,10,98
20201230,30DEC2020:00:00:00,UFU RAMOS MEJIA,57,66,100,23,0,123,107,16,113,10,6,2,43,30,14,15,7,6,0,21,37,49,107
20201230,30DEC2020:00:00:00,UFU RIVADAVIA,166,115,195,70,16,281,267,14,269,12,0,4,98,63,42,38,24,12,0,41,112,114,267
20201230,30DEC2020:00:00:00,UFU SANTOJANNI,130,127,156,99,2,257,241,16,253,4,3,16,58,57,51,23,27,22,0,54,92,95,241
20201230,30DEC2020:00:00:00,UFU TORNU,97,82,131,48,0,179,159,20,167,12,6,9,58,43,28,11,19,5,0,24,71,64,159
20201230,30DEC2020:00:00:00,UFU VELEZ SARSFIELD,44,54,78,20,0,98,94,4,98,0,0,0,25,34,20,10,5,4,0,21,10,63,94
20201230,30DEC2020:00:00:00,UFU ZUBIZARRETA,5,4,5,4,0,9,9,0,9,0,0,1,2,2,3,1,0,0,0,0,7,2,9
20201231,31DEC2020:00:00:00,UFU ALVAREZ,11,4,12,3,0,15,13,2,13,2,0,0,3,4,6,2,0,0,0,2,2,9,13
20201231,31DEC2020:00:00:00,UFU BORDA-MOYANO,6,3,3,6,0,9,9,0,9,0,0,0,0,3,6,0,0,0,0,3,3,3,9
20201231,31DEC2020:00:00:00,UFU DURAND,15,14,27,2,0,29,29,0,29,0,0,0,6,9,5,5,4,0,0,7,12,10,29
20201231,31DEC2020:00:00:00,UFU MUÑIZ,101,95,78,115,3,196,110,86,116,80,2,2,49,62,38,22,15,6,0,21,63,25,110
20201231,31DEC2020:00:00:00,UFU PIÑERO,46,28,42,25,7,74,64,10,68,6,0,2,30,16,15,4,1,6,0,13,35,16,64
20201231,31DEC2020:00:00:00,UFU TORNU,8,4,6,6,0,12,12,0,12,0,0,0,0,4,4,2,2,0,0,3,3,6,12
20210101,01JAN2021:00:00:00,UFU BORDA-MOYANO,10,14,11,11,2,24,24,0,24,0,0,4,8,0,5,2,1,4,0,0,14,10,24
20210101,01JAN2021:00:00:00,UFU DURAND,0,8,8,0,0,8,0,8,0,8,0,2,2,2,2,0,0,0,0,0,0,0,0
20210101,01JAN2021:00:00:00,UFU MUÑIZ,58,51,37,72,0,109,67,42,69,40,3,0,31,37,17,9,8,4,0,9,44,14,67
20210101,01JAN2021:00:00:00,UFU PIÑERO,12,8,14,4,2,20,20,0,20,0,0,0,9,3,2,4,2,0,0,4,14,2,20
20210101,01JAN2021:00:00:00,UFU TORNU,4,5,7,2,0,9,5,4,7,2,0,0,2,1,6,0,0,0,0,1,2,2,5
20210102,02JAN2021:00:00:00,UFU ALVAREZ,145,97,193,46,3,242,238,4,238,4,6,14,68,58,46,24,17,9,0,34,107,97,238
20210102,02JAN2021:00:00:00,UFU BORDA-MOYANO,19,31,34,16,0,50,50,0,50,0,0,0,8,9,16,7,6,4,0,3,27,20,50
20210102,02JAN2021:00:00:00,UFU DURAND,50,54,101,3,0,104,102,2,102,2,4,2,27,30,10,14,15,2,0,27,33,42,102
20210102,02JAN2021:00:00:00,UFU ELIZALDE,46,29,19,54,2,75,49,26,69,6,29,24,6,9,2,5,0,0,0,1,29,19,49
20210102,02JAN2021:00:00:00,UFU FERNANDEZ,99,111,182,28,0,210,202,8,206,4,0,0,76,72,14,14,22,12,0,40,75,87,202
20210102,02JAN2021:00:00:00,UFU FERRER,39,40,46,33,0,79,75,4,75,4,0,2,19,31,11,11,5,0,0,24,38,13,75
20210102,02JAN2021:00:00:00,UFU GRIERSON,51,42,52,37,4,93,93,0,93,0,0,5,27,28,17,11,4,1,0,35,47,11,93
20210102,02JAN2021:00:00:00,UFU GUTIERREZ,66,44,47,63,0,110,102,8,104,6,26,32,7,16,15,11,2,1,0,2,53,46,102
20210102,02JAN2021:00:00:00,UFU MUÑIZ,45,45,38,51,1,90,66,24,76,14,2,2,19,19,18,11,12,7,0,17,27,22,66
20210102,02JAN2021:00:00:00,UFU PENNA,35,35,36,32,2,70,66,4,68,2,0,2,12,18,10,13,8,7,0,8,31,26,66
20210102,02JAN2021:00:00:00,UFU PIROVANO,92,72,146,18,0,164,146,18,164,0,0,0,37,54,33,24,11,5,0,30,52,64,146
20210102,02JAN2021:00:00:00,UFU PIÑERO,65,42,82,23,2,107,79,28,81,26,0,8,24,20,30,16,7,2,0,11,56,12,79
20210102,02JAN2021:00:00:00,UFU RAMOS MEJIA,33,28,48,13,0,61,59,2,59,2,0,0,24,7,12,9,5,4,0,16,20,23,59
20210102,02JAN2021:00:00:00,UFU RIVADAVIA,182,143,257,64,4,325,309,16,309,16,0,1,121,82,36,36,32,17,0,43,137,127,309
20210102,02JAN2021:00:00:00,UFU SANTOJANNI,75,76,78,69,4,151,139,12,145,6,0,8,45,32,25,22,13,6,0,31,54,54,139
20210102,02JAN2021:00:00:00,UFU TORNU,76,71,72,69,6,147,135,12,141,6,1,5,59,28,20,26,6,2,0,26,56,53,135
20210102,02JAN2021:00:00:00,UFU VELEZ SARSFIELD,83,80,135,28,0,163,159,4,161,2,0,4,43,36,26,31,20,3,0,45,69,45,159
20210102,02JAN2021:00:00:00,UFU ZUBIZARRETA,74,68,108,30,4,142,124,18,132,10,0,7,41,29,27,15,14,9,0,29,83,12,124
20210103,03JAN2021:00:00:00,UFU ALVAREZ,88,71,125,33,1,159,143,16,143,16,4,8,38,44,30,16,14,5,0,26,58,58,143
20210103,03JAN2021:00:00:00,UFU BORDA-MOYANO,21,5,19,7,0,26,26,0,26,0,0,1,3,5,5,6,2,4,0,1,15,10,26
20210103,03JAN2021:00:00:00,UFU ELIZALDE,52,38,18,70,2,90,68,22,88,2,38,31,1,4,12,2,2,0,0,3,41,24,68
20210103,03JAN2021:00:00:00,UFU FERNANDEZ,84,51,109,26,0,135,105,30,123,12,0,4,30,32,23,32,11,3,0,22,38,45,105
20210103,03JAN2021:00:00:00,UFU FERRER,41,32,34,37,2,73,70,3,70,3,0,2,20,17,16,10,8,0,0,15,42,13,70
20210103,03JAN2021:00:00:00,UFU GRIERSON,54,42,65,29,2,96,88,8,92,4,0,1,33,22,18,11,9,2,0,33,51,4,88
20210103,03JAN2021:00:00:00,UFU GUTIERREZ,57,18,34,41,0,75,71,4,73,2,27,13,18,14,3,0,0,0,0,2,41,28,71
20210103,03JAN2021:00:00:00,UFU MUÑIZ,85,72,75,80,2,157,103,54,103,54,1,8,33,42,23,30,13,7,0,23,70,10,103
20210103,03JAN2021:00:00:00,UFU PENNA,40,20,46,14,0,60,48,12,50,10,0,1,27,7,7,6,3,9,0,5,24,18,48
20210103,03JAN2021:00:00:00,UFU PIROVANO,75,64,118,21,0,139,131,8,135,4,0,0,50,56,11,16,3,3,0,25,55,51,131
20210103,03JAN2021:00:00:00,UFU PIÑERO,41,29,51,17,2,70,52,18,54,16,2,4,17,14,14,9,6,4,0,13,37,1,52
20210103,03JAN2021:00:00:00,UFU RAMOS MEJIA,30,24,43,11,0,54,50,4,50,4,3,0,17,14,11,4,4,1,0,10,20,20,50
20210103,03JAN2021:00:00:00,UFU RIVADAVIA,88,71,146,13,0,159,151,8,151,8,0,6,41,48,24,20,17,3,0,21,68,62,151
20210103,03JAN2021:00:00:00,UFU SANTOJANNI,60,54,75,39,0,114,114,0,114,0,2,5,45,19,24,8,6,5,0,29,40,45,114
20210103,03JAN2021:00:00:00,UFU TORNU,58,50,74,30,4,108,100,8,100,8,3,5,22,38,10,14,14,2,0,28,37,35,100
20210103,03JAN2021:00:00:00,UFU VELEZ SARSFIELD,72,66,104,32,2,138,136,2,138,0,0,1,57,36,18,13,8,5,0,30,63,43,136
20210103,03JAN2021:00:00:00,UFU ZUBIZARRETA,96,101,140,55,2,197,175,22,181,16,0,14,52,41,34,35,13,8,0,27,54,94,175
20210204,04FEB2021:00:00:00,UFU RAMOS MEJIA,60,68,77,40,11,128,108,20,116,12,2,9,28,28,22,14,20,5,0,19,45,43,108
20210204,04FEB2021:00:00:00,UFU RIVADAVIA,165,103,195,53,20,268,260,8,262,6,0,11,82,68,34,36,29,8,0,27,121,106,260
20210204,04FEB2021:00:00:00,UFU SANTOJANNI,95,70,87,78,0,165,159,6,165,0,0,10,23,56,36,27,9,4,0,17,76,66,159
20210204,04FEB2021:00:00:00,UFU TORNU,46,31,53,24,0,77,73,4,73,4,0,5,17,25,15,12,3,0,0,5,41,27,73
20210204,04FEB2021:00:00:00,UFU VELEZ SARSFIELD,58,76,105,29,0,134,98,36,134,0,0,3,33,36,27,19,11,5,0,17,40,41,98
20210204,04FEB2021:00:00:00,UFU ZUBIZARRETA,17,23,17,23,0,40,22,18,40,0,0,18,7,1,13,0,1,0,0,0,14,8,22
20210205,05FEB2021:00:00:00,UFU ALVAREZ,111,93,162,36,6,204,164,40,170,34,5,15,50,52,21,34,17,10,0,18,72,74,164
20210205,05FEB2021:00:00:00,UFU ARGERICH,44,29,47,18,8,73,55,18,55,18,2,6,20,17,10,10,0,8,0,5,11,38,55
20210205,05FEB2021:00:00:00,UFU BORDA-MOYANO,68,59,45,50,32,127,121,6,121,6,9,4,22,33,23,20,9,7,0,1,74,45,121
20210205,05FEB2021:00:00:00,UFU DURAND,114,95,182,27,0,209,201,8,203,6,0,8,66,54,48,10,19,4,0,33,96,72,201
20210205,05FEB2021:00:00:00,UFU ELIZALDE,86,66,39,110,3,152,122,30,136,16,70,29,17,12,9,7,8,0,0,7,69,46,122
20210205,05FEB2021:00:00:00,UFU FERNANDEZ,126,119,198,45,2,245,165,80,239,6,2,6,77,55,48,31,20,6,0,9,41,115,165
20210205,05FEB2021:00:00:00,UFU FERRER,52,41,52,39,2,93,93,0,93,0,0,2,24,19,21,5,18,4,0,17,38,38,93
20210205,05FEB2021:00:00:00,UFU GRIERSON,90,78,72,89,7,168,168,0,168,0,0,5,49,33,42,23,10,6,0,32,74,62,168
20210205,05FEB2021:00:00:00,UFU GUTIERREZ,54,43,67,28,2,97,91,6,97,0,21,11,27,20,8,8,2,0,0,6,46,38,91
20210205,05FEB2021:00:00:00,UFU MUÑIZ,221,217,187,230,21,438,332,106,350,88,2,21,130,103,88,49,34,11,0,24,210,97,332
20210205,05FEB2021:00:00:00,UFU PENNA,23,29,33,14,5,52,48,4,50,2,0,3,7,12,11,6,8,5,0,3,25,20,48
20210205,05FEB2021:00:00:00,UFU PIROVANO,158,78,188,38,10,236,214,22,230,6,0,8,78,63,38,24,3,22,0,24,106,84,214
20210205,05FEB2021:00:00:00,UFU PIÑERO,80,57,97,36,4,137,127,10,135,2,0,8,25,32,40,8,12,12,0,13,88,26,127
20210205,05FEB2021:00:00:00,UFU RAMOS MEJIA,58,40,60,34,4,98,88,10,94,4,0,10,26,23,12,13,8,6,0,9,48,31,88
20210205,05FEB2021:00:00:00,UFU RIVADAVIA,145,136,187,63,31,281,241,40,245,36,0,14,55,70,57,51,19,15,0,10,129,102,241
20210205,05FEB2021:00:00:00,UFU SANTOJANNI,67,76,88,55,0,143,137,6,141,2,0,2,42,32,21,25,15,6,0,7,50,80,137
20210205,05FEB2021:00:00:00,UFU TORNU,44,19,36,27,0,63,61,2,61,2,2,4,13,8,14,12,6,4,0,10,29,22,61
20210205,05FEB2021:00:00:00,UFU VELEZ SARSFIELD,77,51,93,27,8,128,124,4,126,2,0,1,31,25,25,25,12,9,0,22,52,50,124
20210205,05FEB2021:00:00:00,UFU ZUBIZARRETA,125,112,139,89,9,237,231,6,237,0,0,3,88,59,35,18,24,10,0,24,67,140,231
20210206,06FEB2021:00:00:00,UFU ALVAREZ,95,57,114,34,4,152,142,10,142,10,0,5,35,34,22,31,19,6,0,21,39,82,142
20210206,06FEB2021:00:00:00,UFU BORDA-MOYANO,43,44,70,17,0,87,81,6,81,6,0,5,19,25,14,16,8,0,0,1,47,33,81
20210206,06FEB2021:00:00:00,UFU DURAND,49,67,97,19,0,116,116,0,116,0,2,1,48,42,10,6,1,6,0,19,64,32,116
20210206,06FEB2021:00:00:00,UFU ELIZALDE,34,46,10,70,0,80,54,26,70,10,37,21,7,6,4,5,0,0,0,0,33,21,54
20210206,06FEB2021:00:00:00,UFU FERNANDEZ,116,96,170,36,6,212,84,128,210,2,0,9,76,48,37,26,7,9,0,12,28,44,84
20210206,06FEB2021:00:00:00,UFU FERRER,29,21,24,26,0,50,50,0,50,0,0,2,14,8,12,12,2,0,0,14,17,19,50
20210206,06FEB2021:00:00:00,UFU GRIERSON,72,63,65,66,4,135,109,26,131,4,0,8,40,35,29,15,5,3,0,14,48,47,109
20210206,06FEB2021:00:00:00,UFU GUTIERREZ,50,36,33,49,4,86,84,2,84,2,21,29,6,14,12,2,2,0,0,1,47,36,84
20210206,06FEB2021:00:00:00,UFU MUÑIZ,144,146,109,174,7,290,204,86,210,80,0,0,55,77,70,43,29,16,0,25,119,60,204
20210206,06FEB2021:00:00:00,UFU PENNA,25,16,23,17,1,41,35,6,41,0,0,1,8,5,6,4,12,5,0,3,23,9,35
20210206,06FEB2021:00:00:00,UFU PIROVANO,68,50,96,20,2,118,106,12,118,0,0,0,30,33,25,9,8,13,0,18,46,42,106
20210206,06FEB2021:00:00:00,UFU PIÑERO,46,24,56,11,3,70,70,0,70,0,0,4,11,25,15,10,5,0,0,3,48,19,70
20210206,06FEB2021:00:00:00,UFU RAMOS MEJIA,46,47,60,19,14,93,89,4,89,4,6,13,20,25,10,8,8,3,0,10,38,41,89
20210206,06FEB2021:00:00:00,UFU RIVADAVIA,130,81,138,61,12,211,203,8,203,8,0,7,38,68,44,33,21,0,0,18,97,88,203
20210206,06FEB2021:00:00:00,UFU SANTOJANNI,79,55,68,63,3,134,120,14,130,4,0,6,29,28,26,24,11,10,0,13,57,50,120
20210206,06FEB2021:00:00:00,UFU TORNU,40,21,28,29,4,61,59,2,59,2,0,0,20,15,9,15,2,0,0,5,27,27,59
20210206,06FEB2021:00:00:00,UFU VELEZ SARSFIELD,45,71,82,32,2,116,110,6,112,4,0,0,25,31,25,22,11,2,0,20,45,45,110
20210206,06FEB2021:00:00:00,UFU ZUBIZARRETA,131,121,166,71,15,252,224,28,242,10,0,16,52,61,50,47,20,6,0,31,100,93,224
20210207,07FEB2021:00:00:00,UFU ALVAREZ,50,67,93,23,1,117,99,18,101,16,8,0,35,26,25,7,11,5,0,8,48,43,99
20210207,07FEB2021:00:00:00,UFU ARGERICH,12,9,17,4,0,21,15,6,21,0,0,2,5,8,0,2,0,4,0,1,8,6,15
20210207,07FEB2021:00:00:00,UFU BORDA-MOYANO,8,8,11,5,0,16,16,0,16,0,0,0,2,7,4,2,1,0,0,0,10,6,16
20210207,07FEB2021:00:00:00,UFU ELIZALDE,45,24,20,47,2,69,57,12,63,6,35,11,6,10,5,2,0,0,0,0,29,28,57
20210207,07FEB2021:00:00:00,UFU FERNANDEZ,152,162,271,40,3,314,78,236,310,4,0,2,106,88,57,33,15,13,0,13,31,34,78
20210207,07FEB2021:00:00:00,UFU FERRER,30,17,23,24,0,47,45,2,45,2,0,0,7,17,9,11,3,0,0,7,20,18,45
20210207,07FEB2021:00:00:00,UFU GRIERSON,97,77,87,78,9,174,156,18,174,0,0,7,61,36,17,32,13,8,0,15,80,61,156
20210207,07FEB2021:00:00:00,UFU GUTIERREZ,21,17,19,19,0,38,38,0,38,0,13,10,3,3,8,0,0,1,0,0,26,12,38
20210207,07FEB2021:00:00:00,UFU MUÑIZ,119,101,93,116,11,220,170,50,184,36,0,5,57,63,44,32,15,4,0,9,112,49,170
20210207,07FEB2021:00:00:00,UFU PENNA,25,13,12,26,0,38,34,4,37,1,2,4,5,11,8,6,0,2,0,3,16,15,34
20210207,07FEB2021:00:00:00,UFU PIROVANO,59,63,94,28,0,122,112,10,120,2,0,2,27,41,24,12,7,9,0,17,49,46,112
20210207,07FEB2021:00:00:00,UFU PIÑERO,43,58,81,20,0,101,99,2,99,2,0,3,31,23,14,13,15,2,0,7,61,31,99
20210207,07FEB2021:00:00:00,UFU RAMOS MEJIA,42,36,56,16,8,80,72,8,72,8,4,6,13,23,16,7,8,3,0,11,28,33,72
20210207,07FEB2021:00:00:00,UFU RIVADAVIA,111,94,147,50,8,205,187,18,187,18,0,14,50,52,26,31,28,4,0,20,89,77,187
20210207,07FEB2021:00:00:00,UFU SANTOJANNI,42,57,65,32,2,99,85,14,97,2,0,1,25,29,21,11,8,4,0,11,34,40,85
20210207,07FEB2021:00:00:00,UFU TORNU,21,23,22,12,10,44,40,4,40,4,0,1,10,7,9,9,5,3,0,5,23,12,40
20210207,07FEB2021:00:00:00,UFU VELEZ SARSFIELD,58,57,91,24,0,115,109,6,113,2,0,4,24,33,17,19,13,5,0,12,50,47,109
20210207,07FEB2021:00:00:00,UFU ZUBIZARRETA,116,101,138,74,5,217,181,36,209,8,0,10,54,45,54,25,26,3,0,21,86,74,181
20210208,08FEB2021:00:00:00,UFU ALVAREZ,122,85,144,50,13,207,193,14,193,14,3,8,53,54,40,16,21,12,0,24,93,76,193
20210208,08FEB2021:00:00:00,UFU ARGERICH,40,25,42,23,0,65,51,14,51,14,3,4,14,17,10,7,10,0,0,5,26,20,51
20210208,08FEB2021:00:00:00,UFU BORDA-MOYANO,80,59,46,41,52,139,135,4,135,4,0,13,34,27,31,18,9,7,0,5,76,54,135
20210208,08FEB2021:00:00:00,UFU DURAND,133,71,166,36,2,204,188,16,202,2,1,11,51,50,36,23,15,17,0,36,71,81,188
20210208,08FEB2021:00:00:00,UFU ELIZALDE,77,53,47,82,1,130,98,32,122,8,42,39,10,11,8,13,3,4,0,7,54,37,98
20210208,08FEB2021:00:00:00,UFU FERNANDEZ,126,101,187,29,11,227,147,80,217,10,0,0,56,77,39,30,12,13,0,21,58,68,147
20210208,08FEB2021:00:00:00,UFU FERRER,38,21,23,36,0,59,57,2,57,2,0,0,7,20,16,6,8,2,0,8,25,24,57
20210208,08FEB2021:00:00:00,UFU GRIERSON,85,114,110,87,2,199,191,8,193,6,0,7,79,50,26,27,6,4,0,10,82,99,191
20210208,08FEB2021:00:00:00,UFU GUTIERREZ,55,56,64,45,2,111,95,16,111,0,50,20,13,19,9,0,0,0,0,2,55,38,95
20210208,08FEB2021:00:00:00,UFU MUÑIZ,234,235,171,279,19,469,351,118,363,106,2,13,141,128,74,73,32,6,0,29,216,106,351
20210208,08FEB2021:00:00:00,UFU PENNA,34,32,40,26,0,66,60,6,60,6,0,3,16,22,13,8,3,1,0,4,36,20,60
20210208,08FEB2021:00:00:00,UFU PIROVANO,134,96,159,61,10,230,218,12,226,4,0,0,56,80,26,24,35,9,0,21,105,92,218
20210208,08FEB2021:00:00:00,UFU PIÑERO,89,71,90,58,12,160,150,10,152,8,0,7,47,33,34,26,9,4,0,18,87,43,150
20210208,08FEB2021:00:00:00,UFU RAMOS MEJIA,69,66,79,31,25,135,127,8,127,8,5,5,35,37,14,28,5,6,0,11,63,53,127
20210208,08FEB2021:00:00:00,UFU RIVADAVIA,170,139,205,78,26,309,241,68,241,68,0,12,98,95,36,33,28,7,0,17,109,113,241
20210208,08FEB2021:00:00:00,UFU SANTOJANNI,90,63,68,81,4,153,141,12,153,0,0,5,40,35,27,27,18,1,0,16,65,60,141
20210208,08FEB2021:00:00:00,UFU TORNU,52,48,70,19,11,100,96,4,96,4,5,11,21,23,12,15,8,5,0,15,38,43,96
20210208,08FEB2021:00:00:00,UFU VELEZ SARSFIELD,53,50,79,22,2,103,95,8,95,8,0,3,9,21,30,20,11,9,0,17,41,37,95
20210208,08FEB2021:00:00:00,UFU ZUBIZARRETA,90,89,121,52,6,179,173,6,179,0,0,4,53,31,40,33,10,8,0,21,71,81,173
20210209,09FEB2021:00:00:00,UFU ALVAREZ,124,94,164,44,10,218,196,22,206,12,11,12,46,56,35,30,20,8,0,14,97,85,196
20210209,09FEB2021:00:00:00,UFU ARGERICH,36,36,39,30,3,72,38,34,46,26,8,0,26,19,7,1,7,4,0,0,18,19,38
20210209,09FEB2021:00:00:00,UFU BORDA-MOYANO,50,53,34,34,35,103,101,2,101,2,0,4,16,35,10,26,10,2,0,3,66,32,101
20210209,09FEB2021:00:00:00,UFU DURAND,70,52,103,19,0,122,122,0,122,0,2,2,34,31,27,12,7,7,0,20,69,33,122
20210209,09FEB2021:00:00:00,UFU ELIZALDE,113,97,53,155,2,210,126,84,202,8,80,59,13,26,13,11,4,4,0,1,77,48,126
20210209,09FEB2021:00:00:00,UFU FERNANDEZ,169,116,216,55,14,285,149,136,271,14,0,4,72,88,60,25,17,19,0,23,55,71,149
20210209,09FEB2021:00:00:00,UFU FERRER,38,44,48,32,2,82,80,2,80,2,0,0,17,18,21,14,8,4,0,6,37,37,80
20210209,09FEB2021:00:00:00,UFU GRIERSON,89,104,82,105,6,193,185,8,187,6,0,9,67,38,27,33,11,8,0,18,88,79,185
20210209,09FEB2021:00:00:00,UFU GUTIERREZ,59,61,57,63,0,120,80,40,104,16,55,25,17,12,11,0,0,0,0,1,48,30,80
20210209,09FEB2021:00:00:00,UFU MUÑIZ,204,212,183,223,10,416,304,112,320,96,0,9,103,117,84,58,32,13,0,27,193,84,304
20210209,09FEB2021:00:00:00,UFU PENNA,10,14,12,8,4,24,24,0,24,0,0,0,12,8,0,2,2,0,0,2,15,7,24
20210209,09FEB2021:00:00:00,UFU PIROVANO,112,140,180,59,13,252,230,22,244,8,0,6,78,63,52,23,17,13,0,22,115,93,230
20210209,09FEB2021:00:00:00,UFU PIÑERO,58,43,60,35,6,101,101,0,101,0,0,0,30,33,23,8,6,1,0,8,64,29,101
20210209,09FEB2021:00:00:00,UFU RAMOS MEJIA,81,56,90,37,10,137,127,10,129,8,16,5,24,35,31,20,3,3,0,14,63,50,127
20210209,09FEB2021:00:00:00,UFU RIVADAVIA,156,129,183,64,38,285,247,38,251,34,2,3,82,75,59,26,32,6,0,30,112,104,247
20210209,09FEB2021:00:00:00,UFU SANTOJANNI,87,83,90,76,4,170,162,8,166,4,0,4,44,33,28,37,20,4,0,16,33,113,162
20210209,09FEB2021:00:00:00,UFU TORNU,32,42,59,11,4,74,70,4,70,4,0,0,22,30,8,8,4,2,0,5,31,34,70
20210209,09FEB2021:00:00:00,UFU VELEZ SARSFIELD,60,45,76,29,0,105,105,0,105,0,0,6,20,34,19,12,9,5,0,19,42,44,105
20210209,09FEB2021:00:00:00,UFU ZUBIZARRETA,72,66,74,60,4,138,138,0,138,0,0,10,38,30,25,21,13,1,0,15,62,61,138
20210210,10FEB2021:00:00:00,UFU ALVAREZ,128,135,186,58,19,263,235,28,235,28,5,10,67,56,52,26,25,22,0,12,112,111,235
20210210,10FEB2021:00:00:00,UFU ARGERICH,40,28,35,27,6,68,56,12,56,12,5,3,18,23,8,2,2,7,0,11,20,24,56
20210210,10FEB2021:00:00:00,UFU BORDA-MOYANO,72,92,73,89,2,164,160,4,160,4,4,5,25,28,32,31,26,13,0,4,100,56,160
20210210,10FEB2021:00:00:00,UFU DURAND,146,93,191,48,0,239,215,24,239,0,0,18,59,85,53,8,9,7,0,22,124,69,215
20210210,10FEB2021:00:00:00,UFU ELIZALDE,77,49,25,96,5,126,116,10,122,4,39,26,11,31,10,7,2,0,0,4,69,43,116
20210210,10FEB2021:00:00:00,UFU FERNANDEZ,225,125,276,64,10,350,142,208,346,4,0,6,95,110,72,37,16,14,0,22,60,60,142
20210210,10FEB2021:00:00:00,UFU FERRER,44,32,42,34,0,76,68,8,68,8,0,0,22,21,16,10,5,2,0,12,29,27,68
20210210,10FEB2021:00:00:00,UFU GRIERSON,89,94,88,91,4,183,169,14,169,14,0,8,55,39,47,13,16,5,0,12,88,68,169
20210210,10FEB2021:00:00:00,UFU GUTIERREZ,46,38,60,24,0,84,78,6,84,0,30,14,10,16,10,2,2,0,0,2,41,35,78
20210210,10FEB2021:00:00:00,UFU MUÑIZ,199,229,162,261,5,428,306,122,328,100,0,15,107,125,98,51,21,11,0,26,192,88,306
20210210,10FEB2021:00:00:00,UFU PENNA,43,25,34,26,8,68,58,10,64,4,0,1,27,6,10,8,11,5,0,4,33,21,58
20210210,10FEB2021:00:00:00,UFU PIROVANO,97,63,128,28,4,160,144,16,150,10,0,4,46,51,22,27,9,1,0,8,80,56,144
20210210,10FEB2021:00:00:00,UFU PIÑERO,81,64,109,34,2,145,141,4,145,0,0,6,21,41,35,22,12,8,0,10,91,39,141
20210210,10FEB2021:00:00:00,UFU RAMOS MEJIA,70,76,85,61,0,146,140,6,144,2,6,2,29,40,28,27,10,4,0,8,69,63,140
20210210,10FEB2021:00:00:00,UFU RIVADAVIA,166,121,191,60,36,287,247,40,261,26,0,16,78,69,45,60,12,7,0,23,121,102,247
20210210,10FEB2021:00:00:00,UFU SANTOJANNI,112,97,103,104,2,209,201,8,207,2,0,11,53,38,39,32,28,8,0,17,98,86,201
20210210,10FEB2021:00:00:00,UFU TORNU,34,28,47,12,3,62,54,8,56,6,0,4,17,14,20,3,2,2,0,9,23,22,54
20210210,10FEB2021:00:00:00,UFU VELEZ SARSFIELD,51,63,80,30,4,114,106,8,110,4,0,2,29,34,18,13,8,10,0,12,53,41,106
20210210,10FEB2021:00:00:00,UFU ZUBIZARRETA,121,79,97,95,8,200,196,4,200,0,0,15,48,27,43,33,17,17,0,22,93,81,196
20210211,11FEB2021:00:00:00,UFU ALVAREZ,104,90,126,59,9,194,186,8,188,6,5,11,51,56,23,19,19,10,0,15,94,77,186
20210211,11FEB2021:00:00:00,UFU ARGERICH,40,37,38,39,0,77,55,22,55,22,10,0,22,15,16,12,0,2,0,10,22,23,55
20210211,11FEB2021:00:00:00,UFU BORDA-MOYANO,53,51,31,44,29,104,102,2,102,2,0,5,20,34,13,19,11,2,0,4,58,39,102
20210211,11FEB2021:00:00:00,UFU DURAND,78,80,128,26,4,158,150,8,152,6,4,2,45,32,20,35,13,7,0,20,65,65,150
20210211,11FEB2021:00:00:00,UFU ELIZALDE,72,76,48,98,2,148,116,32,132,16,47,33,15,19,21,10,2,1,0,3,77,36,116
20210211,11FEB2021:00:00:00,UFU FERNANDEZ,136,123,214,33,12,259,127,132,251,8,0,4,66,86,35,39,24,5,0,10,49,68,127
20210211,11FEB2021:00:00:00,UFU FERRER,48,54,51,49,2,102,100,2,100,2,0,4,41,19,19,10,8,1,0,12,45,43,100
20210211,11FEB2021:00:00:00,UFU GRIERSON,102,91,84,107,2,193,189,4,189,4,0,17,50,31,38,27,22,8,0,25,83,81,189
20210211,11FEB2021:00:00:00,UFU GUTIERREZ,56,51,84,20,3,107,97,10,107,0,23,19,22,19,13,6,5,0,0,6,45,45,97
20210211,11FEB2021:00:00:00,UFU MUÑIZ,221,283,203,290,11,504,364,140,382,122,3,26,132,142,98,64,34,5,0,21,239,102,364
20210211,11FEB2021:00:00:00,UFU PENNA,29,24,42,6,5,53,35,18,51,2,0,2,12,9,8,13,1,8,0,7,16,12,35
20210211,11FEB2021:00:00:00,UFU PIROVANO,126,136,179,75,8,262,228,34,258,4,0,6,64,65,52,30,29,16,0,24,110,94,228
20220425,25APR2022:00:00:00,UFU PENNA,7,13,10,10,0,20,20,0,20,0,0,2,3,6,6,0,1,2,0,0,11,9,20
20210211,11FEB2021:00:00:00,UFU PIÑERO,70,72,81,52,9,142,136,6,140,2,0,4,46,44,27,14,3,4,0,11,85,37,136
20210211,11FEB2021:00:00:00,UFU RAMOS MEJIA,59,72,83,38,10,131,117,14,123,8,5,13,30,13,29,18,21,2,0,7,57,53,117
20210211,11FEB2021:00:00:00,UFU RIVADAVIA,172,113,186,63,36,285,259,26,267,18,0,8,87,67,39,53,26,5,0,20,127,108,259
20210211,11FEB2021:00:00:00,UFU SANTOJANNI,79,77,87,67,2,156,144,12,154,2,7,8,38,45,34,13,8,3,0,21,64,59,144
20210211,11FEB2021:00:00:00,UFU TORNU,24,38,45,15,2,62,54,8,54,8,3,2,13,15,10,10,6,3,0,9,24,21,54
20210211,11FEB2021:00:00:00,UFU VELEZ SARSFIELD,89,55,99,45,0,144,78,66,144,0,0,4,27,40,20,33,12,8,0,13,35,30,78
20210211,11FEB2021:00:00:00,UFU ZUBIZARRETA,75,75,94,54,2,150,132,18,150,0,0,20,18,36,39,13,10,14,0,8,74,50,132
20210212,12FEB2021:00:00:00,UFU ALVAREZ,120,94,166,41,7,214,158,56,172,42,2,13,48,53,25,34,27,12,0,20,69,69,158
20210212,12FEB2021:00:00:00,UFU ARGERICH,40,20,39,19,2,60,39,21,39,21,6,0,11,16,12,7,3,5,0,5,13,20,39
20210212,12FEB2021:00:00:00,UFU BORDA-MOYANO,83,102,54,104,27,185,181,4,181,4,3,11,21,52,32,44,15,7,0,1,99,74,181
20210212,12FEB2021:00:00:00,UFU DURAND,113,100,175,32,6,213,207,6,207,6,4,4,55,62,45,17,17,9,0,18,130,59,207
20210212,12FEB2021:00:00:00,UFU ELIZALDE,65,67,35,88,9,132,114,18,126,6,42,30,14,17,16,9,0,4,0,3,60,51,114
20210212,12FEB2021:00:00:00,UFU FERNANDEZ,122,82,166,30,8,204,130,74,200,4,0,13,43,65,21,27,28,7,0,0,5,125,130
20210212,12FEB2021:00:00:00,UFU FERRER,29,35,31,27,6,64,60,4,60,4,0,0,18,12,11,11,8,4,0,8,27,25,60
20210212,12FEB2021:00:00:00,UFU GRIERSON,106,102,78,122,8,208,200,8,204,4,0,14,57,58,36,31,8,4,0,18,89,93,200
20210212,12FEB2021:00:00:00,UFU GUTIERREZ,59,57,76,38,2,116,104,12,114,2,36,11,19,26,11,11,2,0,0,4,53,46,104
20210212,12FEB2021:00:00:00,UFU MUÑIZ,226,263,210,275,4,489,327,162,347,142,2,10,102,147,99,73,32,24,0,29,197,101,327
20210212,12FEB2021:00:00:00,UFU PENNA,16,7,17,6,0,23,21,2,23,0,0,2,6,8,3,4,0,0,0,2,11,8,21
20210212,12FEB2021:00:00:00,UFU PIROVANO,134,110,173,65,6,244,208,36,234,10,0,10,50,65,39,33,20,27,0,22,102,84,208
20210212,12FEB2021:00:00:00,UFU PIÑERO,78,75,82,66,5,153,141,12,143,10,0,0,49,41,12,14,22,15,0,9,97,34,141
20210212,12FEB2021:00:00:00,UFU RAMOS MEJIA,67,55,78,35,9,122,102,20,120,2,7,6,20,39,21,10,12,7,0,13,44,45,102
20210212,12FEB2021:00:00:00,UFU RIVADAVIA,189,124,213,58,42,313,289,24,293,20,2,22,74,93,52,39,26,5,0,25,149,115,289
20210212,12FEB2021:00:00:00,UFU SANTOJANNI,82,70,77,69,6,152,130,22,146,6,4,3,33,34,36,25,12,5,0,10,67,53,130
20210212,12FEB2021:00:00:00,UFU TORNU,39,47,60,22,4,86,72,14,78,8,2,5,13,23,13,16,14,0,0,13,26,33,72
20210212,12FEB2021:00:00:00,UFU VELEZ SARSFIELD,67,73,109,27,4,140,134,6,136,4,0,4,50,25,31,16,10,4,0,20,61,53,134
20210212,12FEB2021:00:00:00,UFU ZUBIZARRETA,72,84,87,61,8,156,156,0,156,0,0,11,22,27,33,21,27,15,0,16,76,64,156
20210213,13FEB2021:00:00:00,UFU ALVAREZ,87,60,118,17,12,147,127,20,127,20,2,9,26,54,20,22,8,6,0,19,56,52,127
20210213,13FEB2021:00:00:00,UFU ARGERICH,2,0,2,0,0,2,2,0,2,0,0,2,0,0,0,0,0,0,0,0,1,1,2
20210213,13FEB2021:00:00:00,UFU BORDA-MOYANO,12,12,16,8,0,24,20,4,20,4,0,0,11,1,2,5,4,1,0,4,8,8,20
20210213,13FEB2021:00:00:00,UFU DURAND,64,57,97,24,0,121,121,0,121,0,0,6,42,29,15,21,5,3,0,15,71,35,121
20210213,13FEB2021:00:00:00,UFU ELIZALDE,35,35,15,55,0,70,48,22,70,0,32,23,7,2,4,0,2,0,0,1,28,19,48
20210213,13FEB2021:00:00:00,UFU FERNANDEZ,95,73,133,31,4,168,74,94,168,0,0,2,43,58,25,21,12,7,0,9,35,30,74
20210213,13FEB2021:00:00:00,UFU FERRER,28,32,32,28,0,60,54,6,54,6,0,0,15,11,19,12,3,0,0,6,28,20,54
20210213,13FEB2021:00:00:00,UFU GRIERSON,73,61,71,59,4,134,134,0,134,0,0,7,45,20,31,16,15,0,0,18,60,56,134
20210213,13FEB2021:00:00:00,UFU GUTIERREZ,9,25,20,14,0,34,30,4,34,0,11,8,2,6,1,4,0,2,0,1,17,12,30
20210213,13FEB2021:00:00:00,UFU MUÑIZ,143,153,125,167,4,296,192,104,206,90,4,3,47,80,63,53,26,20,0,13,128,51,192
20210213,13FEB2021:00:00:00,UFU PENNA,13,14,21,6,0,27,25,2,27,0,0,2,11,6,2,2,2,2,0,3,13,9,25
20210213,13FEB2021:00:00:00,UFU PIROVANO,70,77,117,24,6,147,125,22,147,0,0,2,26,44,17,28,24,6,0,14,55,56,125
20210213,13FEB2021:00:00:00,UFU PIÑERO,55,43,55,40,3,98,92,6,92,6,2,2,29,7,17,29,8,4,0,6,55,30,92
20210213,13FEB2021:00:00:00,UFU RAMOS MEJIA,40,35,33,9,33,75,75,0,75,0,4,2,17,16,19,15,2,0,0,6,38,31,75
20210213,13FEB2021:00:00:00,UFU RIVADAVIA,90,97,134,45,8,187,153,34,153,34,0,1,53,51,26,25,23,8,0,15,80,57,153
20210213,13FEB2021:00:00:00,UFU SANTOJANNI,89,73,88,64,10,162,140,22,152,10,0,1,34,39,37,19,22,10,0,18,56,66,140
20210213,13FEB2021:00:00:00,UFU TORNU,56,49,49,46,10,105,101,4,105,0,4,4,27,26,27,12,5,0,0,14,34,53,101
20210213,13FEB2021:00:00:00,UFU VELEZ SARSFIELD,59,25,65,19,0,84,82,2,84,0,0,2,21,20,16,7,8,10,0,14,40,28,82
20210213,13FEB2021:00:00:00,UFU ZUBIZARRETA,112,89,135,59,7,201,169,32,195,6,0,9,45,38,52,23,28,6,0,35,66,68,169
20210214,14FEB2021:00:00:00,UFU ALVAREZ,53,60,78,31,4,113,101,12,101,12,2,4,26,22,19,21,13,6,0,20,37,44,101
20210214,14FEB2021:00:00:00,UFU BORDA-MOYANO,11,5,8,8,0,16,12,4,12,4,0,0,6,2,5,2,1,0,0,1,7,4,12
20210214,14FEB2021:00:00:00,UFU ELIZALDE,33,32,12,51,2,65,41,24,63,2,39,10,9,4,2,0,1,0,0,2,23,16,41
20210214,14FEB2021:00:00:00,UFU FERNANDEZ,51,48,82,17,0,99,59,40,97,2,0,0,25,32,13,11,16,2,0,6,25,28,59
20210214,14FEB2021:00:00:00,UFU FERRER,22,14,25,9,2,36,32,4,32,4,0,0,11,13,6,6,0,0,0,3,16,13,32
20210214,14FEB2021:00:00:00,UFU GRIERSON,85,84,102,63,4,169,145,24,163,6,0,5,35,35,29,32,25,8,0,20,65,52,145
20210214,14FEB2021:00:00:00,UFU GUTIERREZ,19,17,18,16,2,36,28,8,34,2,17,8,5,4,2,0,0,0,0,2,14,11,28
20210214,14FEB2021:00:00:00,UFU MUÑIZ,103,76,91,84,4,179,141,38,149,30,0,5,48,49,40,20,13,4,0,10,90,41,141
20210214,14FEB2021:00:00:00,UFU PENNA,8,5,11,2,0,13,13,0,13,0,0,0,3,7,2,0,1,0,0,2,6,5,13
20210214,14FEB2021:00:00:00,UFU PIROVANO,62,49,98,11,2,111,101,10,107,4,0,2,26,20,28,15,11,9,0,12,48,41,101
20210214,14FEB2021:00:00:00,UFU PIÑERO,56,43,72,24,3,99,93,6,99,0,2,3,13,31,32,11,4,3,0,8,59,26,93
20210214,14FEB2021:00:00:00,UFU RAMOS MEJIA,22,22,35,3,6,44,36,8,38,6,0,0,15,14,9,0,2,4,0,6,18,12,36
20210214,14FEB2021:00:00:00,UFU RIVADAVIA,106,68,125,40,9,174,166,8,166,8,0,1,53,51,30,16,18,5,0,14,81,69,166
20210214,14FEB2021:00:00:00,UFU SANTOJANNI,43,40,49,34,0,83,73,10,81,2,0,6,9,23,18,13,12,2,0,11,31,31,73
20210214,14FEB2021:00:00:00,UFU TORNU,26,25,33,8,10,51,49,2,51,0,0,1,18,11,6,8,5,2,0,7,20,22,49
20210214,14FEB2021:00:00:00,UFU VELEZ SARSFIELD,50,42,74,16,2,92,90,2,92,0,0,0,19,24,20,9,8,12,0,17,35,38,90
20210214,14FEB2021:00:00:00,UFU ZUBIZARRETA,100,81,126,47,8,181,141,40,169,12,0,11,39,42,28,31,19,11,0,13,74,54,141
20210215,15FEB2021:00:00:00,UFU ALVAREZ,110,78,142,37,9,188,120,68,120,68,11,8,52,38,28,38,9,4,0,19,51,50,120
20210215,15FEB2021:00:00:00,UFU ARGERICH,13,25,16,22,0,38,36,2,38,0,0,0,5,13,6,5,6,3,0,3,19,14,36
20210215,15FEB2021:00:00:00,UFU BORDA-MOYANO,5,18,15,8,0,23,19,4,19,4,0,0,2,6,6,6,2,1,0,0,11,8,19
20210215,15FEB2021:00:00:00,UFU DURAND,95,71,150,16,0,166,166,0,166,0,3,5,30,43,42,12,11,20,0,27,88,51,166
20210215,15FEB2021:00:00:00,UFU ELIZALDE,46,25,21,50,0,71,51,20,65,6,31,10,2,10,6,4,3,5,0,0,32,19,51
20210215,15FEB2021:00:00:00,UFU FERNANDEZ,109,111,193,27,0,220,72,148,210,10,0,9,55,55,39,26,22,14,0,6,19,47,72
20210215,15FEB2021:00:00:00,UFU FERRER,46,26,30,40,2,72,70,2,70,2,0,2,10,33,13,12,2,0,0,14,27,29,70
20210121,21JAN2021:00:00:00,UFU PIROVANO,96,97,147,39,7,193,175,18,185,8,0,7,41,59,44,22,13,7,0,18,87,70,175
20210121,21JAN2021:00:00:00,UFU PIÑERO,76,75,125,12,14,151,147,4,147,4,1,4,34,36,28,21,20,7,0,18,116,13,147
20210121,21JAN2021:00:00:00,UFU RAMOS MEJIA,80,74,109,36,9,154,142,12,146,8,3,8,44,38,19,28,7,7,0,19,63,60,142
20210121,21JAN2021:00:00:00,UFU RIVADAVIA,183,138,200,71,50,321,305,16,305,16,0,7,97,89,65,36,14,13,0,36,134,133,305
20210121,21JAN2021:00:00:00,UFU SANTOJANNI,86,73,101,58,0,159,149,10,157,2,0,4,61,42,22,19,10,1,0,7,32,110,149
20210121,21JAN2021:00:00:00,UFU TORNU,57,46,84,17,2,103,95,8,99,4,3,9,24,36,13,8,8,2,0,14,42,39,95
20210121,21JAN2021:00:00:00,UFU VELEZ SARSFIELD,99,65,108,56,0,164,136,28,164,0,0,2,31,36,27,47,16,5,0,25,63,48,136
20210121,21JAN2021:00:00:00,UFU ZUBIZARRETA,66,65,70,44,17,131,129,2,131,0,0,12,46,25,18,19,6,5,0,16,63,50,129
20210122,22JAN2021:00:00:00,UFU ALVAREZ,118,119,171,57,9,237,205,32,207,30,8,9,81,40,38,23,24,14,0,22,101,82,205
20210122,22JAN2021:00:00:00,UFU ARGERICH,29,43,44,28,0,72,58,14,58,14,2,2,24,16,13,7,6,2,0,6,24,27,58
20210122,22JAN2021:00:00:00,UFU BORDA-MOYANO,72,47,67,50,2,119,67,52,67,52,4,8,19,39,13,15,17,4,0,3,37,26,67
20210122,22JAN2021:00:00:00,UFU DURAND,103,74,156,17,4,177,165,12,165,12,3,2,42,64,20,24,13,9,0,38,68,59,165
20210122,22JAN2021:00:00:00,UFU ELIZALDE,49,35,44,32,8,84,70,14,80,4,19,23,10,14,10,8,0,0,0,0,45,25,70
20210122,22JAN2021:00:00:00,UFU FERNANDEZ,126,111,199,36,2,237,139,98,233,4,0,1,53,92,33,34,14,10,0,29,58,52,139
20210122,22JAN2021:00:00:00,UFU FERRER,37,40,53,24,0,77,75,2,75,2,0,0,18,25,13,11,8,2,0,13,33,29,75
20210122,22JAN2021:00:00:00,UFU GRIERSON,87,67,77,59,18,154,150,4,152,2,0,6,45,36,39,15,12,1,0,25,86,39,150
20210122,22JAN2021:00:00:00,UFU GUTIERREZ,48,34,49,33,0,82,80,2,80,2,23,6,21,9,13,3,7,0,0,7,38,35,80
20210122,22JAN2021:00:00:00,UFU MUÑIZ,151,235,184,183,19,386,224,162,256,130,0,4,91,109,86,46,36,14,0,23,176,25,224
20210122,22JAN2021:00:00:00,UFU PENNA,29,43,55,14,3,72,58,14,62,10,0,2,10,16,24,15,5,0,0,5,34,19,58
20210122,22JAN2021:00:00:00,UFU PIROVANO,108,73,144,28,9,181,169,12,175,6,0,4,58,43,28,27,16,5,0,18,78,73,169
20210122,22JAN2021:00:00:00,UFU PIÑERO,83,59,70,34,38,142,127,15,139,3,0,8,38,28,12,39,7,10,0,12,111,4,127
20210122,22JAN2021:00:00:00,UFU RAMOS MEJIA,70,65,88,38,9,135,113,22,121,14,5,7,34,23,31,12,7,16,0,13,53,47,113
20210122,22JAN2021:00:00:00,UFU RIVADAVIA,176,91,145,64,58,267,253,14,263,4,0,4,88,66,39,47,16,7,0,28,114,108,253
20210122,22JAN2021:00:00:00,UFU SANTOJANNI,102,63,86,72,7,165,145,20,163,2,8,3,58,27,30,13,18,8,0,14,62,69,145
20210122,22JAN2021:00:00:00,UFU TORNU,42,54,73,23,0,96,92,4,92,4,2,3,33,28,11,3,11,5,0,11,40,40,92
20210122,22JAN2021:00:00:00,UFU VELEZ SARSFIELD,84,73,118,36,3,157,125,32,151,6,0,5,30,34,25,30,26,7,0,26,59,40,125
20210122,22JAN2021:00:00:00,UFU ZUBIZARRETA,89,80,98,69,2,169,167,2,169,0,0,5,68,40,20,19,8,9,0,20,90,57,167
20210123,23JAN2021:00:00:00,UFU ALVAREZ,80,61,107,29,5,141,127,14,129,12,1,2,38,49,22,12,6,11,0,24,30,73,127
20210123,23JAN2021:00:00:00,UFU ARGERICH,1,0,0,1,0,1,1,0,1,0,0,1,0,0,0,0,0,0,0,0,1,0,1
20210123,23JAN2021:00:00:00,UFU BORDA-MOYANO,3,11,7,5,2,14,12,2,12,2,0,0,6,6,1,0,1,0,0,1,6,5,12
20210123,23JAN2021:00:00:00,UFU DURAND,78,52,120,10,0,130,128,2,128,2,0,0,51,44,18,7,4,6,0,26,53,49,128
20210123,23JAN2021:00:00:00,UFU ELIZALDE,30,24,10,44,0,54,42,12,52,2,16,22,1,11,2,2,0,0,0,0,29,13,42
20210123,23JAN2021:00:00:00,UFU FERNANDEZ,73,67,124,14,2,140,76,64,130,10,0,11,47,33,6,26,13,4,0,18,27,31,76
20210123,23JAN2021:00:00:00,UFU FERRER,27,17,26,18,0,44,42,2,42,2,0,1,11,13,6,7,3,3,0,7,18,17,42
20210123,23JAN2021:00:00:00,UFU GRIERSON,42,55,52,43,2,97,93,4,95,2,0,1,33,25,12,19,5,2,0,15,51,27,93
20210123,23JAN2021:00:00:00,UFU GUTIERREZ,24,27,27,24,0,51,45,6,51,0,29,10,9,0,2,0,1,0,0,0,29,16,45
20210123,23JAN2021:00:00:00,UFU MUÑIZ,142,158,151,132,17,300,192,108,208,92,2,7,81,74,70,36,23,7,0,30,147,14,192
20210123,23JAN2021:00:00:00,UFU PENNA,22,19,28,13,1,42,39,3,39,3,1,2,9,6,11,6,7,0,0,9,15,15,39
20210123,23JAN2021:00:00:00,UFU PIROVANO,57,81,117,21,0,138,116,22,138,0,0,0,33,42,34,13,10,6,0,14,51,51,116
20210123,23JAN2021:00:00:00,UFU PIÑERO,67,33,65,31,4,100,96,4,98,2,1,1,28,20,32,12,2,4,0,12,71,12,96
20210123,23JAN2021:00:00:00,UFU RAMOS MEJIA,47,41,44,20,24,88,84,4,86,2,7,1,24,19,15,11,9,2,0,14,46,24,84
20210123,23JAN2021:00:00:00,UFU RIVADAVIA,124,93,199,16,2,217,195,22,199,18,0,3,89,54,27,27,12,5,0,23,89,81,195
20210123,23JAN2021:00:00:00,UFU SANTOJANNI,60,73,64,64,5,133,121,12,129,4,10,0,43,26,24,24,2,4,0,11,65,45,121
20210123,23JAN2021:00:00:00,UFU TORNU,45,40,38,15,32,85,81,4,81,4,0,3,19,17,20,15,5,6,0,13,33,35,81
20210123,23JAN2021:00:00:00,UFU VELEZ SARSFIELD,71,74,108,37,0,145,139,6,139,6,0,4,38,33,17,35,12,6,0,22,64,53,139
20210123,23JAN2021:00:00:00,UFU ZUBIZARRETA,123,82,126,74,5,205,167,38,181,24,0,7,72,43,34,30,11,8,0,28,82,57,167
20210124,24JAN2021:00:00:00,UFU ALVAREZ,59,38,69,21,7,97,85,12,85,12,4,6,17,17,12,20,14,7,0,16,35,34,85
20210124,24JAN2021:00:00:00,UFU ARGERICH,6,14,16,4,0,20,18,2,20,0,0,0,3,2,0,5,6,4,0,4,6,8,18
20210124,24JAN2021:00:00:00,UFU BORDA-MOYANO,2,20,11,11,0,22,8,14,8,14,0,0,8,4,2,6,0,2,0,0,5,3,8
20210124,24JAN2021:00:00:00,UFU ELIZALDE,48,18,18,47,1,66,40,26,62,4,33,18,4,3,8,0,0,0,0,2,28,10,40
20210124,24JAN2021:00:00:00,UFU FERNANDEZ,175,144,272,45,2,319,73,246,319,0,0,14,70,83,51,48,30,23,0,11,33,29,73
20210124,24JAN2021:00:00:00,UFU FERRER,15,12,17,9,1,27,27,0,27,0,0,2,5,2,6,10,2,0,0,3,13,11,27
20210124,24JAN2021:00:00:00,UFU GRIERSON,55,46,39,55,7,101,79,22,99,2,0,5,34,27,18,10,5,2,0,20,54,5,79
20210124,24JAN2021:00:00:00,UFU GUTIERREZ,30,21,24,27,0,51,49,2,51,0,17,23,0,4,3,2,2,0,0,3,25,21,49
20210124,24JAN2021:00:00:00,UFU MUÑIZ,81,96,78,92,7,177,107,70,125,52,1,4,36,59,36,18,15,8,0,14,80,12,107
20210124,24JAN2021:00:00:00,UFU PENNA,24,23,26,21,0,47,43,4,45,2,0,0,10,12,11,8,4,2,0,5,19,18,43
20210124,24JAN2021:00:00:00,UFU PIROVANO,67,64,103,24,4,131,111,20,131,0,0,0,22,38,26,19,18,8,0,14,47,49,111
20210124,24JAN2021:00:00:00,UFU PIÑERO,21,18,29,7,3,39,37,2,39,0,0,0,15,0,10,6,6,2,0,3,31,3,37
20210124,24JAN2021:00:00:00,UFU RAMOS MEJIA,43,33,60,14,2,76,70,6,70,6,1,0,22,25,8,11,4,5,0,12,29,29,70
20210124,24JAN2021:00:00:00,UFU RIVADAVIA,63,68,122,7,2,131,119,12,119,12,0,2,59,35,9,15,9,2,0,17,54,45,119
20210124,24JAN2021:00:00:00,UFU SANTOJANNI,60,43,41,62,0,103,101,2,103,0,2,3,36,22,16,17,6,1,0,10,36,55,101
20210124,24JAN2021:00:00:00,UFU TORNU,33,28,28,8,25,61,59,2,59,2,1,1,10,9,19,8,6,7,0,12,24,23,59
20210124,24JAN2021:00:00:00,UFU VELEZ SARSFIELD,64,47,69,42,0,111,111,0,111,0,0,3,34,26,15,15,14,4,0,22,54,35,111
20210124,24JAN2021:00:00:00,UFU ZUBIZARRETA,80,80,114,42,4,160,115,45,129,31,0,9,40,28,38,18,13,14,0,20,49,45,115
20210125,25JAN2021:00:00:00,UFU ALVAREZ,114,108,161,52,9,222,134,88,136,86,11,10,62,57,30,25,10,17,0,21,50,63,134
20210125,25JAN2021:00:00:00,UFU ARGERICH,42,39,47,27,7,81,65,16,65,16,6,0,33,20,9,6,5,2,0,11,21,33,65
20210125,25JAN2021:00:00:00,UFU BORDA-MOYANO,35,32,39,28,0,67,63,4,63,4,0,4,19,5,14,14,6,5,0,2,37,24,63
20210125,25JAN2021:00:00:00,UFU DURAND,82,101,155,28,0,183,175,8,181,2,2,10,50,49,33,22,14,3,0,39,80,56,175
20210125,25JAN2021:00:00:00,UFU ELIZALDE,91,67,36,116,6,158,106,52,152,6,70,44,10,17,11,3,3,0,0,1,69,36,106
20210125,25JAN2021:00:00:00,UFU FERNANDEZ,94,85,152,27,0,179,127,52,173,6,2,3,35,56,36,21,17,9,0,30,48,49,127
20210125,25JAN2021:00:00:00,UFU FERRER,34,41,36,39,0,75,69,6,73,2,0,4,17,20,19,7,8,0,0,12,34,23,69
20210125,25JAN2021:00:00:00,UFU GRIERSON,88,64,70,73,9,152,132,20,134,18,0,15,47,34,22,19,12,3,0,30,98,4,132
20210125,25JAN2021:00:00:00,UFU GUTIERREZ,85,60,75,66,4,145,129,16,143,2,55,27,17,22,9,11,0,4,0,4,67,56,129
20210125,25JAN2021:00:00:00,UFU MUÑIZ,187,203,198,161,31,390,278,112,312,78,0,7,98,115,69,53,28,20,0,45,198,34,278
20210125,25JAN2021:00:00:00,UFU PENNA,28,46,54,15,5,74,60,14,68,6,0,0,17,24,15,8,9,1,0,4,34,22,60
20210125,25JAN2021:00:00:00,UFU PIROVANO,104,90,161,31,2,194,168,26,190,4,0,7,49,51,33,23,14,17,0,27,75,66,168
20210125,25JAN2021:00:00:00,UFU PIÑERO,90,75,89,42,34,165,149,16,163,2,2,2,41,40,41,24,11,4,0,15,122,12,149
20210125,25JAN2021:00:00:00,UFU RAMOS MEJIA,43,52,60,27,8,95,91,4,93,2,4,7,44,12,9,9,7,3,0,10,45,36,91
20210125,25JAN2021:00:00:00,UFU RIVADAVIA,155,141,208,71,17,296,170,126,174,122,0,13,83,65,44,58,25,8,0,27,71,70,170
20210125,25JAN2021:00:00:00,UFU SANTOJANNI,83,57,70,67,3,140,126,14,136,4,4,4,25,28,38,20,12,9,0,16,66,44,126
20210125,25JAN2021:00:00:00,UFU TORNU,40,48,67,17,4,88,82,6,82,6,3,2,16,9,20,14,16,8,0,16,36,30,82
20210125,25JAN2021:00:00:00,UFU VELEZ SARSFIELD,92,55,112,35,0,147,145,2,147,0,0,6,37,39,31,21,8,5,0,18,75,52,145
20210125,25JAN2021:00:00:00,UFU ZUBIZARRETA,116,99,126,83,6,215,209,6,213,2,0,6,74,45,30,31,17,12,0,26,105,78,209
20210126,26JAN2021:00:00:00,UFU ALVAREZ,101,71,129,40,3,172,152,20,154,18,4,6,54,55,22,13,15,3,0,16,72,64,152
20210126,26JAN2021:00:00:00,UFU ARGERICH,48,46,41,50,3,94,59,35,59,35,8,2,26,15,14,8,14,7,0,9,28,22,59
20210126,26JAN2021:00:00:00,UFU BORDA-MOYANO,51,42,59,31,3,93,91,2,91,2,0,4,20,23,22,8,10,6,0,3,56,32,91
20210126,26JAN2021:00:00:00,UFU DURAND,120,53,140,30,3,173,131,42,169,4,6,4,38,55,25,21,15,9,0,24,88,18,131
20210126,26JAN2021:00:00:00,UFU ELIZALDE,58,68,57,63,6,126,104,22,124,2,55,42,7,13,7,2,0,0,0,2,67,35,104
20210126,26JAN2021:00:00:00,UFU FERNANDEZ,109,96,164,37,4,205,133,72,199,6,0,4,49,56,41,25,22,8,0,24,55,54,133
20210126,26JAN2021:00:00:00,UFU FERRER,34,36,46,24,0,70,66,4,66,4,0,0,25,25,13,3,3,1,0,19,23,24,66
20210126,26JAN2021:00:00:00,UFU GRIERSON,46,48,40,53,1,94,92,2,92,2,0,2,26,17,19,20,4,6,0,13,55,24,92
20210126,26JAN2021:00:00:00,UFU GUTIERREZ,74,36,55,55,0,110,92,18,110,0,48,24,11,5,6,12,2,2,0,9,44,38,92
20210126,26JAN2021:00:00:00,UFU MUÑIZ,141,193,172,151,11,334,186,148,238,96,2,10,83,111,65,41,14,8,0,25,146,15,186
20210126,26JAN2021:00:00:00,UFU PENNA,33,34,41,24,2,67,54,13,62,5,0,0,15,18,7,10,8,9,0,11,25,17,54
20210126,26JAN2021:00:00:00,UFU PIROVANO,125,88,178,28,7,213,199,14,209,4,0,4,75,48,29,27,16,14,0,28,89,82,199
20210126,26JAN2021:00:00:00,UFU PIÑERO,78,65,78,49,16,143,105,38,139,4,2,10,37,22,22,32,10,8,0,11,88,6,105
20210126,26JAN2021:00:00:00,UFU RAMOS MEJIA,89,79,136,21,11,168,142,26,152,16,2,19,54,31,30,18,9,5,0,26,55,61,142
20210126,26JAN2021:00:00:00,UFU RIVADAVIA,138,103,168,61,12,241,215,26,221,20,0,7,73,75,29,25,24,8,0,20,95,92,215
20210126,26JAN2021:00:00:00,UFU SANTOJANNI,81,82,91,70,2,163,147,16,163,0,6,8,52,29,38,21,7,2,0,28,64,55,147
20210126,26JAN2021:00:00:00,UFU TORNU,55,41,59,33,4,96,84,12,90,6,4,6,29,15,23,11,6,2,0,15,32,37,84
20210126,26JAN2021:00:00:00,UFU VELEZ SARSFIELD,73,62,85,50,0,135,133,2,133,2,0,3,35,50,21,17,6,3,0,16,67,50,133
20210126,26JAN2021:00:00:00,UFU ZUBIZARRETA,70,88,98,51,9,158,158,0,158,0,0,5,41,52,25,15,14,6,0,14,86,58,158
20210127,27JAN2021:00:00:00,UFU ALVAREZ,91,95,144,28,14,186,144,42,144,42,10,14,55,37,37,18,8,7,0,16,54,74,144
20210127,27JAN2021:00:00:00,UFU ARGERICH,45,41,43,38,5,86,62,24,64,22,2,1,23,22,12,11,4,11,0,7,32,23,62
20210127,27JAN2021:00:00:00,UFU BORDA-MOYANO,34,49,50,33,0,83,83,0,83,0,3,7,14,12,18,16,9,4,0,1,54,28,83
20210127,27JAN2021:00:00:00,UFU DURAND,76,63,128,11,0,139,135,4,137,2,3,7,50,48,16,9,2,4,0,17,88,29,135
20210127,27JAN2021:00:00:00,UFU ELIZALDE,55,43,23,72,3,98,76,22,88,10,50,13,12,10,8,2,3,0,0,2,55,19,76
20210127,27JAN2021:00:00:00,UFU FERNANDEZ,181,177,317,41,0,358,128,230,354,4,2,10,100,109,47,56,27,7,0,18,50,60,128
20210127,27JAN2021:00:00:00,UFU FERRER,55,31,45,41,0,86,82,4,82,4,0,0,23,29,19,4,10,1,0,12,42,28,82
20210127,27JAN2021:00:00:00,UFU GRIERSON,58,65,60,59,4,123,119,4,119,4,0,3,33,40,22,16,6,3,0,36,69,14,119
20210127,27JAN2021:00:00:00,UFU GUTIERREZ,53,50,66,34,3,103,91,12,101,2,36,23,8,18,10,6,2,0,0,5,50,36,91
20210127,27JAN2021:00:00:00,UFU MUÑIZ,179,164,163,170,10,343,215,128,247,96,1,14,80,117,63,48,13,7,0,34,164,17,215
20210127,27JAN2021:00:00:00,UFU PENNA,41,22,39,22,2,63,47,16,61,2,0,9,10,6,18,13,6,1,0,2,29,16,47
20210127,27JAN2021:00:00:00,UFU PIROVANO,124,93,154,53,10,217,177,40,209,8,0,7,48,68,44,29,14,7,0,25,82,70,177
20210127,27JAN2021:00:00:00,UFU PIÑERO,51,61,70,40,2,112,106,6,108,4,0,7,36,26,11,18,8,6,0,13,90,1,106
20210127,27JAN2021:00:00:00,UFU RAMOS MEJIA,91,72,111,48,4,163,137,26,147,16,11,10,44,38,33,19,6,2,0,12,54,71,137
20210127,27JAN2021:00:00:00,UFU RIVADAVIA,161,106,192,57,18,267,243,24,257,10,1,6,70,66,40,42,31,11,0,22,125,95,243
20210127,27JAN2021:00:00:00,UFU SANTOJANNI,117,79,105,85,6,196,180,16,190,6,7,15,50,42,36,34,11,1,0,13,89,78,180
20210127,27JAN2021:00:00:00,UFU TORNU,49,33,60,18,4,82,64,18,78,4,0,0,19,17,18,11,8,9,0,10,27,27,64
20210127,27JAN2021:00:00:00,UFU VELEZ SARSFIELD,60,55,78,37,0,115,99,16,115,0,2,0,41,21,24,13,8,6,0,16,48,35,99
20210127,27JAN2021:00:00:00,UFU ZUBIZARRETA,122,64,101,77,8,186,162,24,186,0,2,14,52,38,29,24,22,5,0,33,70,59,162
20210128,28JAN2021:00:00:00,UFU ALVAREZ,81,81,112,46,4,162,150,12,152,10,6,7,39,45,30,14,9,12,0,20,65,64,150
20210128,28JAN2021:00:00:00,UFU ARGERICH,51,22,50,23,0,73,59,14,63,10,7,0,12,27,13,8,6,0,0,6,24,29,59
20210128,28JAN2021:00:00:00,UFU BORDA-MOYANO,53,31,44,40,0,84,84,0,84,0,2,7,14,29,14,6,10,2,0,0,49,34,84
20210128,28JAN2021:00:00:00,UFU DURAND,111,69,142,35,3,180,178,2,178,2,2,12,48,54,39,21,4,0,0,25,115,37,178
20210128,28JAN2021:00:00:00,UFU ELIZALDE,62,45,20,87,0,107,73,34,99,8,51,24,4,14,13,1,0,0,0,0,49,24,73
20210128,28JAN2021:00:00:00,UFU FERNANDEZ,32,28,56,2,2,60,8,52,60,0,0,0,18,16,6,14,2,4,0,0,4,4,8
20210128,28JAN2021:00:00:00,UFU FERRER,47,38,32,53,0,85,77,8,79,6,0,0,26,22,16,11,8,2,0,10,30,37,77
20210128,28JAN2021:00:00:00,UFU GRIERSON,91,93,81,100,3,184,180,4,180,4,0,8,74,47,20,14,17,4,0,20,80,80,180
20210128,28JAN2021:00:00:00,UFU GUTIERREZ,77,49,78,46,2,126,118,8,126,0,30,39,15,23,10,9,0,0,0,7,58,53,118
20210128,28JAN2021:00:00:00,UFU MUÑIZ,204,235,204,222,13,439,277,162,303,136,0,4,135,142,74,46,32,6,0,33,209,35,277
20210128,28JAN2021:00:00:00,UFU PENNA,13,26,24,11,4,39,37,2,39,0,0,0,12,9,6,7,1,4,0,0,24,13,37
20210128,28JAN2021:00:00:00,UFU PIROVANO,114,107,163,51,7,221,209,12,215,6,2,7,62,45,38,42,18,7,0,27,98,82,209
20210128,28JAN2021:00:00:00,UFU PIÑERO,69,60,75,48,6,129,125,4,125,4,0,2,40,40,23,8,14,2,0,14,97,14,125
20210128,28JAN2021:00:00:00,UFU RAMOS MEJIA,80,74,96,50,8,154,134,20,140,14,4,11,36,47,23,14,15,4,0,16,67,51,134
20210128,28JAN2021:00:00:00,UFU RIVADAVIA,203,166,251,95,23,369,353,16,357,12,0,9,117,99,55,54,26,9,0,39,165,145,353
20210128,28JAN2021:00:00:00,UFU SANTOJANNI,85,119,148,52,4,204,192,12,198,6,4,6,57,49,42,28,9,9,0,35,73,84,192
20210128,28JAN2021:00:00:00,UFU TORNU,54,67,84,37,0,121,97,24,113,8,2,6,21,20,26,27,9,10,0,13,38,46,97
20210128,28JAN2021:00:00:00,UFU VELEZ SARSFIELD,110,90,156,44,0,200,160,40,200,0,0,5,52,45,23,41,24,10,0,19,44,97,160
20210128,28JAN2021:00:00:00,UFU ZUBIZARRETA,99,68,90,71,6,167,161,6,167,0,0,5,35,39,26,34,19,9,0,39,57,65,161
20210129,29JAN2021:00:00:00,UFU ALVAREZ,112,108,169,43,8,220,180,40,180,40,8,6,49,66,35,25,27,4,0,17,57,105,180
20210129,29JAN2021:00:00:00,UFU ARGERICH,39,31,43,27,0,70,46,24,48,22,2,1,17,9,16,6,9,10,0,6,21,19,46
20210129,29JAN2021:00:00:00,UFU BORDA-MOYANO,45,54,54,43,2,99,95,4,95,4,3,7,28,14,19,12,11,5,0,2,56,37,95
20210129,29JAN2021:00:00:00,UFU DURAND,132,79,195,9,7,211,207,4,207,4,0,6,63,54,46,14,19,9,0,38,101,68,207
20210129,29JAN2021:00:00:00,UFU ELIZALDE,75,46,24,97,0,121,91,30,107,14,44,23,11,13,14,4,12,0,0,0,53,38,91
20210129,29JAN2021:00:00:00,UFU FERNANDEZ,131,117,210,33,5,248,104,144,242,6,0,5,62,67,38,45,15,16,0,15,49,40,104
20210129,29JAN2021:00:00:00,UFU FERRER,27,35,37,23,2,62,52,10,52,10,0,2,24,17,5,2,9,3,0,10,22,20,52
20210129,29JAN2021:00:00:00,UFU GRIERSON,133,98,100,129,2,231,213,18,217,14,2,24,56,59,50,34,4,2,0,36,79,98,213
20210129,29JAN2021:00:00:00,UFU GUTIERREZ,79,48,92,35,0,127,119,8,125,2,24,23,20,25,15,9,9,2,0,1,72,46,119
20210129,29JAN2021:00:00:00,UFU MUÑIZ,214,255,191,260,18,469,331,138,365,104,0,14,133,120,94,57,34,17,0,25,198,108,331
20210129,29JAN2021:00:00:00,UFU PENNA,25,19,32,9,3,44,40,4,42,2,0,0,10,5,14,8,5,2,0,5,18,17,40
20210129,29JAN2021:00:00:00,UFU PIROVANO,149,83,193,38,1,232,218,14,228,4,0,4,48,72,51,32,18,7,0,20,104,94,218
20210129,29JAN2021:00:00:00,UFU PIÑERO,92,91,116,60,7,183,179,4,179,4,0,6,62,49,28,21,12,5,0,16,118,45,179
20210129,29JAN2021:00:00:00,UFU RAMOS MEJIA,72,61,90,22,23,135,119,16,125,10,12,6,34,25,22,22,12,2,0,17,39,63,119
20210129,29JAN2021:00:00:00,UFU RIVADAVIA,145,119,185,54,25,264,250,14,258,6,0,11,58,62,51,51,17,14,0,27,114,108,250
20210129,29JAN2021:00:00:00,UFU SANTOJANNI,98,76,84,84,6,174,164,10,174,0,2,5,61,33,38,21,6,8,0,15,79,70,164
20210129,29JAN2021:00:00:00,UFU TORNU,47,27,60,14,0,74,68,6,68,6,4,4,17,17,12,13,6,1,0,13,26,29,68
20210129,29JAN2021:00:00:00,UFU VELEZ SARSFIELD,48,53,77,22,2,101,93,8,99,2,0,2,36,24,18,12,6,3,0,10,52,31,93
20210129,29JAN2021:00:00:00,UFU ZUBIZARRETA,110,97,141,58,8,207,201,6,205,2,0,13,59,57,25,33,16,4,0,26,84,91,201
20210130,30JAN2021:00:00:00,UFU ALVAREZ,53,32,74,9,2,85,75,10,75,10,6,4,20,19,9,9,16,2,0,18,29,28,75
20210130,30JAN2021:00:00:00,UFU ARGERICH,2,0,2,0,0,2,2,0,2,0,2,0,0,0,0,0,0,0,0,0,1,1,2
20210130,30JAN2021:00:00:00,UFU BORDA-MOYANO,9,19,15,11,2,28,28,0,28,0,0,5,0,12,7,4,0,0,0,0,17,11,28
20210130,30JAN2021:00:00:00,UFU DURAND,76,75,139,12,0,151,147,4,147,4,6,4,42,36,23,15,15,10,0,16,83,48,147
20210130,30JAN2021:00:00:00,UFU ELIZALDE,29,38,21,46,0,67,45,22,57,10,31,19,1,10,4,0,2,0,0,1,27,17,45
20210130,30JAN2021:00:00:00,UFU FERNANDEZ,120,106,189,28,9,226,94,132,220,6,0,3,62,65,39,34,9,14,0,16,38,40,94
20210130,30JAN2021:00:00:00,UFU FERRER,31,16,27,20,0,47,45,2,45,2,0,1,7,11,14,12,0,2,0,7,20,18,45
20210130,30JAN2021:00:00:00,UFU GRIERSON,81,70,61,88,2,151,139,12,149,2,0,1,54,42,24,19,5,6,0,16,54,69,139
20210130,30JAN2021:00:00:00,UFU GUTIERREZ,41,22,24,37,2,63,59,4,61,2,25,14,5,12,4,1,2,0,0,2,30,27,59
20210130,30JAN2021:00:00:00,UFU MUÑIZ,137,140,119,140,18,277,211,66,215,62,0,5,67,88,49,36,29,3,0,24,129,58,211
20210130,30JAN2021:00:00:00,UFU PENNA,28,12,23,16,1,40,28,12,32,8,0,0,15,11,2,6,5,1,0,11,9,8,28
20210130,30JAN2021:00:00:00,UFU PIROVANO,69,45,102,12,0,114,106,8,114,0,0,1,30,34,17,11,10,11,0,20,41,45,106
20210130,30JAN2021:00:00:00,UFU PIÑERO,48,62,54,53,3,110,104,6,104,6,2,5,37,26,14,11,5,10,0,7,64,33,104
20210130,30JAN2021:00:00:00,UFU RAMOS MEJIA,69,53,77,21,24,122,106,16,108,14,6,7,29,34,22,9,7,8,0,16,47,43,106
20210130,30JAN2021:00:00:00,UFU RIVADAVIA,140,90,183,30,17,230,192,38,194,36,0,11,64,76,24,33,17,5,0,20,87,84,192
20210130,30JAN2021:00:00:00,UFU SANTOJANNI,79,85,95,65,4,164,152,12,158,6,12,4,60,41,27,9,5,6,0,22,67,63,152
20210130,30JAN2021:00:00:00,UFU TORNU,18,33,21,22,8,51,45,6,51,0,2,2,12,22,6,2,5,0,0,6,21,18,45
20210130,30JAN2021:00:00:00,UFU VELEZ SARSFIELD,62,82,115,27,2,144,128,16,136,8,0,3,45,42,16,17,15,6,0,19,13,96,128
20210130,30JAN2021:00:00:00,UFU ZUBIZARRETA,121,113,159,68,7,234,214,20,224,10,0,20,61,44,52,26,19,12,0,37,92,85,214
20210131,31JAN2021:00:00:00,UFU ALVAREZ,58,35,76,15,2,93,89,4,89,4,6,6,25,20,18,6,4,8,0,15,37,37,89
20210131,31JAN2021:00:00:00,UFU ARGERICH,17,19,30,6,0,36,34,2,36,0,0,2,3,8,6,4,11,2,0,3,19,12,34
20210131,31JAN2021:00:00:00,UFU BORDA-MOYANO,6,6,5,7,0,12,12,0,12,0,0,2,3,3,2,0,2,0,0,0,8,4,12
20210131,31JAN2021:00:00:00,UFU ELIZALDE,50,43,15,78,0,93,77,16,91,2,37,26,10,13,3,4,0,0,0,2,43,32,77
20210131,31JAN2021:00:00:00,UFU FERNANDEZ,95,89,156,22,6,184,66,118,180,4,0,6,61,42,30,23,13,9,0,11,28,27,66
20210131,31JAN2021:00:00:00,UFU FERRER,47,22,40,29,0,69,61,8,61,8,0,0,14,20,19,5,11,0,0,13,24,24,61
20210131,31JAN2021:00:00:00,UFU GRIERSON,84,66,88,60,2,150,134,16,148,2,2,6,48,28,29,26,11,0,0,1,6,127,134
20210131,31JAN2021:00:00:00,UFU GUTIERREZ,22,34,27,29,0,56,54,2,56,0,21,9,8,9,7,0,0,2,0,4,31,19,54
20210131,31JAN2021:00:00:00,UFU MUÑIZ,134,120,97,138,19,254,208,46,218,36,0,6,62,77,43,45,13,8,0,21,123,64,208
20210131,31JAN2021:00:00:00,UFU PENNA,20,17,25,12,0,37,34,3,36,1,0,3,10,0,5,9,8,2,0,3,15,16,34
20210131,31JAN2021:00:00:00,UFU PIROVANO,55,59,93,19,2,114,84,30,114,0,0,0,35,34,22,15,4,4,0,18,31,35,84
20210131,31JAN2021:00:00:00,UFU PIÑERO,42,56,62,29,7,98,94,4,96,2,0,2,30,20,16,17,10,3,0,5,62,27,94
20210131,31JAN2021:00:00:00,UFU RAMOS MEJIA,33,41,47,20,7,74,60,14,64,10,0,3,15,13,21,9,7,6,0,11,24,25,60
20210131,31JAN2021:00:00:00,UFU RIVADAVIA,108,79,138,43,6,187,175,12,175,12,0,3,59,55,22,29,15,4,0,32,66,75,175
20210131,31JAN2021:00:00:00,UFU SANTOJANNI,64,40,63,40,1,104,98,6,104,0,6,4,15,40,15,9,12,3,0,17,40,41,98
20210131,31JAN2021:00:00:00,UFU TORNU,26,13,22,12,5,39,37,2,37,2,0,2,7,6,1,13,9,1,0,4,18,15,37
20210131,31JAN2021:00:00:00,UFU VELEZ SARSFIELD,45,58,83,20,0,103,101,2,101,2,0,2,19,21,35,10,6,10,0,11,48,42,101
20210131,31JAN2021:00:00:00,UFU ZUBIZARRETA,99,75,118,44,12,174,138,36,166,8,0,13,56,28,36,16,17,8,0,27,62,49,138
20210201,01FEB2021:00:00:00,UFU ALVAREZ,118,80,163,28,7,198,132,66,134,64,5,2,61,45,32,25,13,15,0,12,68,52,132
20210201,01FEB2021:00:00:00,UFU ARGERICH,33,30,33,30,0,63,47,16,51,12,0,6,15,19,8,10,5,0,0,9,19,19,47
20210201,01FEB2021:00:00:00,UFU BORDA-MOYANO,61,41,59,43,0,102,102,0,102,0,1,8,18,22,25,14,14,0,0,4,57,41,102
20210201,01FEB2021:00:00:00,UFU DURAND,91,89,149,31,0,180,176,4,176,4,2,7,58,41,31,20,13,8,0,36,65,75,176
20210201,01FEB2021:00:00:00,UFU ELIZALDE,94,41,50,85,0,135,109,26,127,8,39,35,19,25,6,8,3,0,0,1,57,51,109
20210201,01FEB2021:00:00:00,UFU FERNANDEZ,108,78,140,32,14,186,162,24,180,6,0,5,35,51,36,39,12,8,0,17,69,76,162
20210201,01FEB2021:00:00:00,UFU FERRER,50,47,53,44,0,97,97,0,97,0,0,0,30,20,19,16,8,4,0,15,44,38,97
20210201,01FEB2021:00:00:00,UFU GRIERSON,119,119,109,127,2,238,214,24,218,20,0,10,85,47,53,18,14,11,0,25,102,87,214
20210201,01FEB2021:00:00:00,UFU GUTIERREZ,102,44,82,62,2,146,116,30,138,8,47,34,19,29,8,3,4,2,0,2,66,48,116
20210201,01FEB2021:00:00:00,UFU MUÑIZ,207,230,199,209,29,437,343,94,359,78,0,11,110,111,75,71,40,19,0,22,230,91,343
20210201,01FEB2021:00:00:00,UFU PENNA,21,29,32,12,7,51,42,9,44,7,1,7,7,19,10,2,4,1,0,2,26,14,42
20210201,01FEB2021:00:00:00,UFU PIROVANO,96,96,162,26,4,192,184,8,186,6,0,8,48,57,39,18,5,17,0,29,82,73,184
20210201,01FEB2021:00:00:00,UFU PIÑERO,55,54,71,15,23,109,101,8,101,8,0,2,30,28,22,17,6,4,0,9,63,28,101
20210201,01FEB2021:00:00:00,UFU RAMOS MEJIA,60,63,65,25,33,123,104,19,116,7,4,5,24,36,21,15,15,3,0,18,40,46,104
20210201,01FEB2021:00:00:00,UFU RIVADAVIA,196,122,237,69,12,318,176,142,182,136,3,15,113,68,48,42,20,9,0,7,96,71,176
20210201,01FEB2021:00:00:00,UFU SANTOJANNI,103,86,89,95,5,189,169,20,185,4,0,11,29,52,43,28,17,9,0,18,79,72,169
20210201,01FEB2021:00:00:00,UFU TORNU,54,44,57,38,3,98,72,26,92,6,6,7,17,24,12,12,13,7,0,11,31,30,72
20210201,01FEB2021:00:00:00,UFU VELEZ SARSFIELD,81,61,97,45,0,142,116,26,140,2,0,6,24,28,38,9,23,14,0,19,51,46,116
20210201,01FEB2021:00:00:00,UFU ZUBIZARRETA,25,37,32,30,0,62,54,8,58,4,0,2,24,18,6,5,5,2,0,9,24,21,54
20210202,02FEB2021:00:00:00,UFU ALVAREZ,121,92,152,52,9,213,185,28,193,20,4,4,62,45,26,37,16,19,0,18,92,75,185
20210202,02FEB2021:00:00:00,UFU ARGERICH,52,31,44,37,2,83,65,18,65,18,6,4,11,12,10,26,10,4,0,4,32,29,65
20210202,02FEB2021:00:00:00,UFU BORDA-MOYANO,27,32,27,29,3,59,57,2,57,2,0,1,17,15,9,13,2,2,0,4,25,25,57
20210202,02FEB2021:00:00:00,UFU DURAND,89,58,133,12,2,147,143,4,143,4,0,8,44,37,22,19,9,8,0,26,62,55,143
20210202,02FEB2021:00:00:00,UFU ELIZALDE,90,76,35,131,0,166,120,46,160,6,65,39,14,19,24,2,2,1,0,5,71,44,120
20210202,02FEB2021:00:00:00,UFU FERNANDEZ,171,138,247,45,17,309,151,158,303,6,0,9,80,80,43,49,29,19,0,20,59,72,151
20210202,02FEB2021:00:00:00,UFU FERRER,56,27,47,36,0,83,77,6,77,6,0,1,20,13,21,19,5,4,0,12,34,31,77
20210202,02FEB2021:00:00:00,UFU GRIERSON,106,76,78,104,0,182,172,10,174,8,0,3,59,42,38,28,9,3,0,22,82,68,172
20210202,02FEB2021:00:00:00,UFU GUTIERREZ,60,48,52,56,0,108,100,8,108,0,52,23,12,15,1,4,1,0,0,2,55,43,100
20210202,02FEB2021:00:00:00,UFU MUÑIZ,183,206,161,211,17,389,309,80,321,68,0,11,102,105,79,59,28,5,0,27,192,90,309
20210202,02FEB2021:00:00:00,UFU PENNA,27,28,41,14,0,55,45,10,47,8,0,1,9,15,11,2,6,11,0,4,26,14,45
20210202,02FEB2021:00:00:00,UFU PIROVANO,113,131,191,42,11,244,206,38,224,20,0,8,46,69,51,37,15,18,0,26,99,81,206
20210202,02FEB2021:00:00:00,UFU PIÑERO,72,61,90,34,9,133,131,2,133,0,0,3,25,34,34,24,10,3,0,3,92,36,131
20210202,02FEB2021:00:00:00,UFU RAMOS MEJIA,102,51,114,29,10,153,133,20,141,12,7,20,35,35,16,16,11,13,0,16,53,64,133
20210202,02FEB2021:00:00:00,UFU RIVADAVIA,192,129,217,76,28,321,291,30,293,28,0,12,81,95,38,56,30,9,0,18,151,119,291
20210202,02FEB2021:00:00:00,UFU SANTOJANNI,105,102,121,81,5,207,171,36,205,2,0,2,55,21,42,48,31,8,0,23,76,72,171
20210202,02FEB2021:00:00:00,UFU TORNU,46,38,62,9,13,84,72,12,74,10,0,2,28,25,18,5,4,2,0,12,28,32,72
20210202,02FEB2021:00:00:00,UFU VELEZ SARSFIELD,80,60,110,26,4,140,132,8,134,6,0,8,36,32,27,22,12,3,0,19,60,53,132
20210202,02FEB2021:00:00:00,UFU ZUBIZARRETA,131,101,164,59,9,232,220,12,230,2,0,7,43,56,46,47,16,17,0,39,96,85,220
20210203,03FEB2021:00:00:00,UFU ALVAREZ,108,97,135,58,12,205,189,16,189,16,5,11,51,39,40,46,6,7,0,18,96,75,189
20210203,03FEB2021:00:00:00,UFU ARGERICH,50,26,51,25,0,76,58,18,60,16,1,6,23,12,12,7,12,3,0,13,24,21,58
20210203,03FEB2021:00:00:00,UFU BORDA-MOYANO,57,62,55,59,5,119,113,6,113,6,10,15,18,21,24,19,8,4,0,4,65,44,113
20210203,03FEB2021:00:00:00,UFU DURAND,101,83,171,11,2,184,176,8,180,4,4,10,38,59,27,14,16,16,0,18,106,52,176
20210203,03FEB2021:00:00:00,UFU ELIZALDE,65,59,27,89,8,124,98,26,116,8,54,25,11,11,8,12,3,0,0,2,57,39,98
20210203,03FEB2021:00:00:00,UFU FERNANDEZ,144,129,218,43,12,273,153,120,271,2,0,21,76,70,48,36,14,8,0,19,64,70,153
20210203,03FEB2021:00:00:00,UFU FERRER,38,39,33,44,0,77,73,4,73,4,0,1,35,16,9,11,5,0,0,12,33,28,73
20210203,03FEB2021:00:00:00,UFU GRIERSON,104,53,75,80,2,157,155,2,155,2,0,3,44,46,31,21,6,6,0,17,80,58,155
20210203,03FEB2021:00:00:00,UFU GUTIERREZ,85,46,70,59,2,131,107,24,131,0,50,33,16,11,8,10,3,0,0,5,55,47,107
20210203,03FEB2021:00:00:00,UFU MUÑIZ,183,253,198,231,7,436,308,128,328,108,0,13,103,110,113,61,26,10,0,25,185,98,308
20210203,03FEB2021:00:00:00,UFU PENNA,36,18,26,26,2,54,49,5,54,0,0,0,7,14,11,6,9,7,0,7,24,18,49
20210203,03FEB2021:00:00:00,UFU PIROVANO,131,82,167,44,2,213,191,22,197,16,0,8,63,62,37,29,11,3,0,19,101,71,191
20210203,03FEB2021:00:00:00,UFU PIÑERO,100,90,135,46,9,190,178,12,180,10,0,12,43,42,28,38,19,8,0,8,109,57,178
20210203,03FEB2021:00:00:00,UFU RAMOS MEJIA,77,75,129,19,4,152,138,14,146,6,4,10,48,20,42,15,11,2,0,16,55,67,138
20210203,03FEB2021:00:00:00,UFU RIVADAVIA,155,114,201,55,13,269,245,24,249,20,0,15,84,69,26,48,25,2,0,20,126,99,245
20210203,03FEB2021:00:00:00,UFU SANTOJANNI,88,85,101,70,2,173,169,4,173,0,3,9,39,39,30,29,18,6,0,14,46,109,169
20210203,03FEB2021:00:00:00,UFU TORNU,65,47,79,31,2,112,96,16,108,4,4,10,31,29,14,13,9,2,0,16,40,39,96
20210203,03FEB2021:00:00:00,UFU VELEZ SARSFIELD,65,60,96,29,0,125,123,2,125,0,0,0,44,20,23,21,11,6,0,19,52,52,123
20210203,03FEB2021:00:00:00,UFU ZUBIZARRETA,112,105,122,90,5,217,209,8,215,2,0,15,49,40,45,46,12,10,0,24,102,83,209
20210204,04FEB2021:00:00:00,UFU ALVAREZ,134,74,154,38,16,208,196,12,196,12,2,6,70,53,30,27,9,11,0,34,78,84,196
20210204,04FEB2021:00:00:00,UFU ARGERICH,43,34,46,31,0,77,61,16,61,16,2,4,30,10,16,4,7,4,0,10,28,23,61
20210204,04FEB2021:00:00:00,UFU BORDA-MOYANO,29,42,44,18,9,71,67,4,67,4,2,9,7,13,26,9,5,0,0,0,40,27,67
20210204,04FEB2021:00:00:00,UFU DURAND,97,68,138,20,7,165,153,12,153,12,5,4,44,35,39,24,7,7,0,20,78,55,153
20210204,04FEB2021:00:00:00,UFU ELIZALDE,69,74,30,108,5,143,113,30,135,8,53,35,6,26,16,6,0,1,0,5,63,45,113
20210204,04FEB2021:00:00:00,UFU FERNANDEZ,198,165,257,90,16,363,147,216,341,22,0,15,102,83,70,52,25,16,0,25,52,70,147
20210204,04FEB2021:00:00:00,UFU FERRER,43,31,37,37,0,74,70,4,70,4,0,1,12,26,16,8,6,5,0,8,36,26,70
20210204,04FEB2021:00:00:00,UFU GRIERSON,74,79,74,73,6,153,143,10,143,10,0,8,30,44,35,12,13,11,0,21,62,60,143
20210204,04FEB2021:00:00:00,UFU GUTIERREZ,80,39,71,44,4,119,93,26,115,4,23,35,32,10,9,3,5,2,0,5,53,35,93
20210204,04FEB2021:00:00:00,UFU MUÑIZ,244,205,159,279,11,449,341,108,345,104,5,19,140,110,74,51,35,15,0,28,223,89,341
20210204,04FEB2021:00:00:00,UFU PENNA,29,18,20,19,8,47,41,6,45,2,0,4,10,14,6,9,4,0,0,3,23,15,41
20210204,04FEB2021:00:00:00,UFU PIROVANO,161,127,220,54,14,288,258,30,276,12,0,10,69,69,52,35,32,21,0,27,121,110,258
20210204,04FEB2021:00:00:00,UFU PIÑERO,92,47,89,31,19,139,121,18,125,14,2,6,40,22,27,25,8,9,0,15,68,37,121
20210225,25FEB2021:00:00:00,UFU ZUBIZARRETA,69,49,80,36,2,118,96,22,118,0,0,5,37,20,22,20,8,6,0,12,44,40,96
20210226,26FEB2021:00:00:00,UFU ALVAREZ,115,88,136,56,11,203,173,30,179,24,10,19,49,56,29,15,15,10,0,19,87,67,173
20210226,26FEB2021:00:00:00,UFU ARGERICH,24,40,34,26,4,64,52,12,52,12,0,3,15,16,16,5,7,2,0,4,27,21,52
20210226,26FEB2021:00:00:00,UFU BORDA-MOYANO,40,38,38,34,6,78,78,0,78,0,1,0,22,11,21,8,11,4,0,2,46,30,78
20210226,26FEB2021:00:00:00,UFU DURAND,124,96,193,23,4,220,218,2,218,2,3,6,39,63,33,51,15,10,0,20,127,71,218
20210226,26FEB2021:00:00:00,UFU ELIZALDE,68,53,49,66,6,121,85,36,115,6,47,31,5,16,6,12,4,0,0,0,50,35,85
20210226,26FEB2021:00:00:00,UFU FERNANDEZ,140,82,156,53,13,222,88,134,216,6,0,8,77,54,37,21,17,8,0,7,44,37,88
20210226,26FEB2021:00:00:00,UFU FERRER,43,22,25,38,2,65,61,4,63,2,0,0,33,16,3,7,3,3,0,10,27,24,61
20210226,26FEB2021:00:00:00,UFU GRIERSON,114,118,119,107,6,232,200,32,216,16,2,20,64,63,27,39,13,4,0,0,6,194,200
20210226,26FEB2021:00:00:00,UFU GUTIERREZ,58,47,95,10,0,105,81,24,103,2,34,23,15,21,6,4,2,0,0,8,37,33,81
20210226,26FEB2021:00:00:00,UFU MUÑIZ,197,180,197,161,19,377,265,112,289,88,2,20,82,87,70,58,41,17,0,23,168,74,265
20210226,26FEB2021:00:00:00,UFU PENNA,16,24,37,3,0,40,32,8,36,4,0,1,10,9,8,6,4,2,0,5,16,11,32
20210226,26FEB2021:00:00:00,UFU PIROVANO,141,98,202,33,4,239,229,10,235,4,0,6,57,57,39,40,23,17,0,17,111,97,229
20210226,26FEB2021:00:00:00,UFU PIÑERO,95,93,106,69,13,188,176,12,180,8,0,10,65,40,27,21,14,11,0,11,121,43,176
20210226,26FEB2021:00:00:00,UFU RAMOS MEJIA,81,59,81,49,10,140,120,20,138,2,13,6,30,51,18,5,13,4,0,10,44,66,120
20210226,26FEB2021:00:00:00,UFU RIVADAVIA,178,129,215,75,17,307,281,26,285,22,2,4,113,93,28,39,14,14,0,40,117,122,281
20210226,26FEB2021:00:00:00,UFU SANTOJANNI,82,65,87,60,0,147,143,4,145,2,2,8,36,31,37,17,12,4,0,13,71,59,143
20210226,26FEB2021:00:00:00,UFU TORNU,38,30,53,15,0,68,60,8,64,4,2,4,14,12,17,8,8,3,0,3,32,24,60
20210226,26FEB2021:00:00:00,UFU VELEZ SARSFIELD,77,111,135,48,5,188,178,10,186,2,2,6,28,49,42,27,21,13,0,21,88,69,178
20210226,26FEB2021:00:00:00,UFU ZUBIZARRETA,102,79,111,61,9,181,155,26,181,0,0,19,59,32,20,19,24,8,0,17,71,67,155
20210227,27FEB2021:00:00:00,UFU ALVAREZ,65,100,108,26,31,165,157,8,157,8,2,5,39,46,34,21,16,2,0,13,56,87,157
20210227,27FEB2021:00:00:00,UFU ARGERICH,3,0,0,3,0,3,3,0,3,0,0,0,2,0,1,0,0,0,0,0,1,2,3
20210227,27FEB2021:00:00:00,UFU BORDA-MOYANO,23,33,32,22,2,56,56,0,56,0,2,4,15,6,9,8,10,2,0,3,31,22,56
20210227,27FEB2021:00:00:00,UFU DURAND,90,88,166,12,0,178,178,0,178,0,3,7,53,46,26,18,19,6,0,22,98,58,178
20210227,27FEB2021:00:00:00,UFU ELIZALDE,56,43,20,79,0,99,51,48,99,0,62,25,2,2,5,3,0,0,0,1,29,21,51
20210227,27FEB2021:00:00:00,UFU FERNANDEZ,50,53,77,24,2,103,81,22,99,4,0,2,35,21,17,11,11,6,0,12,34,35,81
20210227,27FEB2021:00:00:00,UFU FERRER,48,28,45,29,2,76,72,4,72,4,0,2,25,10,26,9,2,2,0,16,27,29,72
20210227,27FEB2021:00:00:00,UFU GRIERSON,94,63,73,79,5,157,151,6,155,2,0,5,54,33,32,24,6,3,0,17,76,58,151
20210227,27FEB2021:00:00:00,UFU GUTIERREZ,40,22,37,25,0,62,58,4,60,2,17,17,0,9,11,4,4,0,0,3,30,25,58
20210227,27FEB2021:00:00:00,UFU MUÑIZ,128,171,148,139,12,299,229,70,239,60,0,7,55,84,72,40,36,5,0,26,144,59,229
20210227,27FEB2021:00:00:00,UFU PENNA,25,23,35,13,0,48,40,8,46,2,0,2,12,11,5,16,2,0,0,9,15,16,40
20210227,27FEB2021:00:00:00,UFU PIROVANO,83,73,138,12,6,156,146,10,156,0,0,2,42,54,32,9,7,10,0,21,59,66,146
20210227,27FEB2021:00:00:00,UFU PIÑERO,78,64,94,38,10,142,142,0,142,0,0,5,47,24,17,19,20,10,0,15,88,39,142
20210227,27FEB2021:00:00:00,UFU RAMOS MEJIA,31,42,55,14,4,73,62,11,68,5,0,8,27,16,4,5,6,7,0,8,32,22,62
20210227,27FEB2021:00:00:00,UFU RIVADAVIA,110,95,155,48,2,205,177,28,177,28,0,6,47,60,34,37,17,4,0,11,90,76,177
20210227,27FEB2021:00:00:00,UFU SANTOJANNI,90,55,88,55,2,145,133,12,139,6,4,11,27,49,24,17,10,3,0,14,63,56,133
20210227,27FEB2021:00:00:00,UFU TORNU,39,20,22,23,14,59,55,4,57,2,4,2,8,22,18,4,1,0,0,8,25,22,55
20220528,28MAY2022:00:00:00,UFU GUTIERREZ,70,51,79,41,5,125,125,0,125,0,71,47,0,2,2,3,0,0,0,10,47,68,125
20210227,27FEB2021:00:00:00,UFU VELEZ SARSFIELD,104,81,141,44,0,185,179,6,181,4,0,9,49,24,42,30,21,10,0,22,77,80,179
20210227,27FEB2021:00:00:00,UFU ZUBIZARRETA,109,111,125,79,16,220,190,30,212,8,0,10,68,51,33,26,19,13,0,24,86,80,190
20210228,28FEB2021:00:00:00,UFU ALVAREZ,59,78,98,34,5,137,127,10,127,10,7,13,32,36,17,22,6,4,0,12,66,49,127
20210228,28FEB2021:00:00:00,UFU ARGERICH,11,4,12,3,0,15,15,0,15,0,0,0,1,5,2,0,5,2,0,4,7,4,15
20210228,28FEB2021:00:00:00,UFU BORDA-MOYANO,19,18,25,12,0,37,37,0,37,0,0,0,18,6,4,4,2,3,0,0,23,14,37
20210228,28FEB2021:00:00:00,UFU DURAND,0,2,0,2,0,2,2,0,2,0,0,0,0,2,0,0,0,0,0,0,1,1,2
20210228,28FEB2021:00:00:00,UFU ELIZALDE,43,42,23,62,0,85,71,14,85,0,38,26,6,6,9,0,0,0,0,2,42,27,71
20210228,28FEB2021:00:00:00,UFU FERNANDEZ,133,101,179,49,6,234,78,156,230,4,0,4,61,57,44,31,24,13,0,11,33,34,78
20210228,28FEB2021:00:00:00,UFU FERRER,22,31,16,37,0,53,53,0,53,0,0,0,12,14,11,1,13,2,0,10,21,22,53
20210228,28FEB2021:00:00:00,UFU GRIERSON,73,61,68,59,7,134,106,28,134,0,2,11,29,25,26,24,13,4,0,19,49,37,106
20210228,28FEB2021:00:00:00,UFU GUTIERREZ,19,25,22,19,3,44,40,4,44,0,21,14,3,2,2,2,0,0,0,1,21,18,40
20210228,28FEB2021:00:00:00,UFU MUÑIZ,128,148,136,134,6,276,194,82,218,58,5,4,47,74,51,46,33,16,0,34,108,52,194
20210228,28FEB2021:00:00:00,UFU PENNA,16,20,23,13,0,36,30,6,34,2,0,0,4,12,4,5,10,1,0,3,17,10,30
20210228,28FEB2021:00:00:00,UFU PIROVANO,74,57,115,14,2,131,111,20,131,0,0,0,35,38,33,3,12,10,0,9,55,47,111
20210228,28FEB2021:00:00:00,UFU PIÑERO,55,52,74,28,5,107,101,6,105,2,0,2,23,30,23,10,14,5,0,8,65,26,101
20210228,28FEB2021:00:00:00,UFU RAMOS MEJIA,44,40,59,17,8,84,62,22,62,22,2,5,18,22,15,13,8,1,0,8,30,24,62
20210228,28FEB2021:00:00:00,UFU RIVADAVIA,96,79,134,34,7,175,169,6,169,6,0,0,64,47,33,14,8,9,0,19,82,68,169
20210228,28FEB2021:00:00:00,UFU SANTOJANNI,92,59,83,63,5,151,147,4,149,2,0,4,26,41,32,25,12,11,0,20,68,59,147
20210228,28FEB2021:00:00:00,UFU TORNU,21,17,26,10,2,38,36,2,36,2,0,1,9,14,3,2,5,4,0,7,14,15,36
20210228,28FEB2021:00:00:00,UFU VELEZ SARSFIELD,50,37,50,30,7,87,81,6,83,4,0,5,8,18,24,16,6,10,0,11,40,30,81
20210228,28FEB2021:00:00:00,UFU ZUBIZARRETA,118,98,140,70,6,216,184,32,210,6,0,15,59,51,33,30,19,9,0,30,74,80,184
20210301,01MAR2021:00:00:00,UFU ALVAREZ,181,173,213,113,28,354,274,80,274,80,12,35,78,92,51,57,18,11,0,37,119,115,274
20210301,01MAR2021:00:00:00,UFU ARGERICH,23,24,33,10,4,47,35,12,35,12,0,2,4,14,10,9,7,1,0,4,16,13,35
20210301,01MAR2021:00:00:00,UFU BORDA-MOYANO,43,57,52,39,9,100,100,0,100,0,0,7,15,32,13,21,4,8,0,2,59,39,100
20210301,01MAR2021:00:00:00,UFU DURAND,114,96,183,23,4,210,206,4,206,4,5,10,32,57,53,24,19,10,0,24,106,75,206
20210301,01MAR2021:00:00:00,UFU ELIZALDE,112,87,56,133,10,199,149,50,183,16,76,53,22,21,8,7,8,4,0,4,85,60,149
20210301,01MAR2021:00:00:00,UFU FERNANDEZ,114,65,149,27,3,179,87,92,173,6,2,0,36,55,33,25,20,8,0,8,40,39,87
20210301,01MAR2021:00:00:00,UFU FERRER,55,67,68,54,0,122,114,8,114,8,0,4,29,49,35,4,1,0,0,18,51,45,114
20210301,01MAR2021:00:00:00,UFU GRIERSON,92,88,103,76,1,180,166,14,168,12,0,14,43,55,31,24,9,4,0,27,74,65,166
20210301,01MAR2021:00:00:00,UFU GUTIERREZ,85,80,95,70,0,165,153,12,161,4,62,36,24,17,12,8,4,2,0,4,84,64,153
20210304,04MAR2021:00:00:00,UFU VELEZ SARSFIELD,76,102,129,43,6,178,144,34,168,10,0,11,43,46,40,22,15,1,0,23,65,56,144
20210304,04MAR2021:00:00:00,UFU ZUBIZARRETA,36,45,42,25,14,81,45,36,81,0,0,22,13,22,4,10,7,3,0,9,18,18,45
20210305,05MAR2021:00:00:00,UFU ALVAREZ,131,118,188,49,12,249,203,46,203,46,17,21,39,62,39,32,27,12,0,21,95,87,203
20210305,05MAR2021:00:00:00,UFU ARGERICH,31,26,27,28,2,57,42,15,42,15,5,2,17,10,8,15,0,0,0,8,18,16,42
20210305,05MAR2021:00:00:00,UFU BORDA-MOYANO,34,45,41,34,4,79,73,6,73,6,0,0,18,27,15,16,3,0,0,1,43,29,73
20210305,05MAR2021:00:00:00,UFU DURAND,125,81,176,28,2,206,188,18,188,18,3,10,50,68,26,23,18,8,0,28,103,57,188
20210305,05MAR2021:00:00:00,UFU ELIZALDE,79,60,41,97,1,139,101,38,137,2,57,40,7,6,9,12,5,3,0,3,58,40,101
20210305,05MAR2021:00:00:00,UFU FERNANDEZ,201,122,258,51,14,323,127,196,317,6,0,8,74,113,52,45,20,11,0,23,53,51,127
20210305,05MAR2021:00:00:00,UFU FERRER,31,43,38,36,0,74,72,2,72,2,0,1,16,21,20,6,4,6,0,18,30,24,72
20210305,05MAR2021:00:00:00,UFU GRIERSON,163,109,119,151,2,272,230,42,260,12,0,24,61,66,49,52,19,1,0,2,3,225,230
20210305,05MAR2021:00:00:00,UFU GUTIERREZ,75,60,82,51,2,135,97,38,135,0,37,33,23,30,6,6,0,0,0,3,45,47,97
20210305,05MAR2021:00:00:00,UFU MUÑIZ,249,236,165,301,19,485,321,164,343,142,0,20,110,114,100,78,45,18,0,35,187,99,321
20210305,05MAR2021:00:00:00,UFU PENNA,21,8,11,18,0,29,25,4,27,2,0,1,3,16,6,3,0,0,0,3,12,10,25
20210305,05MAR2021:00:00:00,UFU PIROVANO,110,100,177,27,6,210,200,10,208,2,0,1,43,77,41,23,15,10,0,18,101,81,200
20210305,05MAR2021:00:00:00,UFU PIÑERO,97,101,123,57,18,198,190,8,196,2,0,1,64,59,20,22,18,14,0,15,115,59,190
20210305,05MAR2021:00:00:00,UFU RAMOS MEJIA,84,81,108,37,20,165,143,22,149,16,11,20,44,26,22,23,11,8,0,20,64,59,143
20210305,05MAR2021:00:00:00,UFU RIVADAVIA,150,130,167,82,31,280,264,16,268,12,0,5,81,81,41,30,33,9,0,32,125,105,264
20210305,05MAR2021:00:00:00,UFU SANTOJANNI,85,111,101,83,12,196,168,28,186,10,2,15,52,32,38,35,16,6,0,25,77,66,168
20210305,05MAR2021:00:00:00,UFU TORNU,38,34,49,15,8,72,54,18,54,18,4,4,18,13,23,2,1,7,0,6,24,24,54
20210305,05MAR2021:00:00:00,UFU VELEZ SARSFIELD,97,62,111,43,5,159,125,34,157,2,0,7,40,35,28,34,12,3,0,24,54,47,125
20210305,05MAR2021:00:00:00,UFU ZUBIZARRETA,91,118,143,53,13,209,201,8,209,0,0,14,44,59,32,31,23,6,0,16,96,89,201
20210306,06MAR2021:00:00:00,UFU ALVAREZ,87,71,114,39,5,158,142,16,142,16,6,8,39,34,36,26,7,2,0,25,59,58,142
20210306,06MAR2021:00:00:00,UFU ARGERICH,6,8,14,0,0,14,14,0,14,0,0,4,2,0,2,2,2,2,0,0,4,10,14
20210306,06MAR2021:00:00:00,UFU BORDA-MOYANO,53,44,53,44,0,97,93,4,93,4,0,4,26,21,22,9,6,9,0,1,54,38,93
20210306,06MAR2021:00:00:00,UFU DURAND,109,94,177,26,0,203,197,6,197,6,12,17,53,56,33,11,15,6,0,28,95,74,197
20210306,06MAR2021:00:00:00,UFU ELIZALDE,59,30,38,51,0,89,55,34,83,6,54,17,10,3,2,1,0,2,0,2,30,23,55
20210306,06MAR2021:00:00:00,UFU FERNANDEZ,102,95,161,34,2,197,93,104,185,12,2,6,44,68,29,22,18,8,0,22,34,37,93
20210306,06MAR2021:00:00:00,UFU FERRER,19,28,23,24,0,47,45,2,45,2,0,2,12,13,10,4,4,2,0,6,22,17,45
20210306,06MAR2021:00:00:00,UFU GRIERSON,71,86,62,87,8,157,155,2,157,0,0,7,31,41,21,27,21,9,0,13,9,131,155
20210306,06MAR2021:00:00:00,UFU GUTIERREZ,48,29,42,35,0,77,73,4,77,0,23,19,14,7,12,2,0,0,0,1,39,32,73
20210306,06MAR2021:00:00:00,UFU MUÑIZ,175,186,129,224,8,361,269,92,287,74,0,14,86,81,83,61,15,21,0,26,164,79,269
20210306,06MAR2021:00:00:00,UFU PENNA,32,12,28,16,0,44,42,2,44,0,0,2,11,6,13,10,2,0,0,6,18,18,42
20210306,06MAR2021:00:00:00,UFU PIROVANO,75,85,145,11,4,160,136,24,160,0,0,0,35,43,33,22,15,12,0,16,64,56,136
20210306,06MAR2021:00:00:00,UFU PIÑERO,91,71,114,48,0,162,152,10,154,8,0,14,42,40,26,27,5,8,0,10,100,42,152
20210306,06MAR2021:00:00:00,UFU RAMOS MEJIA,57,43,78,5,17,100,92,8,94,6,6,7,20,22,16,11,12,6,0,8,46,38,92
20210306,06MAR2021:00:00:00,UFU RIVADAVIA,132,144,218,50,8,276,232,44,232,44,0,1,104,56,48,36,25,6,0,22,109,96,232
20210306,06MAR2021:00:00:00,UFU SANTOJANNI,85,98,97,74,12,183,169,14,177,6,4,8,51,40,30,30,14,6,0,26,70,73,169
20210306,06MAR2021:00:00:00,UFU TORNU,53,29,34,32,16,82,78,4,80,2,3,6,18,21,9,9,8,8,0,7,41,30,78
20210306,06MAR2021:00:00:00,UFU VELEZ SARSFIELD,59,60,104,11,4,119,117,2,117,2,0,0,26,32,16,15,23,7,0,17,55,45,117
20210306,06MAR2021:00:00:00,UFU ZUBIZARRETA,97,94,105,66,20,191,167,24,183,8,0,12,42,47,31,22,25,12,0,18,85,64,167
20210307,07MAR2021:00:00:00,UFU ALVAREZ,96,57,133,18,2,153,141,12,141,12,6,12,34,32,24,18,18,9,0,19,67,55,141
20210307,07MAR2021:00:00:00,UFU ARGERICH,10,13,16,7,0,23,23,0,23,0,2,0,7,4,2,2,2,4,0,1,10,12,23
20210307,07MAR2021:00:00:00,UFU BORDA-MOYANO,4,5,6,3,0,9,9,0,9,0,0,1,4,2,2,0,0,0,0,0,5,4,9
20210307,07MAR2021:00:00:00,UFU DURAND,12,0,8,4,0,12,4,8,12,0,0,0,2,4,2,4,0,0,0,0,2,2,4
20210307,07MAR2021:00:00:00,UFU ELIZALDE,54,44,20,78,0,98,66,32,88,10,61,16,8,6,5,2,0,0,0,2,36,28,66
20210307,07MAR2021:00:00:00,UFU FERNANDEZ,206,131,286,49,2,337,95,242,331,6,0,6,89,96,60,48,26,12,0,18,32,45,95
20210307,07MAR2021:00:00:00,UFU FERRER,26,39,29,36,0,65,63,2,63,2,0,0,17,21,15,6,6,0,0,8,26,29,63
20210307,07MAR2021:00:00:00,UFU GRIERSON,69,75,79,57,8,144,114,30,138,6,2,11,39,42,26,16,5,3,0,13,5,95,114
20210307,07MAR2021:00:00:00,UFU GUTIERREZ,39,28,37,30,0,67,65,2,65,2,24,28,1,8,0,4,2,0,0,3,35,27,65
20210307,07MAR2021:00:00:00,UFU MUÑIZ,130,109,86,147,6,239,199,40,207,32,0,9,37,53,67,44,17,12,0,17,121,61,199
20210307,07MAR2021:00:00:00,UFU PENNA,20,12,18,14,0,32,28,4,28,4,0,0,6,9,4,9,3,1,0,4,14,10,28
20210307,07MAR2021:00:00:00,UFU PIROVANO,94,74,149,15,4,168,164,4,168,0,0,4,41,42,36,21,15,9,0,21,73,70,164
20210307,07MAR2021:00:00:00,UFU PIÑERO,73,69,101,33,8,142,136,6,136,6,0,5,33,34,24,16,28,2,0,15,85,34,136
20210307,07MAR2021:00:00:00,UFU RAMOS MEJIA,53,70,86,32,5,123,111,12,111,12,5,15,31,18,24,16,9,5,0,7,56,48,111
20210307,07MAR2021:00:00:00,UFU RIVADAVIA,103,64,135,28,4,167,161,6,161,6,0,4,48,43,34,22,11,5,0,24,73,61,161
20210307,07MAR2021:00:00:00,UFU SANTOJANNI,95,72,86,71,10,167,157,10,161,6,1,14,41,43,24,23,12,9,0,19,73,65,157
20210307,07MAR2021:00:00:00,UFU TORNU,29,44,28,40,5,73,67,6,71,2,3,9,9,19,14,14,4,1,0,15,21,31,67
20210307,07MAR2021:00:00:00,UFU VELEZ SARSFIELD,67,49,83,31,2,116,112,4,116,0,0,2,19,38,21,19,8,9,0,22,47,43,112
20210307,07MAR2021:00:00:00,UFU ZUBIZARRETA,119,94,138,58,17,213,191,22,203,10,0,21,35,43,36,42,16,20,0,25,88,78,191
20210308,08MAR2021:00:00:00,UFU ALVAREZ,155,135,223,54,13,290,204,86,208,82,18,32,73,57,45,24,27,14,0,15,98,91,204
20210308,08MAR2021:00:00:00,UFU ARGERICH,45,37,47,21,14,82,66,16,66,16,3,4,24,19,12,9,9,2,0,13,20,33,66
20210308,08MAR2021:00:00:00,UFU BORDA-MOYANO,34,63,56,38,3,97,91,6,91,6,0,1,16,26,20,19,9,6,0,1,55,35,91
20210308,08MAR2021:00:00:00,UFU DURAND,133,100,200,20,13,233,219,14,219,14,4,6,65,58,39,32,16,13,0,31,109,79,219
20210308,08MAR2021:00:00:00,UFU ELIZALDE,92,95,41,144,2,187,149,38,171,16,82,52,19,10,15,4,5,0,0,3,82,64,149
20210308,08MAR2021:00:00:00,UFU FERNANDEZ,151,126,225,41,11,277,191,86,263,14,0,8,98,66,45,31,25,4,0,17,48,126,191
20210308,08MAR2021:00:00:00,UFU FERRER,57,46,54,47,2,103,95,8,95,8,0,0,17,42,26,11,7,0,0,25,32,38,95
20210308,08MAR2021:00:00:00,UFU GRIERSON,130,84,115,99,0,214,208,6,210,4,0,14,77,42,28,36,9,8,0,26,10,172,208
20210308,08MAR2021:00:00:00,UFU GUTIERREZ,85,76,83,78,0,161,140,21,160,1,66,42,17,13,14,6,3,0,0,3,80,57,140
20210308,08MAR2021:00:00:00,UFU MUÑIZ,229,295,187,308,29,524,400,124,414,110,0,17,115,136,98,100,42,16,0,26,259,114,400
20210308,08MAR2021:00:00:00,UFU PENNA,46,19,49,14,2,65,59,6,65,0,0,3,19,6,23,11,2,1,0,6,29,24,59
20210308,08MAR2021:00:00:00,UFU PIROVANO,132,121,199,46,8,253,227,26,243,10,0,4,74,71,53,20,22,9,0,18,106,103,227
20210308,08MAR2021:00:00:00,UFU PIÑERO,117,82,151,42,6,199,191,8,193,6,0,14,43,52,31,32,19,8,0,26,113,50,191
20210308,08MAR2021:00:00:00,UFU RAMOS MEJIA,77,77,108,39,7,154,150,4,150,4,10,10,28,33,42,8,14,9,0,9,64,77,150
20210308,08MAR2021:00:00:00,UFU RIVADAVIA,171,144,201,72,42,315,251,64,255,60,3,4,104,74,53,50,16,11,0,26,116,106,251
20210308,08MAR2021:00:00:00,UFU SANTOJANNI,91,109,113,80,7,200,186,14,194,6,0,2,55,36,37,38,15,17,0,16,94,76,186
20210308,08MAR2021:00:00:00,UFU TORNU,51,33,58,26,0,84,70,14,78,6,6,4,14,22,16,13,5,4,0,12,29,29,70
20210308,08MAR2021:00:00:00,UFU VELEZ SARSFIELD,114,123,167,70,0,237,205,32,237,0,2,3,40,68,46,34,23,21,0,39,85,81,205
20210308,08MAR2021:00:00:00,UFU ZUBIZARRETA,111,101,129,75,8,212,210,2,212,0,0,9,55,45,51,24,20,8,0,30,98,82,210
20210309,09MAR2021:00:00:00,UFU ALVAREZ,130,104,184,36,14,234,182,52,214,20,11,15,42,63,44,26,16,17,0,16,94,72,182
20210309,09MAR2021:00:00:00,UFU ARGERICH,41,26,34,30,3,67,58,9,58,9,11,4,26,14,3,3,5,1,0,5,30,23,58
20210309,09MAR2021:00:00:00,UFU BORDA-MOYANO,53,33,51,30,5,86,84,2,84,2,0,3,15,17,22,4,23,2,0,0,54,30,84
20210309,09MAR2021:00:00:00,UFU DURAND,88,81,151,16,2,169,169,0,169,0,0,6,46,44,38,10,21,4,0,13,101,55,169
20210309,09MAR2021:00:00:00,UFU ELIZALDE,74,89,54,109,0,163,115,48,159,4,56,59,9,15,12,6,6,0,0,3,64,48,115
20210309,09MAR2021:00:00:00,UFU FERNANDEZ,112,113,190,35,0,225,175,50,217,8,0,8,58,52,38,37,20,12,0,34,69,72,175
20210309,09MAR2021:00:00:00,UFU FERRER,46,42,45,39,4,88,82,6,82,6,0,0,18,22,31,13,3,1,0,23,28,31,82
20210309,09MAR2021:00:00:00,UFU GRIERSON,105,111,93,120,3,216,212,4,212,4,0,11,66,42,40,32,23,2,0,35,1,176,212
20210309,09MAR2021:00:00:00,UFU GUTIERREZ,69,54,60,61,2,123,103,20,123,0,75,25,8,5,3,3,2,2,0,2,53,48,103
20210309,09MAR2021:00:00:00,UFU MUÑIZ,224,230,160,278,16,454,334,120,352,102,2,16,108,100,109,64,32,23,0,38,198,97,334
20210309,09MAR2021:00:00:00,UFU PENNA,44,40,63,21,0,84,76,8,80,4,0,7,31,13,8,15,8,2,0,11,45,20,76
20210309,09MAR2021:00:00:00,UFU PIROVANO,146,133,230,39,10,279,247,32,271,8,0,18,68,90,44,38,13,8,0,35,111,101,247
20210309,09MAR2021:00:00:00,UFU PIÑERO,141,103,122,98,24,244,240,4,240,4,0,9,60,68,53,23,11,20,0,29,145,64,240
20210309,09MAR2021:00:00:00,UFU RAMOS MEJIA,83,86,120,36,13,169,153,16,157,12,6,15,38,37,30,24,10,9,0,25,62,66,153
20210309,09MAR2021:00:00:00,UFU RIVADAVIA,148,109,170,48,39,257,237,20,241,16,0,2,78,60,40,37,31,9,0,28,114,92,237
20210309,09MAR2021:00:00:00,UFU SANTOJANNI,97,85,103,77,2,182,168,14,182,0,2,9,45,41,18,41,12,14,0,15,86,67,168
20210309,09MAR2021:00:00:00,UFU TORNU,77,64,87,50,4,141,127,14,127,14,6,9,38,35,23,17,8,5,0,17,59,51,127
20210309,09MAR2021:00:00:00,UFU VELEZ SARSFIELD,80,86,109,50,7,166,158,8,166,0,2,1,45,49,27,18,15,9,0,19,30,109,158
20210309,09MAR2021:00:00:00,UFU ZUBIZARRETA,92,73,101,57,7,165,165,0,165,0,0,12,47,44,24,19,11,8,0,22,85,58,165
20210310,10MAR2021:00:00:00,UFU ALVAREZ,136,138,219,39,16,274,191,83,193,81,11,21,63,50,40,41,36,12,0,31,83,77,191
20210310,10MAR2021:00:00:00,UFU ARGERICH,35,27,42,20,0,62,32,30,42,20,2,0,13,14,6,6,7,14,0,5,15,12,32
20210310,10MAR2021:00:00:00,UFU BORDA-MOYANO,57,38,41,37,17,95,95,0,95,0,1,2,18,23,24,13,11,3,0,3,56,36,95
20210310,10MAR2021:00:00:00,UFU DURAND,150,81,199,22,10,231,223,8,225,6,8,19,57,62,37,30,11,7,0,22,119,82,223
20210310,10MAR2021:00:00:00,UFU ELIZALDE,92,75,47,120,0,167,137,30,155,12,54,58,16,11,15,6,7,0,0,5,79,53,137
20210310,10MAR2021:00:00:00,UFU FERNANDEZ,220,144,268,80,16,364,122,242,360,4,0,13,93,94,48,73,27,16,0,5,36,81,122
20210310,10MAR2021:00:00:00,UFU FERRER,61,54,67,44,4,115,107,8,107,8,0,2,33,41,29,7,1,2,0,22,42,43,107
20210310,10MAR2021:00:00:00,UFU GRIERSON,104,116,112,102,6,220,212,8,214,6,0,12,74,56,36,24,12,6,0,0,4,208,212
20210310,10MAR2021:00:00:00,UFU GUTIERREZ,79,47,69,55,2,126,108,18,124,2,42,49,4,10,10,2,9,0,0,1,59,48,108
20210310,10MAR2021:00:00:00,UFU MUÑIZ,229,335,237,315,12,564,416,148,474,90,0,12,169,112,108,73,64,26,0,40,255,121,416
20210310,10MAR2021:00:00:00,UFU PENNA,23,31,22,32,0,54,48,6,48,6,2,0,3,20,17,2,6,4,0,4,26,18,48
20210310,10MAR2021:00:00:00,UFU PIROVANO,84,107,150,39,2,191,181,10,183,8,0,6,62,48,19,32,16,8,0,16,92,73,181
20220327,27MAR2022:00:00:00,UFU FERRER,17,19,22,11,3,36,36,0,36,0,0,0,6,6,11,6,5,2,0,0,27,9,36
20210310,10MAR2021:00:00:00,UFU PIÑERO,84,87,119,40,12,171,159,12,161,10,1,2,57,46,28,23,7,7,0,18,103,38,159
20210310,10MAR2021:00:00:00,UFU RAMOS MEJIA,116,107,188,34,1,223,173,50,207,16,16,18,37,55,21,26,36,14,0,19,77,77,173
20210310,10MAR2021:00:00:00,UFU RIVADAVIA,165,141,200,65,41,306,284,22,288,18,4,10,79,95,59,28,23,8,0,33,131,119,284
20210310,10MAR2021:00:00:00,UFU SANTOJANNI,149,115,149,114,1,264,232,32,260,4,2,25,68,56,53,32,20,8,0,21,113,98,232
20210310,10MAR2021:00:00:00,UFU TORNU,67,62,92,29,8,129,117,12,119,10,9,20,24,29,24,12,9,2,0,14,53,50,117
20210310,10MAR2021:00:00:00,UFU VELEZ SARSFIELD,91,89,120,54,6,180,172,8,180,0,0,8,32,50,33,31,15,11,0,25,75,72,172
20210310,10MAR2021:00:00:00,UFU ZUBIZARRETA,84,91,112,51,12,175,167,8,175,0,0,13,40,38,35,25,19,5,0,17,81,69,167
20210311,11MAR2021:00:00:00,UFU ALVAREZ,122,101,167,42,14,223,207,16,207,16,9,11,58,60,38,34,6,7,0,26,97,84,207
20210311,11MAR2021:00:00:00,UFU ARGERICH,37,24,28,30,3,61,49,12,49,12,4,0,13,18,11,6,7,2,0,5,22,22,49
20210311,11MAR2021:00:00:00,UFU BORDA-MOYANO,60,36,36,36,24,96,94,2,94,2,0,6,14,27,11,17,13,8,0,2,50,42,94
20210311,11MAR2021:00:00:00,UFU DURAND,121,100,199,11,11,221,215,6,215,6,2,9,54,55,40,24,30,7,0,31,106,78,215
20210311,11MAR2021:00:00:00,UFU ELIZALDE,83,82,69,86,10,165,125,40,155,10,61,37,27,15,4,8,10,3,0,2,74,49,125
20210311,11MAR2021:00:00:00,UFU FERNANDEZ,168,163,271,44,16,331,133,198,319,12,0,17,96,92,57,40,13,16,0,5,13,115,133
20210311,11MAR2021:00:00:00,UFU FERRER,40,57,51,43,3,97,89,8,89,8,0,0,15,21,34,13,11,3,0,6,46,37,89
20210311,11MAR2021:00:00:00,UFU GRIERSON,168,126,147,127,20,294,256,38,280,14,0,14,90,71,60,31,22,6,0,0,7,249,256
20210311,11MAR2021:00:00:00,UFU GUTIERREZ,68,59,90,37,0,127,111,16,125,2,61,28,18,13,3,0,4,0,0,2,62,47,111
20210311,11MAR2021:00:00:00,UFU MUÑIZ,225,258,192,281,10,483,313,170,331,152,0,2,113,136,96,71,50,15,0,31,185,97,313
20210311,11MAR2021:00:00:00,UFU PENNA,45,33,60,15,3,78,64,14,64,14,0,0,19,34,8,4,7,6,0,6,36,22,64
20210311,11MAR2021:00:00:00,UFU PIROVANO,70,57,93,19,15,127,105,22,117,10,0,9,28,26,24,16,13,11,0,9,51,45,105
20210311,11MAR2021:00:00:00,UFU PIÑERO,108,87,134,60,1,195,187,8,187,8,0,9,35,53,44,25,17,12,0,18,103,65,187
20210311,11MAR2021:00:00:00,UFU RAMOS MEJIA,97,84,134,32,15,181,167,14,175,6,7,13,36,44,27,33,18,3,0,27,74,66,167
20210311,11MAR2021:00:00:00,UFU RIVADAVIA,207,130,205,87,45,337,299,38,303,34,2,18,114,90,49,33,24,7,0,40,136,122,299
20210311,11MAR2021:00:00:00,UFU SANTOJANNI,114,92,121,85,0,206,202,4,206,0,2,17,58,39,29,34,13,14,0,22,93,87,202
20210311,11MAR2021:00:00:00,UFU TORNU,60,60,96,18,6,120,104,16,106,14,5,11,16,21,34,16,13,4,0,11,54,39,104
20210311,11MAR2021:00:00:00,UFU VELEZ SARSFIELD,143,112,190,60,5,255,183,72,251,4,0,9,60,81,31,36,20,18,0,24,46,113,183
20210311,11MAR2021:00:00:00,UFU ZUBIZARRETA,111,78,123,56,10,189,165,24,189,0,0,27,50,31,29,28,13,11,0,19,80,66,165
20210312,12MAR2021:00:00:00,UFU ALVAREZ,127,118,188,49,8,245,195,50,197,48,13,22,68,46,33,27,17,19,0,30,81,84,195
20210312,12MAR2021:00:00:00,UFU ARGERICH,32,19,36,13,2,51,31,20,31,20,4,2,15,5,14,3,3,5,0,4,12,15,31
20210312,12MAR2021:00:00:00,UFU BORDA-MOYANO,36,50,39,20,27,86,86,0,86,0,0,1,24,11,24,15,9,2,0,7,42,37,86
20210312,12MAR2021:00:00:00,UFU DURAND,138,69,182,18,7,207,203,4,203,4,2,3,57,74,39,16,14,2,0,24,110,69,203
20210312,12MAR2021:00:00:00,UFU ELIZALDE,61,83,44,98,2,144,104,40,126,18,59,52,8,9,5,2,9,0,0,7,53,44,104
20210312,12MAR2021:00:00:00,UFU FERNANDEZ,96,107,159,36,8,203,113,90,195,8,0,14,54,52,46,11,18,8,0,16,50,47,113
20210312,12MAR2021:00:00:00,UFU FERRER,65,53,63,53,2,118,110,8,112,6,2,2,30,40,13,16,15,0,0,18,43,49,110
20210312,12MAR2021:00:00:00,UFU GRIERSON,151,112,127,108,28,263,251,12,255,8,0,17,78,68,40,37,19,4,0,2,3,246,251
20210312,12MAR2021:00:00:00,UFU GUTIERREZ,57,61,85,33,0,118,92,26,116,2,54,38,3,13,4,4,2,0,0,2,51,39,92
20210312,12MAR2021:00:00:00,UFU MUÑIZ,205,222,186,220,21,427,315,112,323,104,3,3,95,117,84,76,31,18,0,39,185,91,315
20210312,12MAR2021:00:00:00,UFU PENNA,28,37,41,24,0,65,51,14,63,2,2,0,23,10,14,8,0,8,0,3,25,23,51
20210312,12MAR2021:00:00:00,UFU PIROVANO,164,129,239,47,7,293,261,32,283,10,0,8,75,81,67,32,14,16,0,25,132,104,261
20210312,12MAR2021:00:00:00,UFU PIÑERO,90,106,114,66,16,196,190,6,192,4,0,8,49,28,63,17,24,7,0,15,122,53,190
20210312,12MAR2021:00:00:00,UFU RAMOS MEJIA,120,97,170,29,18,217,197,20,203,14,18,15,57,38,38,29,17,5,0,27,93,77,197
20210312,12MAR2021:00:00:00,UFU RIVADAVIA,222,158,257,91,32,380,340,40,356,24,0,13,106,116,65,49,23,8,0,50,158,131,340
20210312,12MAR2021:00:00:00,UFU SANTOJANNI,129,85,127,85,2,214,190,24,210,4,8,18,43,51,44,26,9,15,0,22,84,84,190
20210312,12MAR2021:00:00:00,UFU TORNU,72,55,88,26,13,127,123,4,123,4,0,3,44,24,21,18,6,11,0,22,51,50,123
20210312,12MAR2021:00:00:00,UFU VELEZ SARSFIELD,79,74,102,51,0,153,151,2,151,2,0,5,46,30,26,31,10,5,0,24,61,66,151
20210312,12MAR2021:00:00:00,UFU ZUBIZARRETA,123,121,148,88,8,244,234,10,244,0,0,20,45,64,43,36,22,14,0,25,116,93,234
20210313,13MAR2021:00:00:00,UFU ALVAREZ,91,57,116,28,4,148,144,4,144,4,2,10,43,34,21,18,7,13,0,29,59,56,144
20210313,13MAR2021:00:00:00,UFU BORDA-MOYANO,41,33,25,49,0,74,74,0,74,0,2,7,9,15,19,12,9,1,0,0,44,30,74
20210313,13MAR2021:00:00:00,UFU DURAND,109,88,191,4,2,197,195,2,195,2,3,18,63,50,31,19,6,7,0,40,98,57,195
20210313,13MAR2021:00:00:00,UFU ELIZALDE,39,24,9,52,2,63,41,22,59,4,30,20,4,7,0,2,0,0,0,0,23,18,41
20210313,13MAR2021:00:00:00,UFU FERNANDEZ,105,92,176,17,4,197,87,110,193,4,1,11,52,68,25,22,18,0,0,15,37,35,87
20210313,13MAR2021:00:00:00,UFU FERRER,5,18,13,10,0,23,23,0,23,0,0,0,5,6,5,5,0,2,0,2,11,10,23
20210313,13MAR2021:00:00:00,UFU GRIERSON,95,73,61,96,11,168,152,16,168,0,0,6,64,44,22,15,17,0,0,27,68,57,152
20210313,13MAR2021:00:00:00,UFU GUTIERREZ,36,39,41,32,2,75,65,10,73,2,32,24,2,9,6,2,0,0,0,1,36,28,65
20210313,13MAR2021:00:00:00,UFU MUÑIZ,171,229,147,233,20,400,288,112,316,84,2,22,85,91,78,78,33,11,0,28,172,88,288
20210313,13MAR2021:00:00:00,UFU PENNA,31,15,37,7,2,46,44,2,44,2,2,5,8,4,9,10,8,0,0,7,20,16,44
20210313,13MAR2021:00:00:00,UFU PIROVANO,96,96,171,18,3,192,174,18,192,0,0,3,26,66,39,29,19,10,0,20,76,78,174
20210313,13MAR2021:00:00:00,UFU PIÑERO,117,97,136,77,1,214,210,4,210,4,5,15,46,37,47,32,21,11,0,28,104,74,210
20210313,13MAR2021:00:00:00,UFU RAMOS MEJIA,51,51,75,25,2,102,94,8,96,6,3,0,20,39,17,8,10,5,0,14,44,36,94
20210313,13MAR2021:00:00:00,UFU RIVADAVIA,136,123,191,47,21,259,245,14,245,14,2,8,69,91,33,33,17,6,0,27,116,102,245
20210313,13MAR2021:00:00:00,UFU SANTOJANNI,106,91,106,89,2,197,181,16,193,4,8,16,54,51,25,31,8,4,0,18,94,69,181
20210313,13MAR2021:00:00:00,UFU TORNU,73,62,59,57,19,135,121,14,123,12,6,10,27,31,17,25,13,6,0,17,54,50,121
20210313,13MAR2021:00:00:00,UFU VELEZ SARSFIELD,101,101,164,38,0,202,200,2,202,0,0,11,42,38,43,40,18,10,0,38,80,82,200
20210313,13MAR2021:00:00:00,UFU ZUBIZARRETA,128,117,153,79,13,245,223,22,241,4,0,14,59,56,61,26,14,15,0,45,95,83,223
20210314,14MAR2021:00:00:00,UFU ALVAREZ,81,81,142,17,3,162,146,16,146,16,6,21,33,32,32,24,5,9,0,20,73,53,146
20210314,14MAR2021:00:00:00,UFU ARGERICH,16,14,18,12,0,30,30,0,30,0,0,0,6,10,4,4,1,5,0,0,7,23,30
20210314,14MAR2021:00:00:00,UFU BORDA-MOYANO,4,13,13,4,0,17,17,0,17,0,0,0,8,7,0,2,0,0,0,0,9,8,17
20210314,14MAR2021:00:00:00,UFU DURAND,2,0,2,0,0,2,2,0,2,0,0,0,0,0,0,2,0,0,0,0,1,1,2
20210314,14MAR2021:00:00:00,UFU ELIZALDE,58,33,23,68,0,91,75,16,87,4,28,36,8,8,7,0,4,0,0,6,42,27,75
20210314,14MAR2021:00:00:00,UFU FERNANDEZ,147,100,218,29,0,247,83,164,241,6,2,11,69,87,28,17,24,9,0,18,29,36,83
20210314,14MAR2021:00:00:00,UFU FERRER,39,31,53,17,0,70,68,2,68,2,0,4,24,14,14,6,8,0,0,14,28,26,68
20210314,14MAR2021:00:00:00,UFU GRIERSON,98,76,74,87,13,174,150,24,170,4,0,6,53,43,31,28,8,5,0,16,61,73,150
20210314,14MAR2021:00:00:00,UFU GUTIERREZ,35,45,47,33,0,80,68,12,74,6,39,28,5,4,1,3,0,0,0,1,40,27,68
20210314,14MAR2021:00:00:00,UFU MUÑIZ,118,142,127,124,9,260,202,58,224,36,0,7,51,70,47,50,24,11,0,22,120,60,202
20210314,14MAR2021:00:00:00,UFU PENNA,31,30,30,29,2,61,55,6,59,2,0,0,10,15,20,5,7,4,0,7,24,24,55
20210314,14MAR2021:00:00:00,UFU PIROVANO,85,82,148,19,0,167,155,12,167,0,8,4,33,54,43,12,6,7,0,26,65,64,155
20210314,14MAR2021:00:00:00,UFU PIÑERO,72,82,92,55,7,154,152,2,154,0,0,9,44,27,30,27,8,9,0,15,93,44,152
20210314,14MAR2021:00:00:00,UFU RAMOS MEJIA,42,52,84,4,6,94,78,16,82,12,3,6,28,28,12,10,1,6,0,17,25,36,78
20210314,14MAR2021:00:00:00,UFU RIVADAVIA,142,83,171,35,19,225,199,26,199,26,2,3,44,41,64,31,25,15,0,27,83,88,199
20210314,14MAR2021:00:00:00,UFU SANTOJANNI,59,59,64,51,3,118,114,4,116,2,7,7,22,31,20,12,12,7,0,13,58,43,114
20210314,14MAR2021:00:00:00,UFU TORNU,79,22,44,38,19,101,89,12,89,12,4,17,18,26,19,12,4,1,0,13,41,35,89
20210314,14MAR2021:00:00:00,UFU VELEZ SARSFIELD,76,73,113,36,0,149,145,4,149,0,0,14,35,26,37,20,14,3,0,28,59,58,145
20210314,14MAR2021:00:00:00,UFU ZUBIZARRETA,107,60,111,43,13,167,131,36,167,0,0,13,32,24,39,22,27,10,0,23,53,55,131
20210315,15MAR2021:00:00:00,UFU ALVAREZ,138,146,233,46,5,284,194,90,194,90,15,16,76,81,46,16,21,13,0,22,91,81,194
20210315,15MAR2021:00:00:00,UFU ARGERICH,75,69,99,43,2,144,78,66,118,26,11,5,23,26,19,24,22,14,0,7,35,35,78
20210315,15MAR2021:00:00:00,UFU BORDA-MOYANO,54,54,53,51,4,108,108,0,108,0,1,0,15,32,23,17,15,5,0,2,62,44,108
20210315,15MAR2021:00:00:00,UFU DURAND,111,108,202,15,2,219,215,4,215,4,2,21,43,65,45,13,21,9,0,25,118,72,215
20210315,15MAR2021:00:00:00,UFU ELIZALDE,93,91,61,112,11,184,134,50,174,10,80,42,13,26,14,5,2,2,0,3,78,53,134
20210315,15MAR2021:00:00:00,UFU FERNANDEZ,125,106,185,42,4,231,117,114,221,10,0,11,63,56,42,25,22,12,0,19,52,46,117
20210301,01MAR2021:00:00:00,UFU MUÑIZ,195,229,150,254,20,424,358,66,366,58,5,8,92,82,100,71,37,29,0,34,210,113,358
20210301,01MAR2021:00:00:00,UFU PENNA,46,25,42,26,3,71,53,18,57,14,2,2,15,16,12,9,10,5,0,4,28,21,53
20210301,01MAR2021:00:00:00,UFU PIROVANO,135,107,192,43,7,242,234,8,236,6,0,6,69,64,51,28,16,8,0,17,120,97,234
20210301,01MAR2021:00:00:00,UFU PIÑERO,98,107,126,74,5,205,185,20,197,8,14,6,53,53,53,20,3,3,0,11,109,62,185
20210301,01MAR2021:00:00:00,UFU RAMOS MEJIA,130,106,139,48,49,236,192,44,222,14,15,12,63,41,54,21,13,17,0,27,79,86,192
20210301,01MAR2021:00:00:00,UFU RIVADAVIA,181,140,205,88,28,321,237,84,245,76,0,3,84,96,52,44,23,19,0,29,96,107,237
20210301,01MAR2021:00:00:00,UFU SANTOJANNI,108,105,92,114,7,213,207,6,207,6,5,3,55,56,40,34,17,3,0,16,107,84,207
20210301,01MAR2021:00:00:00,UFU TORNU,59,65,84,34,6,124,108,16,114,10,6,7,34,29,19,14,7,8,0,11,51,46,108
20210301,01MAR2021:00:00:00,UFU VELEZ SARSFIELD,109,81,133,54,3,190,184,6,190,0,0,6,48,43,40,28,14,11,0,30,77,77,184
20210301,01MAR2021:00:00:00,UFU ZUBIZARRETA,108,104,107,101,4,212,188,24,212,0,0,4,49,38,37,40,21,23,0,21,92,75,188
20210302,02MAR2021:00:00:00,UFU ALVAREZ,138,130,193,55,20,268,240,28,248,20,11,27,59,58,36,35,26,16,0,35,106,99,240
20210302,02MAR2021:00:00:00,UFU ARGERICH,33,24,32,23,2,57,37,20,37,20,0,5,10,15,8,4,10,5,0,7,15,15,37
20210302,02MAR2021:00:00:00,UFU BORDA-MOYANO,54,50,49,51,4,104,104,0,104,0,0,8,34,6,31,15,10,0,0,5,56,43,104
20210302,02MAR2021:00:00:00,UFU DURAND,85,80,131,30,4,165,161,4,161,4,9,16,40,30,30,12,12,16,0,20,77,64,161
20210302,02MAR2021:00:00:00,UFU ELIZALDE,104,85,67,119,3,189,141,48,185,4,77,56,16,20,2,14,4,0,0,3,87,51,141
20210302,02MAR2021:00:00:00,UFU FERNANDEZ,60,46,70,28,8,106,82,24,94,12,0,4,33,28,19,12,8,2,0,13,36,33,82
20210302,02MAR2021:00:00:00,UFU FERRER,48,55,50,52,1,103,99,4,99,4,0,0,18,33,25,13,7,7,0,14,40,45,99
20210302,02MAR2021:00:00:00,UFU GRIERSON,106,84,92,94,4,190,174,16,190,0,0,8,48,41,43,33,17,0,0,21,84,69,174
20210302,02MAR2021:00:00:00,UFU GUTIERREZ,81,76,104,53,0,157,133,24,155,2,66,23,12,20,22,9,4,1,0,11,69,50,133
20210302,02MAR2021:00:00:00,UFU MUÑIZ,188,287,173,256,46,475,365,110,385,90,0,13,125,146,70,64,48,9,0,36,215,113,365
20210302,02MAR2021:00:00:00,UFU PENNA,24,33,36,21,0,57,53,4,53,4,0,2,16,18,11,1,9,0,0,2,32,19,53
20210302,02MAR2021:00:00:00,UFU PIROVANO,132,108,202,36,2,240,234,6,240,0,0,7,53,84,36,26,20,14,0,15,115,104,234
20210302,02MAR2021:00:00:00,UFU PIÑERO,89,109,104,63,31,198,186,12,186,12,0,0,66,48,42,23,10,9,0,22,115,49,186
20210302,02MAR2021:00:00:00,UFU RAMOS MEJIA,88,64,99,36,17,152,120,32,124,28,6,8,32,42,24,22,11,7,0,11,56,53,120
20210302,02MAR2021:00:00:00,UFU RIVADAVIA,147,139,165,77,44,286,262,24,266,20,0,6,89,79,38,52,14,8,0,20,138,104,262
20210302,02MAR2021:00:00:00,UFU SANTOJANNI,107,93,107,87,6,200,174,26,198,2,2,8,52,53,29,37,13,6,0,23,74,77,174
20210302,02MAR2021:00:00:00,UFU TORNU,46,43,52,32,5,89,73,16,77,12,3,2,19,30,9,13,7,6,0,5,40,28,73
20210302,02MAR2021:00:00:00,UFU VELEZ SARSFIELD,73,54,82,45,0,127,123,4,127,0,0,3,32,39,26,10,13,4,0,7,66,50,123
20210302,02MAR2021:00:00:00,UFU ZUBIZARRETA,75,78,94,58,1,153,149,4,153,0,0,6,29,41,26,23,19,9,0,13,76,60,149
20210303,03MAR2021:00:00:00,UFU ALVAREZ,138,118,186,49,21,256,210,46,210,46,4,24,70,63,39,27,19,10,0,30,98,80,210
20210303,03MAR2021:00:00:00,UFU ARGERICH,42,47,45,41,3,89,59,30,59,30,1,5,25,16,17,16,6,3,0,11,22,26,59
20210303,03MAR2021:00:00:00,UFU BORDA-MOYANO,41,25,32,34,0,66,64,2,64,2,2,10,9,17,14,3,11,0,0,4,35,25,64
20210303,03MAR2021:00:00:00,UFU DURAND,95,96,168,23,0,191,183,8,187,4,4,9,59,56,26,24,12,1,0,27,94,62,183
20210303,03MAR2021:00:00:00,UFU ELIZALDE,81,66,57,88,2,147,121,26,135,12,53,44,11,18,7,6,7,1,0,1,73,47,121
20210303,03MAR2021:00:00:00,UFU FERNANDEZ,47,48,83,10,2,95,79,16,93,2,0,2,17,42,8,16,6,4,0,14,34,31,79
20210303,03MAR2021:00:00:00,UFU FERRER,51,27,50,28,0,78,78,0,78,0,0,0,17,18,16,14,10,3,0,17,32,29,78
20210303,03MAR2021:00:00:00,UFU GRIERSON,92,76,83,85,0,168,164,4,164,4,0,18,45,43,35,14,10,3,0,25,73,66,164
20210303,03MAR2021:00:00:00,UFU GUTIERREZ,85,59,95,49,0,144,122,22,144,0,47,39,18,21,7,10,2,0,0,5,63,53,122
20210303,03MAR2021:00:00:00,UFU MUÑIZ,234,257,200,271,20,491,341,150,357,134,0,4,124,127,84,90,42,20,0,34,204,103,341
20210303,03MAR2021:00:00:00,UFU PENNA,58,39,61,30,6,97,75,22,83,14,4,0,20,19,18,9,20,7,0,6,40,29,75
20210303,03MAR2021:00:00:00,UFU PIROVANO,164,106,208,54,8,270,226,44,260,10,0,7,76,69,50,26,16,26,0,22,112,92,226
20210303,03MAR2021:00:00:00,UFU PIÑERO,97,112,134,50,25,209,199,10,201,8,2,10,57,58,39,21,18,4,0,22,117,55,199
20210303,03MAR2021:00:00:00,UFU RAMOS MEJIA,111,106,133,68,16,217,179,38,207,10,14,20,54,54,37,19,5,14,0,15,81,83,179
20210303,03MAR2021:00:00:00,UFU RIVADAVIA,186,108,200,56,38,294,272,22,274,20,0,1,107,78,39,41,16,12,0,35,122,113,272
20210303,03MAR2021:00:00:00,UFU SANTOJANNI,124,146,172,97,1,270,234,36,266,4,6,9,55,77,48,28,32,15,0,27,108,99,234
20210303,03MAR2021:00:00:00,UFU TORNU,39,38,63,10,4,77,67,10,71,6,2,11,13,20,7,10,11,3,0,10,31,26,67
20210303,03MAR2021:00:00:00,UFU VELEZ SARSFIELD,73,88,124,35,2,161,149,12,157,4,0,4,35,43,25,28,19,7,0,29,60,60,149
20210303,03MAR2021:00:00:00,UFU ZUBIZARRETA,95,100,109,80,6,195,185,10,195,0,0,6,44,36,46,33,18,12,0,27,85,73,185
20210304,04MAR2021:00:00:00,UFU ALVAREZ,123,111,169,51,14,234,194,40,194,40,9,16,54,58,38,29,19,11,0,25,89,80,194
20210304,04MAR2021:00:00:00,UFU ARGERICH,50,35,43,36,6,85,71,14,75,10,2,9,24,17,17,6,8,2,0,9,30,32,71
20210304,04MAR2021:00:00:00,UFU BORDA-MOYANO,41,48,53,30,6,89,89,0,89,0,1,6,17,19,18,15,11,2,0,5,49,35,89
20210304,04MAR2021:00:00:00,UFU DURAND,92,64,130,21,5,156,140,16,140,16,2,6,43,44,13,27,12,9,0,25,65,50,140
20210304,04MAR2021:00:00:00,UFU ELIZALDE,79,71,57,92,1,150,120,30,140,10,55,42,11,23,6,8,5,0,0,6,72,42,120
20210304,04MAR2021:00:00:00,UFU FERNANDEZ,162,129,224,56,11,291,125,166,277,14,0,3,81,107,41,33,19,7,0,8,62,55,125
20210304,04MAR2021:00:00:00,UFU FERRER,48,41,43,42,4,89,85,4,85,4,0,0,21,27,22,13,3,3,0,16,38,31,85
20210304,04MAR2021:00:00:00,UFU GRIERSON,98,81,85,92,2,179,177,2,177,2,0,18,30,55,53,10,5,8,0,25,77,75,177
20210304,04MAR2021:00:00:00,UFU GUTIERREZ,97,58,95,59,1,155,107,48,137,18,51,26,21,21,17,19,0,0,0,7,52,47,107
20210304,04MAR2021:00:00:00,UFU MUÑIZ,246,267,183,304,26,513,367,146,391,122,0,10,111,130,104,80,65,13,0,32,225,110,367
20210304,04MAR2021:00:00:00,UFU PENNA,34,25,24,33,2,59,47,12,51,8,0,5,18,15,7,8,6,0,0,2,24,20,47
20210304,04MAR2021:00:00:00,UFU PIROVANO,126,125,201,42,8,251,207,44,243,8,2,5,70,75,38,22,21,18,0,32,88,86,207
20210304,04MAR2021:00:00:00,UFU PIÑERO,82,78,133,19,8,160,148,12,154,6,0,0,40,49,24,25,12,10,0,11,93,43,148
20210304,04MAR2021:00:00:00,UFU RAMOS MEJIA,113,81,132,51,11,194,180,14,186,8,9,10,47,37,31,33,21,6,0,29,75,76,180
20210304,04MAR2021:00:00:00,UFU RIVADAVIA,124,125,146,65,38,249,221,28,221,28,0,3,91,68,35,26,21,5,0,23,112,83,221
20210304,04MAR2021:00:00:00,UFU SANTOJANNI,84,82,104,57,5,166,148,18,162,4,2,5,51,40,20,23,19,6,0,17,69,62,148
20210304,04MAR2021:00:00:00,UFU TORNU,45,36,62,16,3,81,75,6,77,4,4,3,21,14,20,4,9,6,0,4,41,30,75
20210215,15FEB2021:00:00:00,UFU GRIERSON,115,79,108,74,12,194,173,21,187,7,0,5,53,61,28,24,11,12,0,23,67,83,173
20210215,15FEB2021:00:00:00,UFU GUTIERREZ,36,26,27,31,4,62,60,2,62,0,25,3,9,7,13,3,2,0,0,4,30,26,60
20210215,15FEB2021:00:00:00,UFU MUÑIZ,99,115,102,107,5,214,164,50,174,40,0,5,67,44,43,42,5,8,0,10,109,45,164
20210215,15FEB2021:00:00:00,UFU PENNA,21,19,22,18,0,40,38,2,38,2,0,0,13,12,6,3,3,3,0,3,20,15,38
20210215,15FEB2021:00:00:00,UFU PIROVANO,82,56,117,16,5,138,128,10,136,2,0,0,30,48,27,24,9,0,0,15,60,53,128
20210215,15FEB2021:00:00:00,UFU PIÑERO,30,24,37,15,2,54,48,6,48,6,0,0,16,11,7,13,3,4,0,2,34,12,48
20210215,15FEB2021:00:00:00,UFU RAMOS MEJIA,46,34,55,25,0,80,68,12,68,12,1,13,19,18,10,11,4,4,0,11,21,36,68
20210215,15FEB2021:00:00:00,UFU RIVADAVIA,112,65,120,41,16,177,163,14,169,8,0,2,47,36,33,23,25,11,0,19,71,73,163
20210215,15FEB2021:00:00:00,UFU SANTOJANNI,65,43,65,37,6,108,100,8,104,4,0,5,31,21,19,18,13,1,0,20,40,40,100
20210215,15FEB2021:00:00:00,UFU TORNU,25,40,47,16,2,65,63,2,65,0,4,3,7,7,11,13,13,7,0,14,20,28,63
20210215,15FEB2021:00:00:00,UFU VELEZ SARSFIELD,83,64,104,43,0,147,145,2,145,2,0,0,32,34,25,34,19,3,0,26,56,63,145
20210215,15FEB2021:00:00:00,UFU ZUBIZARRETA,95,89,118,58,8,184,162,22,178,6,0,1,49,41,31,27,22,13,0,21,80,61,162
20210216,16FEB2021:00:00:00,UFU ALVAREZ,66,85,98,46,7,151,143,8,143,8,6,12,31,41,16,33,11,1,0,9,68,66,143
20210216,16FEB2021:00:00:00,UFU ARGERICH,0,1,0,1,0,1,1,0,1,0,0,0,0,1,0,0,0,0,0,0,1,0,1
20210216,16FEB2021:00:00:00,UFU BORDA-MOYANO,13,18,17,13,1,31,31,0,31,0,0,0,7,4,0,12,8,0,0,0,21,10,31
20210216,16FEB2021:00:00:00,UFU DURAND,87,60,121,14,12,147,137,10,139,8,1,0,29,47,33,15,14,8,0,11,88,38,137
20210216,16FEB2021:00:00:00,UFU ELIZALDE,56,38,26,64,4,94,68,26,88,6,48,18,10,14,4,0,0,0,0,1,44,23,68
20210216,16FEB2021:00:00:00,UFU FERNANDEZ,110,90,169,31,0,200,66,134,196,4,0,2,56,55,29,38,16,4,0,7,29,30,66
20210216,16FEB2021:00:00:00,UFU FERRER,30,34,25,37,2,64,60,4,60,4,0,0,18,13,14,12,5,2,0,10,25,25,60
20210216,16FEB2021:00:00:00,UFU GRIERSON,74,55,44,79,6,129,119,10,129,0,0,3,34,27,24,19,17,5,0,12,58,49,119
20210216,16FEB2021:00:00:00,UFU GUTIERREZ,46,31,28,47,2,77,71,6,77,0,34,19,8,10,2,2,2,0,0,1,43,26,71
20210216,16FEB2021:00:00:00,UFU MUÑIZ,141,156,121,163,13,297,215,82,227,70,0,10,91,75,38,46,30,7,0,22,126,67,215
20210216,16FEB2021:00:00:00,UFU PENNA,13,20,23,10,0,33,33,0,33,0,0,3,4,5,9,6,6,0,0,6,13,14,33
20210216,16FEB2021:00:00:00,UFU PIROVANO,67,83,112,36,2,150,142,8,146,4,0,0,32,46,38,17,9,8,0,21,64,57,142
20210216,16FEB2021:00:00:00,UFU PIÑERO,40,46,48,34,4,86,82,4,86,0,0,3,30,25,3,15,6,4,0,7,51,24,82
20210216,16FEB2021:00:00:00,UFU RAMOS MEJIA,52,41,71,20,2,93,71,22,71,22,0,9,31,23,9,19,0,2,0,14,27,30,71
20210216,16FEB2021:00:00:00,UFU RIVADAVIA,127,89,158,44,14,216,208,8,208,8,1,7,82,51,34,28,10,3,0,19,99,87,208
20210216,16FEB2021:00:00:00,UFU SANTOJANNI,53,55,54,54,0,108,104,4,106,2,0,1,28,30,21,16,7,5,0,20,38,46,104
20210216,16FEB2021:00:00:00,UFU TORNU,41,41,32,39,11,82,74,8,76,6,1,12,13,19,20,12,5,0,0,14,31,29,74
20210216,16FEB2021:00:00:00,UFU VELEZ SARSFIELD,81,74,112,41,2,155,151,4,151,4,0,3,34,50,18,25,21,4,0,16,74,61,151
20210216,16FEB2021:00:00:00,UFU ZUBIZARRETA,99,81,119,56,5,180,166,14,172,8,0,0,43,29,51,29,11,17,0,22,74,70,166
20210217,17FEB2021:00:00:00,UFU ALVAREZ,87,134,153,56,12,221,203,18,205,16,9,15,42,52,47,20,31,5,0,20,96,86,203
20210217,17FEB2021:00:00:00,UFU ARGERICH,28,34,34,23,5,62,48,14,48,14,4,0,16,25,10,2,0,5,0,3,24,21,48
20210217,17FEB2021:00:00:00,UFU BORDA-MOYANO,85,38,55,39,29,123,113,10,113,10,0,4,31,13,29,24,18,4,0,1,67,45,113
20210217,17FEB2021:00:00:00,UFU DURAND,141,139,226,47,7,280,272,8,274,6,2,8,92,95,40,23,15,5,0,28,155,89,272
20210217,17FEB2021:00:00:00,UFU ELIZALDE,91,44,39,87,9,135,115,20,131,4,37,47,18,14,7,5,7,0,0,6,64,45,115
20210217,17FEB2021:00:00:00,UFU FERNANDEZ,72,56,100,26,2,128,84,44,128,0,2,4,24,39,25,27,2,5,0,12,35,37,84
20210217,17FEB2021:00:00:00,UFU FERRER,39,15,28,24,2,54,52,2,52,2,0,2,23,6,21,2,0,0,0,7,23,22,52
20210217,17FEB2021:00:00:00,UFU GRIERSON,97,96,80,113,0,193,185,8,187,6,0,2,50,59,47,27,4,4,0,2,3,180,185
20210217,17FEB2021:00:00:00,UFU GUTIERREZ,61,75,87,49,0,136,120,16,134,2,42,31,20,20,16,6,1,0,0,8,65,47,120
20210217,17FEB2021:00:00:00,UFU MUÑIZ,196,215,194,208,9,411,355,56,363,48,0,17,95,119,89,42,35,14,0,27,229,99,355
20210217,17FEB2021:00:00:00,UFU PENNA,18,33,41,10,0,51,35,16,45,6,0,0,6,18,16,6,5,0,0,5,17,13,35
20210217,17FEB2021:00:00:00,UFU PIROVANO,111,151,189,69,4,262,242,20,248,14,0,5,67,89,60,19,11,11,0,21,123,98,242
20210217,17FEB2021:00:00:00,UFU PIÑERO,90,67,115,34,8,157,149,8,149,8,0,4,42,37,24,28,14,8,0,13,101,35,149
20210217,17FEB2021:00:00:00,UFU RAMOS MEJIA,83,48,76,45,10,131,111,20,125,6,7,7,41,19,21,13,12,11,0,15,49,47,111
20210217,17FEB2021:00:00:00,UFU RIVADAVIA,185,158,219,93,31,343,303,40,323,20,0,19,97,88,55,52,27,5,0,44,142,114,303
20210217,17FEB2021:00:00:00,UFU SANTOJANNI,83,96,86,87,6,179,167,12,177,2,2,7,43,40,50,31,4,2,0,17,84,66,167
20210217,17FEB2021:00:00:00,UFU TORNU,61,44,76,23,6,105,97,8,97,8,0,3,20,34,16,18,2,12,0,20,35,42,97
20210217,17FEB2021:00:00:00,UFU VELEZ SARSFIELD,82,82,109,51,4,164,158,6,160,4,0,8,46,29,33,25,16,7,0,19,71,68,158
20210217,17FEB2021:00:00:00,UFU ZUBIZARRETA,81,73,84,65,5,154,152,2,154,0,0,5,22,50,20,30,19,8,0,18,75,59,152
20210218,18FEB2021:00:00:00,UFU ALVAREZ,112,92,153,47,4,204,180,24,182,22,4,8,47,53,29,30,22,11,0,17,81,82,180
20210218,18FEB2021:00:00:00,UFU ARGERICH,27,41,38,30,0,68,62,6,62,6,6,0,19,18,10,9,6,0,0,7,27,28,62
20210218,18FEB2021:00:00:00,UFU BORDA-MOYANO,44,38,44,36,2,82,80,2,80,2,0,9,22,8,18,16,7,2,0,6,44,30,80
20210218,18FEB2021:00:00:00,UFU DURAND,144,120,234,29,1,264,258,6,258,6,5,18,76,74,39,32,15,5,0,31,141,86,258
20210218,18FEB2021:00:00:00,UFU ELIZALDE,96,60,53,98,5,156,124,32,148,8,52,61,6,18,9,9,1,0,0,2,72,50,124
20210218,18FEB2021:00:00:00,UFU FERNANDEZ,62,52,85,20,9,114,84,30,108,6,0,0,40,32,15,14,7,6,0,17,36,31,84
20210218,18FEB2021:00:00:00,UFU FERRER,30,27,27,29,1,57,57,0,57,0,0,0,8,23,13,10,1,2,0,11,24,22,57
20210218,18FEB2021:00:00:00,UFU GRIERSON,118,86,112,90,2,204,198,6,198,6,0,3,52,50,58,22,11,8,0,36,87,75,198
20210218,18FEB2021:00:00:00,UFU GUTIERREZ,65,47,74,36,2,112,96,16,110,2,43,12,22,23,5,0,2,5,0,4,54,37,96
20210218,18FEB2021:00:00:00,UFU MUÑIZ,203,242,169,259,17,445,327,118,341,104,0,21,109,125,96,52,25,17,0,24,217,86,327
20210218,18FEB2021:00:00:00,UFU PENNA,25,37,32,27,3,62,42,20,62,0,2,12,5,16,12,2,13,0,0,9,17,16,42
20210218,18FEB2021:00:00:00,UFU PIROVANO,161,117,230,43,5,278,230,48,266,12,0,11,73,80,45,31,17,21,0,18,118,94,230
20210218,18FEB2021:00:00:00,UFU PIÑERO,78,50,82,33,13,128,118,10,122,6,0,1,30,35,23,23,11,5,0,14,69,35,118
20210218,18FEB2021:00:00:00,UFU RAMOS MEJIA,66,68,89,34,11,134,118,16,134,0,2,9,19,24,19,32,17,12,0,6,57,55,118
20210218,18FEB2021:00:00:00,UFU RIVADAVIA,179,133,219,67,26,312,296,16,298,14,0,6,100,66,47,40,34,19,0,28,138,126,296
20210218,18FEB2021:00:00:00,UFU SANTOJANNI,57,53,59,50,1,110,102,8,108,2,0,4,21,36,14,18,15,2,0,14,48,40,102
20210218,18FEB2021:00:00:00,UFU TORNU,49,48,71,21,5,97,81,16,89,8,3,7,18,21,18,13,13,4,0,13,37,31,81
20210218,18FEB2021:00:00:00,UFU VELEZ SARSFIELD,90,122,151,55,6,212,162,50,212,0,0,5,48,56,55,26,20,2,0,21,76,65,162
20210218,18FEB2021:00:00:00,UFU ZUBIZARRETA,93,67,85,73,2,160,136,24,160,0,0,21,33,35,32,24,6,9,0,11,73,52,136
20210219,19FEB2021:00:00:00,UFU ALVAREZ,139,99,174,50,14,238,228,10,228,10,8,13,63,57,35,31,20,11,0,12,121,95,228
20210219,19FEB2021:00:00:00,UFU ARGERICH,46,36,57,22,3,82,60,22,60,22,6,2,20,20,13,10,9,2,0,8,19,33,60
20210219,19FEB2021:00:00:00,UFU BORDA-MOYANO,46,25,33,33,5,71,67,4,67,4,0,5,15,15,8,12,16,0,0,1,42,24,67
20210219,19FEB2021:00:00:00,UFU DURAND,122,105,200,27,0,227,219,8,219,8,8,9,43,79,49,11,18,10,0,35,116,68,219
20210219,19FEB2021:00:00:00,UFU ELIZALDE,54,58,33,75,4,112,78,34,100,12,47,25,12,16,9,1,2,0,0,0,43,35,78
20210219,19FEB2021:00:00:00,UFU FERNANDEZ,106,81,135,42,10,187,87,100,185,2,0,6,64,48,26,24,13,6,0,18,34,35,87
20210219,19FEB2021:00:00:00,UFU FERRER,42,46,53,32,3,88,84,4,84,4,0,2,26,19,27,6,4,4,0,8,40,36,84
20210219,19FEB2021:00:00:00,UFU GRIERSON,94,100,85,101,8,194,186,8,186,8,0,9,64,42,36,22,14,7,0,16,95,75,186
20210219,19FEB2021:00:00:00,UFU GUTIERREZ,43,54,77,18,2,97,83,14,95,2,24,25,10,26,8,4,0,0,0,3,41,38,83
20220327,27MAR2022:00:00:00,UFU GRIERSON,29,24,32,21,0,53,53,0,53,0,0,2,0,17,19,8,5,2,0,0,40,13,53
20210219,19FEB2021:00:00:00,UFU MUÑIZ,189,227,165,239,12,416,296,120,304,112,2,17,94,125,87,59,16,16,0,20,188,87,296
20210219,19FEB2021:00:00:00,UFU PENNA,48,14,36,22,4,62,48,14,60,2,0,2,13,9,7,17,7,7,0,7,22,19,48
20210219,19FEB2021:00:00:00,UFU PIROVANO,151,114,218,45,2,265,255,10,261,4,0,9,65,74,41,35,28,13,0,23,135,95,255
20210219,19FEB2021:00:00:00,UFU PIÑERO,89,85,126,38,10,174,170,4,170,4,0,3,23,62,34,22,18,12,0,11,112,46,170
20210219,19FEB2021:00:00:00,UFU RAMOS MEJIA,56,53,72,31,6,109,99,10,107,2,6,6,18,21,29,8,16,5,0,5,49,45,99
20210219,19FEB2021:00:00:00,UFU RIVADAVIA,196,147,220,93,30,343,295,48,317,26,4,10,70,90,81,35,30,23,0,23,144,127,295
20210219,19FEB2021:00:00:00,UFU SANTOJANNI,77,77,79,68,7,154,144,10,152,2,0,3,34,40,26,21,19,11,0,15,72,57,144
20210219,19FEB2021:00:00:00,UFU TORNU,39,39,47,27,4,78,70,8,74,4,2,7,13,24,13,11,8,0,0,8,32,30,70
20210219,19FEB2021:00:00:00,UFU VELEZ SARSFIELD,74,66,110,29,1,140,136,4,140,0,0,4,39,45,23,22,4,3,0,18,39,79,136
20210219,19FEB2021:00:00:00,UFU ZUBIZARRETA,114,111,125,85,15,225,207,18,225,0,0,2,44,63,39,33,31,13,0,25,98,84,207
20210220,20FEB2021:00:00:00,UFU ALVAREZ,86,84,119,43,8,170,170,0,170,0,0,7,38,40,36,18,22,9,0,22,77,71,170
20210220,20FEB2021:00:00:00,UFU BORDA-MOYANO,37,21,30,22,6,58,51,7,51,7,0,3,13,9,17,7,5,4,0,7,25,19,51
20210220,20FEB2021:00:00:00,UFU DURAND,91,51,132,10,0,142,142,0,142,0,3,8,33,45,26,17,5,5,0,20,79,43,142
20210220,20FEB2021:00:00:00,UFU ELIZALDE,62,40,26,76,0,102,60,42,98,4,56,24,8,4,7,3,0,0,0,1,39,20,60
20210220,20FEB2021:00:00:00,UFU FERNANDEZ,95,102,157,38,2,197,83,114,187,10,0,6,56,49,31,33,18,4,0,12,32,39,83
20210220,20FEB2021:00:00:00,UFU FERRER,14,23,19,18,0,37,27,10,27,10,0,0,11,9,12,3,2,0,0,3,13,11,27
20210220,20FEB2021:00:00:00,UFU GRIERSON,92,75,81,78,8,167,151,16,163,4,0,8,42,57,22,23,14,1,0,16,71,64,151
20210220,20FEB2021:00:00:00,UFU GUTIERREZ,21,35,35,21,0,56,50,6,56,0,21,16,7,8,3,0,1,0,0,10,15,25,50
20210220,20FEB2021:00:00:00,UFU MUÑIZ,152,187,158,173,8,339,251,88,257,82,0,12,93,92,53,48,35,6,0,23,161,67,251
20210220,20FEB2021:00:00:00,UFU PENNA,14,15,19,8,2,29,25,4,25,4,0,2,5,2,9,3,7,1,0,3,12,10,25
20210220,20FEB2021:00:00:00,UFU PIROVANO,103,106,162,33,14,209,193,16,201,8,0,0,56,53,49,32,14,5,0,14,99,80,193
20210220,20FEB2021:00:00:00,UFU PIÑERO,110,77,123,41,23,187,183,4,183,4,0,8,47,52,40,21,10,9,0,12,122,49,183
20210220,20FEB2021:00:00:00,UFU RAMOS MEJIA,49,53,58,11,33,102,92,10,100,2,1,2,33,22,11,19,10,4,0,12,39,41,92
20210220,20FEB2021:00:00:00,UFU RIVADAVIA,153,128,216,50,15,281,161,120,161,120,0,7,97,87,27,27,28,8,0,13,76,71,161
20210220,20FEB2021:00:00:00,UFU SANTOJANNI,89,70,90,67,2,159,151,8,157,2,2,8,27,29,35,29,19,10,0,15,75,61,151
20210220,20FEB2021:00:00:00,UFU TORNU,67,43,60,31,19,110,104,6,104,6,0,9,20,37,19,20,5,0,0,10,51,42,104
20210220,20FEB2021:00:00:00,UFU VELEZ SARSFIELD,102,103,156,47,2,205,201,4,205,0,0,10,48,49,35,34,19,10,0,22,76,103,201
20210220,20FEB2021:00:00:00,UFU ZUBIZARRETA,127,112,157,66,16,239,197,42,229,10,0,6,47,53,57,36,28,12,0,25,91,81,197
20210221,21FEB2021:00:00:00,UFU ALVAREZ,96,66,133,24,5,162,148,14,148,14,6,11,35,34,20,36,10,10,0,23,64,61,148
20210221,21FEB2021:00:00:00,UFU ARGERICH,28,25,25,28,0,53,51,2,53,0,1,3,9,17,5,9,9,0,0,6,13,32,51
20210221,21FEB2021:00:00:00,UFU BORDA-MOYANO,12,8,11,9,0,20,20,0,20,0,0,0,9,3,4,2,2,0,0,1,10,9,20
20210221,21FEB2021:00:00:00,UFU ELIZALDE,64,42,28,74,4,106,66,40,100,6,55,18,11,15,5,1,0,1,0,1,41,24,66
20210221,21FEB2021:00:00:00,UFU FERNANDEZ,71,70,119,22,0,141,81,60,141,0,0,2,38,42,23,23,12,1,0,15,38,28,81
20210221,21FEB2021:00:00:00,UFU FERRER,26,27,30,23,0,53,51,2,51,2,0,0,22,10,11,5,3,2,0,14,17,20,51
20210221,21FEB2021:00:00:00,UFU GRIERSON,85,62,93,50,4,147,141,6,147,0,0,9,33,36,34,19,9,7,0,10,74,57,141
20210221,21FEB2021:00:00:00,UFU GUTIERREZ,30,44,40,34,0,74,74,0,74,0,33,15,9,7,10,0,0,0,0,0,39,35,74
20210221,21FEB2021:00:00:00,UFU MUÑIZ,155,120,114,150,11,275,215,60,241,34,0,11,82,55,59,32,27,9,0,23,126,66,215
20210221,21FEB2021:00:00:00,UFU PENNA,29,17,26,20,0,46,40,6,44,2,0,1,6,11,14,5,3,6,0,2,21,17,40
20210221,21FEB2021:00:00:00,UFU PIROVANO,106,87,168,17,8,193,153,40,187,6,0,0,38,44,39,28,27,17,0,19,68,66,153
20210221,21FEB2021:00:00:00,UFU PIÑERO,77,59,91,37,8,136,128,8,132,4,0,3,25,19,35,30,13,11,0,11,85,32,128
20210221,21FEB2021:00:00:00,UFU RAMOS MEJIA,49,41,78,12,0,90,86,4,88,2,2,3,23,26,11,17,3,5,0,14,37,35,86
20210221,21FEB2021:00:00:00,UFU RIVADAVIA,124,60,146,26,12,184,172,12,172,12,0,4,51,46,35,21,16,11,0,26,80,66,172
20210221,21FEB2021:00:00:00,UFU SANTOJANNI,61,46,71,36,0,107,101,6,107,0,2,6,23,18,19,17,17,5,0,9,52,40,101
20210221,21FEB2021:00:00:00,UFU TORNU,41,51,49,32,11,92,86,6,90,2,0,2,17,28,26,16,3,0,0,14,32,40,86
20210221,21FEB2021:00:00:00,UFU VELEZ SARSFIELD,86,54,100,38,2,140,134,6,138,2,0,4,44,22,27,28,10,5,0,18,61,55,134
20210221,21FEB2021:00:00:00,UFU ZUBIZARRETA,118,81,114,63,22,199,155,44,193,6,0,9,47,64,27,21,13,18,0,22,70,63,155
20210222,22FEB2021:00:00:00,UFU ALVAREZ,136,141,206,60,11,277,167,110,173,104,25,19,74,50,42,24,27,16,0,21,76,70,167
20210222,22FEB2021:00:00:00,UFU ARGERICH,29,28,34,21,2,57,47,10,47,10,4,0,14,21,4,9,4,1,0,7,19,20,47
20210222,22FEB2021:00:00:00,UFU BORDA-MOYANO,34,52,45,39,2,86,78,8,78,8,0,3,22,16,16,22,7,0,0,3,46,29,78
20210222,22FEB2021:00:00:00,UFU DURAND,150,76,182,42,2,226,192,34,220,6,3,8,38,63,35,38,25,16,0,33,75,83,192
20210222,22FEB2021:00:00:00,UFU ELIZALDE,76,65,34,106,1,141,119,22,135,6,49,26,14,18,16,8,4,6,0,1,67,51,119
20210222,22FEB2021:00:00:00,UFU FERNANDEZ,124,96,185,31,4,220,148,72,210,10,0,4,64,61,48,26,12,5,0,18,67,63,148
20210222,22FEB2021:00:00:00,UFU FERRER,74,46,50,67,3,120,120,0,120,0,0,0,28,26,29,23,11,3,0,15,58,47,120
20210222,22FEB2021:00:00:00,UFU GRIERSON,103,83,87,91,8,186,126,60,148,38,0,11,44,38,47,31,11,4,0,19,61,46,126
20210222,22FEB2021:00:00:00,UFU GUTIERREZ,65,59,58,65,1,124,104,20,120,4,47,29,18,15,10,4,0,1,0,3,62,39,104
20210222,22FEB2021:00:00:00,UFU MUÑIZ,192,170,162,187,13,362,310,52,320,42,0,4,95,131,61,36,29,6,0,21,200,89,310
20210222,22FEB2021:00:00:00,UFU PENNA,30,24,29,21,4,54,44,10,44,10,0,0,13,14,7,7,12,1,0,2,25,17,44
20210222,22FEB2021:00:00:00,UFU PIROVANO,110,103,165,44,4,213,205,8,209,4,2,4,58,45,48,31,13,12,0,20,97,88,205
20210222,22FEB2021:00:00:00,UFU PIÑERO,75,81,83,68,5,156,142,14,150,6,4,7,42,28,39,23,9,4,0,13,83,46,142
20210222,22FEB2021:00:00:00,UFU RAMOS MEJIA,52,62,76,19,19,114,92,22,108,6,7,6,25,43,15,10,4,4,0,9,50,33,92
20210222,22FEB2021:00:00:00,UFU RIVADAVIA,187,98,197,62,26,285,191,94,195,90,0,8,93,93,32,36,19,4,0,11,101,79,191
20210222,22FEB2021:00:00:00,UFU SANTOJANNI,80,79,98,56,5,159,153,6,157,2,0,10,36,32,24,26,19,12,0,19,70,64,153
20210222,22FEB2021:00:00:00,UFU TORNU,41,36,52,14,11,77,69,8,75,2,4,8,16,15,11,8,12,3,0,7,33,29,69
20210222,22FEB2021:00:00:00,UFU VELEZ SARSFIELD,92,122,156,48,10,214,192,22,214,0,5,7,42,45,40,38,20,17,0,25,93,74,192
20210222,22FEB2021:00:00:00,UFU ZUBIZARRETA,96,97,136,55,2,193,185,8,193,0,0,9,43,33,47,37,18,6,0,17,99,69,185
20210223,23FEB2021:00:00:00,UFU ALVAREZ,82,77,104,47,8,159,151,8,151,8,5,6,32,38,17,26,18,17,0,16,71,64,151
20210223,23FEB2021:00:00:00,UFU ARGERICH,29,45,39,32,3,74,48,26,48,26,4,2,21,12,16,9,6,4,0,7,22,18,48
20210223,23FEB2021:00:00:00,UFU BORDA-MOYANO,35,21,24,32,0,56,54,2,54,2,0,6,7,3,15,12,10,3,0,1,35,18,54
20210223,23FEB2021:00:00:00,UFU DURAND,71,70,115,22,4,141,139,2,139,2,0,5,31,41,27,20,8,9,0,27,61,51,139
20210223,23FEB2021:00:00:00,UFU ELIZALDE,78,57,32,100,3,135,115,20,133,2,49,26,10,25,12,11,2,0,0,3,68,44,115
20210223,23FEB2021:00:00:00,UFU FERNANDEZ,136,126,205,49,8,262,158,104,260,2,0,2,85,86,44,30,8,7,0,16,70,72,158
20210223,23FEB2021:00:00:00,UFU FERRER,45,37,39,42,1,82,74,8,74,8,0,6,20,19,16,17,1,3,0,9,26,39,74
20210223,23FEB2021:00:00:00,UFU GRIERSON,79,91,84,83,3,170,168,2,168,2,0,16,39,50,21,29,13,2,0,27,74,67,168
20210223,23FEB2021:00:00:00,UFU GUTIERREZ,85,74,94,60,5,159,145,14,153,6,50,35,16,29,15,7,5,2,0,9,70,66,145
20210223,23FEB2021:00:00:00,UFU MUÑIZ,196,197,171,214,8,393,283,110,297,96,2,14,89,115,86,49,28,10,0,24,177,82,283
20210223,23FEB2021:00:00:00,UFU PENNA,27,25,31,19,2,52,36,16,52,0,0,0,7,11,14,4,10,6,0,4,19,13,36
20210223,23FEB2021:00:00:00,UFU PIROVANO,179,118,225,58,14,297,271,26,291,6,0,4,68,92,47,54,23,9,0,33,123,115,271
20210223,23FEB2021:00:00:00,UFU PIÑERO,100,94,133,59,2,194,185,9,191,3,4,9,60,55,18,36,10,2,0,6,136,43,185
20210223,23FEB2021:00:00:00,UFU RAMOS MEJIA,70,68,70,59,9,138,134,4,136,2,4,15,32,24,24,15,13,11,0,11,60,63,134
20210223,23FEB2021:00:00:00,UFU RIVADAVIA,130,129,168,58,33,259,231,28,233,26,0,6,71,71,37,39,24,11,0,22,105,103,231
20210223,23FEB2021:00:00:00,UFU SANTOJANNI,87,91,84,88,6,178,158,20,170,8,2,9,34,49,37,24,15,8,0,13,77,68,158
20210223,23FEB2021:00:00:00,UFU TORNU,56,36,56,26,10,92,82,10,84,8,0,6,10,26,18,17,4,11,0,8,38,36,82
20210223,23FEB2021:00:00:00,UFU VELEZ SARSFIELD,108,84,129,61,2,192,172,20,186,6,0,1,50,42,35,34,18,12,0,18,88,66,172
20210223,23FEB2021:00:00:00,UFU ZUBIZARRETA,34,43,44,32,1,77,77,0,77,0,0,0,21,26,13,6,10,1,0,12,36,29,77
20210224,24FEB2021:00:00:00,UFU ALVAREZ,107,117,142,47,35,224,194,30,194,30,8,15,62,51,33,16,20,19,0,24,82,88,194
20210224,24FEB2021:00:00:00,UFU ARGERICH,38,43,47,28,6,81,57,24,61,20,2,7,22,14,5,15,8,8,0,1,32,24,57
20210224,24FEB2021:00:00:00,UFU BORDA-MOYANO,71,41,40,72,0,112,108,4,108,4,0,10,10,18,29,32,8,5,0,8,60,40,108
20210224,24FEB2021:00:00:00,UFU DURAND,112,88,163,32,5,200,196,4,196,4,5,2,51,62,39,29,9,3,0,19,111,66,196
20210224,24FEB2021:00:00:00,UFU ELIZALDE,56,54,24,84,2,110,90,20,100,10,34,26,17,11,6,10,4,2,0,4,54,32,90
20210224,24FEB2021:00:00:00,UFU FERNANDEZ,163,111,201,65,8,274,166,108,256,18,0,6,85,84,27,44,13,15,0,21,74,71,166
20210224,24FEB2021:00:00:00,UFU FERRER,41,36,35,42,0,77,73,4,73,4,0,0,29,21,9,14,4,0,0,12,31,30,73
20210224,24FEB2021:00:00:00,UFU GRIERSON,95,62,70,81,6,157,149,8,149,8,0,9,52,41,23,19,10,3,0,22,71,56,149
20210224,24FEB2021:00:00:00,UFU GUTIERREZ,62,34,63,33,0,96,49,47,87,9,46,14,7,16,5,6,0,2,0,1,27,21,49
20210224,24FEB2021:00:00:00,UFU MUÑIZ,202,224,167,237,22,426,306,120,322,104,0,8,122,124,68,57,34,13,0,21,197,88,306
20210224,24FEB2021:00:00:00,UFU PENNA,31,14,21,20,4,45,43,2,45,0,0,1,9,6,7,10,10,2,0,2,26,15,43
20210224,24FEB2021:00:00:00,UFU PIROVANO,140,141,193,70,18,281,269,12,273,8,0,5,78,68,62,40,16,12,0,28,130,111,269
20210224,24FEB2021:00:00:00,UFU PIÑERO,64,57,84,18,19,121,105,16,117,4,8,3,28,29,30,12,8,3,0,16,58,30,105
20210224,24FEB2021:00:00:00,UFU RAMOS MEJIA,68,48,68,35,13,116,108,8,114,2,7,4,18,33,20,14,15,5,0,10,56,42,108
20210224,24FEB2021:00:00:00,UFU RIVADAVIA,127,79,135,55,16,206,182,24,188,18,0,7,44,41,59,34,14,7,0,19,91,68,182
20210224,24FEB2021:00:00:00,UFU SANTOJANNI,116,64,106,68,6,180,168,12,178,2,0,12,52,33,34,22,17,10,0,16,81,71,168
20210224,24FEB2021:00:00:00,UFU TORNU,49,56,75,27,3,105,87,18,95,10,7,13,24,27,16,8,6,4,0,7,41,39,87
20210224,24FEB2021:00:00:00,UFU VELEZ SARSFIELD,82,86,121,43,4,168,150,18,162,6,0,3,34,38,40,18,14,21,0,17,66,67,150
20210224,24FEB2021:00:00:00,UFU ZUBIZARRETA,43,33,37,39,0,76,76,0,76,0,0,11,18,15,18,12,2,0,0,8,29,39,76
20210225,25FEB2021:00:00:00,UFU ALVAREZ,108,133,183,44,14,241,231,10,231,10,12,15,44,60,31,39,24,16,0,35,93,103,231
20210225,25FEB2021:00:00:00,UFU ARGERICH,49,31,41,39,0,80,58,22,62,18,8,3,15,8,22,11,11,2,0,12,24,22,58
20210225,25FEB2021:00:00:00,UFU BORDA-MOYANO,70,48,54,62,2,118,112,6,112,6,0,10,33,29,21,15,7,3,0,6,61,45,112
20210225,25FEB2021:00:00:00,UFU DURAND,107,98,177,27,1,205,203,2,203,2,11,12,62,49,29,18,13,11,0,27,106,70,203
20210225,25FEB2021:00:00:00,UFU ELIZALDE,83,77,46,110,4,160,118,42,150,10,60,42,13,22,10,3,10,0,0,2,74,42,118
20210225,25FEB2021:00:00:00,UFU FERNANDEZ,151,149,246,44,10,300,108,192,290,10,0,1,85,94,54,27,21,18,0,12,54,42,108
20210225,25FEB2021:00:00:00,UFU FERRER,40,45,44,39,2,85,83,2,83,2,0,0,27,27,13,11,3,4,0,10,39,34,83
20210225,25FEB2021:00:00:00,UFU GRIERSON,143,110,128,121,4,253,239,14,249,4,0,11,91,63,50,27,7,4,0,1,1,237,239
20210225,25FEB2021:00:00:00,UFU GUTIERREZ,56,59,73,40,2,115,103,12,113,2,41,33,15,13,8,4,1,0,0,6,51,46,103
20210225,25FEB2021:00:00:00,UFU MUÑIZ,186,199,131,242,12,385,279,106,311,74,0,2,112,121,72,26,40,12,0,23,180,76,279
20210225,25FEB2021:00:00:00,UFU PENNA,50,25,52,21,2,75,45,30,69,6,0,3,10,20,10,13,9,10,0,6,21,17,45
20210225,25FEB2021:00:00:00,UFU PIROVANO,144,127,207,46,18,271,239,32,259,12,0,6,84,90,35,23,14,19,0,26,112,101,239
20210225,25FEB2021:00:00:00,UFU PIÑERO,88,69,84,60,13,157,151,6,157,0,0,5,44,42,24,28,9,5,0,26,81,42,151
20210225,25FEB2021:00:00:00,UFU RAMOS MEJIA,94,61,111,19,25,155,143,12,147,8,9,10,43,28,19,14,22,10,0,16,69,58,143
20210225,25FEB2021:00:00:00,UFU RIVADAVIA,144,119,171,69,23,263,251,12,251,12,0,1,85,71,36,27,22,21,0,28,123,100,251
20210225,25FEB2021:00:00:00,UFU SANTOJANNI,99,78,86,89,2,177,165,12,175,2,8,18,29,42,35,33,9,3,0,16,80,69,165
20210225,25FEB2021:00:00:00,UFU TORNU,64,49,80,24,9,113,101,12,107,6,3,10,28,31,10,15,13,3,0,14,43,44,101
20210225,25FEB2021:00:00:00,UFU VELEZ SARSFIELD,105,102,139,64,4,207,173,34,207,0,2,8,63,42,30,33,18,11,0,20,87,66,173
20210329,29MAR2021:00:00:00,UFU BORDA-MOYANO,26,32,44,14,0,58,56,2,56,2,0,0,12,19,14,10,1,2,0,7,25,24,56
20210329,29MAR2021:00:00:00,UFU DURAND,180,120,235,40,25,300,296,4,298,2,6,12,85,78,36,48,17,18,0,61,135,100,296
20210329,29MAR2021:00:00:00,UFU ELIZALDE,125,70,53,137,5,195,155,40,181,14,68,83,7,11,26,0,0,0,0,8,91,56,155
20210329,29MAR2021:00:00:00,UFU FERNANDEZ,230,203,287,88,58,433,257,176,411,22,0,14,124,127,70,45,30,23,0,61,86,106,257
20210329,29MAR2021:00:00:00,UFU FERRER,78,87,76,75,14,165,159,6,159,6,0,2,47,56,21,19,16,4,0,49,48,62,159
20210329,29MAR2021:00:00:00,UFU GRIERSON,187,142,130,187,12,329,329,0,329,0,0,16,98,93,61,34,23,4,0,54,147,128,329
20210329,29MAR2021:00:00:00,UFU GUTIERREZ,102,57,80,77,2,159,147,12,159,0,56,52,11,20,10,4,6,0,0,17,66,63,147
20210329,29MAR2021:00:00:00,UFU MUÑIZ,342,349,225,443,23,691,541,150,573,118,0,28,164,197,129,101,49,23,0,80,280,181,541
20210329,29MAR2021:00:00:00,UFU PENNA,41,45,63,20,5,88,80,8,84,4,2,3,15,30,22,5,10,1,0,11,42,27,80
20210329,29MAR2021:00:00:00,UFU PIROVANO,204,149,268,54,31,353,317,36,345,8,0,11,100,93,63,47,30,9,0,55,129,133,317
20210329,29MAR2021:00:00:00,UFU PIÑERO,228,200,258,148,22,428,396,32,418,10,0,11,117,113,68,50,39,30,0,55,222,110,396
20210329,29MAR2021:00:00:00,UFU RAMOS MEJIA,209,151,238,89,33,360,338,22,348,12,15,17,89,96,74,29,30,10,0,74,120,143,338
20210329,29MAR2021:00:00:00,UFU RIVADAVIA,280,218,296,141,61,498,440,58,440,58,1,18,159,125,58,79,50,8,0,61,196,180,440
20210329,29MAR2021:00:00:00,UFU SANTOJANNI,174,153,143,170,14,327,307,20,317,10,22,16,84,60,38,53,44,10,0,42,145,120,307
20210329,29MAR2021:00:00:00,UFU TORNU,138,116,172,57,25,254,230,24,236,18,12,10,55,55,54,31,21,16,0,41,92,97,230
20210329,29MAR2021:00:00:00,UFU VELEZ SARSFIELD,204,176,263,95,22,380,340,40,374,6,0,14,99,79,88,56,30,14,0,71,129,140,340
20210329,29MAR2021:00:00:00,UFU ZUBIZARRETA,113,106,104,95,20,219,211,8,219,0,0,15,45,46,54,31,20,8,0,27,99,85,211
20210330,30MAR2021:00:00:00,UFU ALVAREZ,213,225,286,116,36,438,408,30,408,30,11,23,122,105,86,48,30,13,0,90,165,152,408
20210330,30MAR2021:00:00:00,UFU ARGERICH,115,83,105,91,2,198,152,46,152,46,12,12,63,44,26,25,16,0,0,37,50,65,152
20210330,30MAR2021:00:00:00,UFU BORDA-MOYANO,53,34,61,26,0,87,85,2,85,2,0,3,21,23,24,14,2,0,0,6,44,35,85
20210330,30MAR2021:00:00:00,UFU DURAND,148,114,208,38,16,262,248,14,248,14,2,9,71,71,44,46,15,4,0,52,109,86,248
20210330,30MAR2021:00:00:00,UFU ELIZALDE,122,94,84,128,4,216,178,38,210,6,97,76,12,22,7,2,0,0,0,16,93,69,178
20210330,30MAR2021:00:00:00,UFU FERNANDEZ,252,253,335,104,66,505,261,244,491,14,0,10,140,150,93,57,33,22,0,52,93,114,261
20210330,30MAR2021:00:00:00,UFU FERRER,96,80,78,93,5,176,172,4,172,4,0,5,56,47,35,22,9,2,0,36,66,70,172
20210330,30MAR2021:00:00:00,UFU GRIERSON,139,119,111,139,8,258,246,12,246,12,0,8,86,48,51,36,27,2,0,62,91,93,246
20210330,30MAR2021:00:00:00,UFU GUTIERREZ,88,73,100,55,6,161,145,16,159,2,58,67,4,17,10,2,2,1,0,10,79,56,145
20210330,30MAR2021:00:00:00,UFU MUÑIZ,340,419,234,453,74,761,527,234,543,218,5,16,189,206,167,116,44,18,0,82,274,171,527
20210330,30MAR2021:00:00:00,UFU PENNA,56,46,68,28,6,102,94,8,98,4,2,6,14,29,14,28,7,2,0,16,45,32,94
20210330,30MAR2021:00:00:00,UFU PIROVANO,181,137,235,57,26,318,296,22,310,8,0,10,107,78,49,34,31,9,0,49,122,125,296
20210330,30MAR2021:00:00:00,UFU PIÑERO,182,172,215,122,17,354,312,42,334,20,0,9,115,72,68,50,28,12,0,54,160,97,312
20210330,30MAR2021:00:00:00,UFU RAMOS MEJIA,161,156,220,71,26,317,285,32,305,12,18,20,91,86,52,23,22,5,0,52,102,131,285
20210330,30MAR2021:00:00:00,UFU RIVADAVIA,300,184,312,117,55,484,464,20,466,18,0,10,160,124,75,73,38,4,0,88,182,189,464
20210330,30MAR2021:00:00:00,UFU SANTOJANNI,161,130,159,116,16,291,247,44,285,6,5,10,85,71,52,33,22,13,0,40,109,98,247
20210330,30MAR2021:00:00:00,UFU TORNU,135,103,155,54,29,238,218,20,222,16,12,11,66,68,38,28,6,9,0,42,91,85,218
20210330,30MAR2021:00:00:00,UFU VELEZ SARSFIELD,158,173,219,83,29,331,311,20,325,6,0,9,92,106,59,31,16,18,0,55,127,129,311
20210330,30MAR2021:00:00:00,UFU ZUBIZARRETA,133,139,161,106,5,272,262,10,272,0,0,13,52,74,71,28,24,10,0,45,110,107,262
20210331,31MAR2021:00:00:00,UFU ALVAREZ,193,163,247,74,35,356,294,62,294,62,6,26,75,102,81,28,21,17,0,85,86,122,294
20210331,31MAR2021:00:00:00,UFU ARGERICH,155,83,134,100,4,238,200,38,202,36,23,18,73,58,28,20,13,5,0,39,60,99,200
20210331,31MAR2021:00:00:00,UFU BORDA-MOYANO,76,33,83,26,0,109,103,6,103,6,0,0,13,16,26,28,13,13,0,11,45,47,103
20210331,31MAR2021:00:00:00,UFU DURAND,207,135,278,43,21,342,322,20,328,14,4,6,94,105,80,34,10,9,0,67,144,111,322
20210331,31MAR2021:00:00:00,UFU ELIZALDE,102,94,68,126,2,196,150,46,174,22,78,73,14,15,7,9,0,0,0,16,76,58,150
20210331,31MAR2021:00:00:00,UFU FERNANDEZ,293,290,414,90,79,583,293,290,567,16,0,25,178,122,109,80,48,21,0,53,115,122,293
20210331,31MAR2021:00:00:00,UFU FERRER,88,108,83,106,7,196,184,12,186,10,0,7,54,58,30,36,9,2,0,37,64,83,184
20210331,31MAR2021:00:00:00,UFU GRIERSON,107,113,70,147,3,220,214,6,214,6,0,16,56,67,40,27,7,7,0,49,80,85,214
20210331,31MAR2021:00:00:00,UFU GUTIERREZ,63,45,76,22,10,108,106,2,108,0,42,36,3,12,8,4,3,0,0,5,60,40,106
20210331,31MAR2021:00:00:00,UFU MUÑIZ,346,466,274,456,82,812,516,296,612,200,0,14,218,210,158,132,66,14,0,63,300,152,516
20210331,31MAR2021:00:00:00,UFU PENNA,63,61,99,8,17,124,116,8,118,6,0,1,38,39,17,10,16,3,0,20,54,41,116
20210331,31MAR2021:00:00:00,UFU PIROVANO,186,211,307,58,32,397,353,44,393,4,0,20,112,115,66,48,22,14,0,68,138,147,353
20210331,31MAR2021:00:00:00,UFU PIÑERO,205,189,198,176,20,394,354,40,366,28,0,17,104,91,90,54,30,8,0,68,170,111,354
20210331,31MAR2021:00:00:00,UFU RAMOS MEJIA,192,180,273,73,26,372,312,60,342,30,6,13,96,128,61,36,20,12,0,66,105,139,312
20210331,31MAR2021:00:00:00,UFU RIVADAVIA,229,201,255,122,53,430,404,26,410,20,0,12,157,104,61,61,28,7,0,70,169,165,404
20210331,31MAR2021:00:00:00,UFU SANTOJANNI,165,136,162,123,16,301,265,36,295,6,6,26,66,60,57,67,15,4,0,44,115,106,265
20210331,31MAR2021:00:00:00,UFU TORNU,128,131,171,62,26,259,239,20,239,20,3,12,69,76,52,24,17,6,0,56,83,99,239
20210331,31MAR2021:00:00:00,UFU VELEZ SARSFIELD,157,160,227,54,36,317,297,20,315,2,0,13,93,77,52,53,16,13,0,56,125,116,297
20210331,31MAR2021:00:00:00,UFU ZUBIZARRETA,100,114,110,93,11,214,208,6,214,0,0,10,61,61,29,22,12,19,0,36,95,77,208
20210401,01APR2021:00:00:00,UFU ALVAREZ,184,157,240,62,39,341,327,14,327,14,6,26,93,95,55,41,15,10,0,55,133,138,327
20210401,01APR2021:00:00:00,UFU ARGERICH,12,4,13,2,1,16,16,0,16,0,2,2,4,1,2,0,4,1,0,4,10,2,16
20210401,01APR2021:00:00:00,UFU BORDA-MOYANO,34,36,31,39,0,70,70,0,70,0,0,5,24,8,7,17,7,2,0,11,32,27,70
20210401,01APR2021:00:00:00,UFU DURAND,149,149,237,45,16,298,284,14,288,10,9,13,83,78,58,27,24,6,0,93,78,113,284
20210401,01APR2021:00:00:00,UFU ELIZALDE,101,94,73,111,11,195,165,30,183,12,70,101,8,3,12,1,0,0,0,17,92,56,165
20210401,01APR2021:00:00:00,UFU FERNANDEZ,176,220,279,68,49,396,128,268,388,8,0,14,114,131,60,36,24,17,0,36,39,53,128
20210401,01APR2021:00:00:00,UFU FERRER,95,126,97,118,6,221,221,0,221,0,0,4,71,68,44,17,11,6,0,53,72,96,221
20210401,01APR2021:00:00:00,UFU GRIERSON,137,138,88,116,71,275,271,4,271,4,0,11,99,64,53,39,9,0,0,50,119,102,271
20210401,01APR2021:00:00:00,UFU GUTIERREZ,53,28,53,19,9,81,61,20,79,2,21,37,7,3,7,4,2,0,0,5,30,26,61
20210401,01APR2021:00:00:00,UFU MUÑIZ,308,300,183,403,22,608,436,172,462,146,4,5,179,149,142,82,41,6,0,87,212,137,436
20210401,01APR2021:00:00:00,UFU PENNA,45,38,73,8,2,83,61,22,73,10,0,3,24,17,18,4,15,2,0,19,21,21,61
20210401,01APR2021:00:00:00,UFU PIROVANO,182,190,286,57,29,372,328,44,368,4,0,17,110,105,55,40,29,16,0,51,120,157,328
20210401,01APR2021:00:00:00,UFU PIÑERO,166,229,240,128,27,395,387,8,391,4,0,21,96,104,90,48,19,17,0,65,206,114,387
20210401,01APR2021:00:00:00,UFU RAMOS MEJIA,175,146,264,38,19,321,301,20,309,12,0,22,95,85,54,29,26,10,0,54,116,128,301
20210401,01APR2021:00:00:00,UFU RIVADAVIA,211,153,258,61,45,364,332,32,344,20,0,5,125,83,58,58,28,7,0,66,135,129,332
20210401,01APR2021:00:00:00,UFU SANTOJANNI,157,149,129,162,15,306,290,16,298,8,5,21,78,77,61,40,13,11,0,49,122,119,290
20210401,01APR2021:00:00:00,UFU TORNU,145,100,178,50,17,245,231,14,231,14,2,23,52,77,49,30,5,7,0,60,72,99,231
20210401,01APR2021:00:00:00,UFU VELEZ SARSFIELD,192,161,237,88,28,353,345,8,347,6,0,12,112,94,59,42,19,15,0,73,92,180,345
20210401,01APR2021:00:00:00,UFU ZUBIZARRETA,86,62,80,63,5,148,144,4,148,0,0,10,33,37,26,27,13,2,0,22,64,58,144
20210402,02APR2021:00:00:00,UFU ALVAREZ,189,163,257,59,36,352,276,76,282,70,8,19,78,90,51,51,39,16,0,64,102,110,276
20210402,02APR2021:00:00:00,UFU ARGERICH,55,53,57,51,0,108,108,0,108,0,5,1,35,16,25,16,3,7,0,26,44,38,108
20210402,02APR2021:00:00:00,UFU BORDA-MOYANO,53,53,58,46,2,106,102,4,102,4,0,6,21,22,21,13,17,6,0,19,40,43,102
20210402,02APR2021:00:00:00,UFU DURAND,167,106,229,24,20,273,267,6,267,6,5,20,69,68,53,27,21,10,0,57,113,97,267
20210402,02APR2021:00:00:00,UFU ELIZALDE,85,87,68,99,5,172,122,50,156,16,73,82,7,5,5,0,0,0,0,21,57,44,122
20210402,02APR2021:00:00:00,UFU FERNANDEZ,237,252,362,67,60,489,135,354,479,10,0,17,156,121,92,60,32,11,0,40,42,53,135
20210402,02APR2021:00:00:00,UFU FERRER,125,112,83,130,24,237,223,14,225,12,0,3,57,66,55,23,25,8,0,68,63,92,223
20210402,02APR2021:00:00:00,UFU GRIERSON,163,131,131,150,13,294,276,18,276,18,0,17,82,67,49,47,25,7,0,46,126,104,276
20210402,02APR2021:00:00:00,UFU GUTIERREZ,39,38,62,8,7,77,71,6,75,2,26,24,16,2,4,2,2,1,0,6,35,30,71
20210402,02APR2021:00:00:00,UFU MUÑIZ,313,219,183,320,29,532,384,148,398,134,0,15,141,152,104,69,34,17,0,84,152,148,384
20210402,02APR2021:00:00:00,UFU PENNA,28,27,45,6,4,55,47,8,55,0,0,5,15,16,14,3,0,2,0,14,15,18,47
20210402,02APR2021:00:00:00,UFU PIROVANO,169,149,243,55,20,318,306,12,316,2,0,15,80,99,49,41,18,16,0,71,111,124,306
20210402,02APR2021:00:00:00,UFU PIÑERO,235,147,224,137,21,382,370,12,370,12,0,26,109,86,61,65,33,2,0,70,172,124,370
20210402,02APR2021:00:00:00,UFU RAMOS MEJIA,153,121,231,15,28,274,242,32,248,26,7,19,78,62,42,35,20,11,0,71,77,91,242
20210402,02APR2021:00:00:00,UFU RIVADAVIA,227,188,302,69,44,415,399,16,401,14,0,16,140,119,61,42,15,22,0,72,157,161,399
20210402,02APR2021:00:00:00,UFU SANTOJANNI,148,117,131,121,13,265,245,20,257,8,4,24,65,65,58,30,12,7,0,38,106,101,245
20210402,02APR2021:00:00:00,UFU TORNU,130,105,177,34,24,235,215,20,215,20,6,9,56,59,42,23,36,4,0,42,80,92,215
20210402,02APR2021:00:00:00,UFU VELEZ SARSFIELD,172,156,226,77,25,328,318,10,322,6,0,10,84,92,48,40,33,21,0,53,126,139,318
20210402,02APR2021:00:00:00,UFU ZUBIZARRETA,116,107,129,82,12,223,211,12,223,0,0,19,59,41,48,19,26,11,0,29,100,82,211
20210403,03APR2021:00:00:00,UFU ALVAREZ,228,189,265,112,40,417,389,28,391,26,17,43,83,85,69,68,42,10,0,112,115,160,389
20210403,03APR2021:00:00:00,UFU BORDA-MOYANO,32,25,26,31,0,57,57,0,57,0,0,4,6,11,13,18,1,4,0,13,18,26,57
20210403,03APR2021:00:00:00,UFU DURAND,192,139,273,55,5,333,316,17,320,13,4,15,90,92,51,42,28,11,0,84,119,112,316
20210403,03APR2021:00:00:00,UFU ELIZALDE,72,60,52,72,8,132,106,26,126,6,45,56,13,6,3,7,2,0,0,8,62,36,106
20210403,03APR2021:00:00:00,UFU FERNANDEZ,76,71,116,31,0,147,141,6,143,4,0,2,34,31,32,28,15,5,0,31,50,60,141
20210403,03APR2021:00:00:00,UFU FERRER,125,96,86,131,4,221,213,8,213,8,0,4,50,54,39,54,14,6,0,65,62,86,213
20210403,03APR2021:00:00:00,UFU GRIERSON,118,119,87,143,7,237,225,12,225,12,0,11,64,54,43,47,12,6,0,52,85,88,225
20210403,03APR2021:00:00:00,UFU GUTIERREZ,50,49,54,40,5,99,89,10,97,2,33,41,6,8,7,3,1,0,0,7,45,36,89
20210403,03APR2021:00:00:00,UFU MUÑIZ,238,306,170,336,38,544,400,144,420,124,0,6,136,149,125,71,47,10,0,101,165,134,400
20210403,03APR2021:00:00:00,UFU PENNA,69,43,86,19,7,112,98,14,102,10,0,1,42,18,18,20,7,6,0,29,34,35,98
20210403,03APR2021:00:00:00,UFU PIROVANO,153,149,216,64,22,302,282,20,300,2,0,6,72,90,36,41,38,19,0,49,86,147,282
20210403,03APR2021:00:00:00,UFU PIÑERO,200,146,203,132,11,346,338,8,338,8,0,4,86,92,85,51,15,13,0,55,184,99,338
20210403,03APR2021:00:00:00,UFU RAMOS MEJIA,186,207,337,39,17,393,349,44,355,38,4,35,122,95,63,39,23,12,0,71,96,182,349
20210403,03APR2021:00:00:00,UFU RIVADAVIA,193,154,259,74,14,347,315,32,315,32,0,6,113,88,67,36,22,15,0,45,137,129,315
20210403,03APR2021:00:00:00,UFU SANTOJANNI,185,128,139,167,7,313,295,18,303,10,0,9,84,90,55,46,21,8,0,47,122,126,295
20210403,03APR2021:00:00:00,UFU TORNU,143,140,211,58,14,283,257,26,257,26,4,10,79,51,60,35,31,13,0,42,104,111,257
20210403,03APR2021:00:00:00,UFU VELEZ SARSFIELD,157,145,201,91,10,302,292,10,296,6,0,13,93,56,64,43,19,14,0,62,115,115,292
20210403,03APR2021:00:00:00,UFU ZUBIZARRETA,115,130,142,93,10,245,233,12,245,0,0,6,73,62,37,38,16,13,0,44,112,77,233
20210404,04APR2021:00:00:00,UFU ALVAREZ,252,203,305,78,72,455,429,26,431,24,14,40,111,79,110,68,23,10,0,94,147,188,429
20210404,04APR2021:00:00:00,UFU ARGERICH,56,47,47,56,0,103,103,0,103,0,0,0,25,33,12,18,8,7,0,28,39,35,103
20210404,04APR2021:00:00:00,UFU BORDA-MOYANO,37,46,47,34,2,83,83,0,83,0,0,3,8,24,17,14,13,4,0,15,33,35,83
20210404,04APR2021:00:00:00,UFU DURAND,137,107,212,26,6,244,222,22,230,14,2,11,43,74,42,35,23,14,0,98,35,88,222
20210404,04APR2021:00:00:00,UFU ELIZALDE,99,82,43,131,7,181,121,60,163,18,81,62,6,19,7,4,2,0,0,6,67,48,121
20210404,04APR2021:00:00:00,UFU FERNANDEZ,188,140,262,57,9,328,144,184,316,12,0,7,90,79,61,54,25,12,0,32,49,63,144
20210404,04APR2021:00:00:00,UFU FERRER,107,96,105,94,4,203,197,6,197,6,0,2,75,43,46,22,11,4,0,50,62,85,197
20210404,04APR2021:00:00:00,UFU GRIERSON,135,134,128,137,4,269,259,10,259,10,3,16,64,60,54,45,21,6,0,59,99,101,259
20210404,04APR2021:00:00:00,UFU GUTIERREZ,46,43,65,24,0,89,85,4,89,0,25,45,4,5,9,0,0,1,0,13,38,33,85
20210404,04APR2021:00:00:00,UFU MUÑIZ,184,157,109,179,53,341,217,124,261,80,0,16,94,54,60,71,34,12,0,44,96,77,217
20210404,04APR2021:00:00:00,UFU PENNA,43,34,60,15,2,77,66,11,66,11,0,0,8,21,23,20,1,4,0,14,20,32,66
20210404,04APR2021:00:00:00,UFU PIROVANO,160,165,272,46,7,325,313,12,323,2,2,16,92,88,53,35,34,5,0,66,120,125,313
20210404,04APR2021:00:00:00,UFU PIÑERO,188,149,236,85,16,337,333,4,333,4,0,19,92,57,69,55,29,16,0,61,171,101,333
20210404,04APR2021:00:00:00,UFU RAMOS MEJIA,206,138,193,27,124,344,314,30,314,30,9,19,87,89,64,34,26,16,0,29,34,247,314
20210404,04APR2021:00:00:00,UFU RIVADAVIA,120,95,147,51,17,215,207,8,207,8,0,5,80,54,31,29,12,4,0,55,59,92,207
20210404,04APR2021:00:00:00,UFU SANTOJANNI,202,180,201,163,18,382,360,22,376,6,7,28,77,96,77,44,35,18,0,74,139,147,360
20210404,04APR2021:00:00:00,UFU TORNU,117,91,106,35,67,208,192,16,192,16,2,16,54,52,43,28,11,2,0,46,62,84,192
20210404,04APR2021:00:00:00,UFU VELEZ SARSFIELD,119,132,175,68,8,251,243,8,247,4,0,5,58,62,59,39,22,6,0,45,99,99,243
20210404,04APR2021:00:00:00,UFU ZUBIZARRETA,75,79,95,48,11,154,140,14,154,0,0,0,30,33,28,23,21,19,0,26,58,56,140
20210405,05APR2021:00:00:00,UFU ALVAREZ,329,286,394,151,70,615,485,130,491,124,8,55,182,144,93,78,37,18,0,96,215,173,485
20210405,05APR2021:00:00:00,UFU ARGERICH,157,160,160,151,6,317,260,57,288,29,9,25,84,83,63,28,17,8,0,49,123,83,260
20210405,05APR2021:00:00:00,UFU BORDA-MOYANO,57,65,65,54,3,122,118,4,118,4,0,4,32,28,31,21,4,2,0,28,41,49,118
20210405,05APR2021:00:00:00,UFU DURAND,237,202,326,99,22,447,428,19,428,19,13,18,127,104,85,59,26,15,0,110,159,159,428
20210405,05APR2021:00:00:00,UFU ELIZALDE,115,115,45,181,4,230,168,62,210,20,98,87,14,21,4,6,0,0,0,20,87,61,168
20210405,05APR2021:00:00:00,UFU FERNANDEZ,217,217,353,60,21,434,154,280,424,10,0,6,127,116,64,74,34,13,0,46,45,63,154
20210405,05APR2021:00:00:00,UFU FERRER,106,73,71,95,13,179,175,4,175,4,0,0,63,52,34,28,0,2,0,53,56,66,175
20210405,05APR2021:00:00:00,UFU GRIERSON,139,134,91,173,9,273,259,14,265,8,0,6,80,55,61,53,16,2,0,61,98,100,259
20210405,05APR2021:00:00:00,UFU GUTIERREZ,116,70,119,62,5,186,166,20,184,2,68,59,14,21,14,4,1,5,0,12,82,71,166
20210405,05APR2021:00:00:00,UFU MUÑIZ,422,444,248,556,62,866,608,258,658,208,0,14,205,243,209,111,69,15,0,110,319,179,608
20210405,05APR2021:00:00:00,UFU PENNA,82,69,107,36,9,152,137,15,143,9,1,7,22,39,32,33,16,2,0,33,48,55,137
20210405,05APR2021:00:00:00,UFU PIROVANO,271,195,332,110,24,466,416,50,464,2,2,21,137,121,77,66,23,19,0,71,168,177,416
20210405,05APR2021:00:00:00,UFU PIÑERO,252,199,229,192,30,451,423,28,431,20,0,42,117,145,56,48,35,8,0,66,233,124,423
20210405,05APR2021:00:00:00,UFU RAMOS MEJIA,190,173,237,97,29,363,337,26,351,12,10,32,102,78,41,63,28,9,0,90,106,134,337
20210405,05APR2021:00:00:00,UFU RIVADAVIA,255,214,316,120,33,469,409,60,409,60,2,10,148,111,69,88,28,13,0,96,135,170,409
20210405,05APR2021:00:00:00,UFU SANTOJANNI,183,233,183,224,9,416,394,22,406,10,2,35,90,90,86,68,39,6,0,76,167,151,394
20210405,05APR2021:00:00:00,UFU TORNU,207,176,263,95,25,383,307,76,307,76,10,18,85,101,86,49,15,19,0,79,102,125,307
20210405,05APR2021:00:00:00,UFU VELEZ SARSFIELD,139,131,157,97,16,270,266,4,266,4,0,22,50,72,53,43,18,12,0,66,59,141,266
20210405,05APR2021:00:00:00,UFU ZUBIZARRETA,90,65,79,71,5,155,149,6,155,0,0,14,44,29,36,22,5,5,0,18,75,56,149
20210406,06APR2021:00:00:00,UFU ALVAREZ,316,370,441,196,49,686,662,24,670,16,10,59,170,180,143,69,37,18,0,105,345,205,662
20210406,06APR2021:00:00:00,UFU ARGERICH,135,128,116,138,9,263,209,54,213,50,13,15,70,65,52,34,10,4,0,50,76,83,209
20210406,06APR2021:00:00:00,UFU BORDA-MOYANO,106,88,103,83,8,194,186,8,186,8,0,5,47,42,51,24,9,16,0,45,61,80,186
20210406,06APR2021:00:00:00,UFU DURAND,266,236,415,76,15,506,480,26,480,26,7,15,153,165,93,35,22,16,0,130,176,172,480
20210406,06APR2021:00:00:00,UFU ELIZALDE,132,111,82,156,5,243,175,68,229,14,86,106,14,15,17,3,2,0,0,11,97,67,175
20210406,06APR2021:00:00:00,UFU FERNANDEZ,206,237,359,70,14,443,283,160,439,4,0,15,139,152,54,37,36,10,0,8,7,268,283
20210406,06APR2021:00:00:00,UFU FERRER,116,56,76,92,4,172,168,4,168,4,0,3,51,56,31,24,5,2,0,48,55,65,168
20210406,06APR2021:00:00:00,UFU GRIERSON,155,181,148,187,1,336,316,20,316,20,2,9,81,89,81,44,19,11,0,64,128,124,316
20210406,06APR2021:00:00:00,UFU GUTIERREZ,90,78,75,90,3,168,144,24,166,2,71,59,13,10,10,5,0,0,0,6,80,58,144
20210406,06APR2021:00:00:00,UFU MUÑIZ,414,390,318,438,48,804,634,170,640,164,0,18,208,231,188,88,44,27,0,117,311,205,634
20210406,06APR2021:00:00:00,UFU PENNA,101,78,139,24,16,179,173,6,177,2,0,5,50,48,34,29,9,4,0,27,86,60,173
20210406,06APR2021:00:00:00,UFU PIROVANO,213,206,300,92,27,419,375,44,417,2,0,20,116,105,78,44,45,11,0,65,138,172,375
20210406,06APR2021:00:00:00,UFU PIÑERO,177,186,218,114,31,363,339,24,355,8,2,15,119,84,58,39,34,12,0,58,183,97,339
20210406,06APR2021:00:00:00,UFU RAMOS MEJIA,201,144,226,92,27,345,321,24,335,10,11,22,107,88,53,40,13,11,0,88,92,139,321
20210406,06APR2021:00:00:00,UFU RIVADAVIA,260,254,320,130,64,514,470,44,482,32,4,10,189,150,80,43,31,7,0,105,171,192,470
20210406,06APR2021:00:00:00,UFU SANTOJANNI,267,237,230,256,18,504,466,38,498,6,0,32,135,148,75,59,33,22,0,76,207,183,466
20210406,06APR2021:00:00:00,UFU TORNU,185,173,249,88,21,358,315,43,315,43,9,19,96,94,69,40,14,17,0,53,128,134,315
20210406,06APR2021:00:00:00,UFU VELEZ SARSFIELD,152,173,199,107,19,325,315,10,325,0,0,19,101,66,61,46,21,11,0,49,96,170,315
20210406,06APR2021:00:00:00,UFU ZUBIZARRETA,109,124,137,94,2,233,227,6,233,0,0,18,59,54,35,38,24,5,0,26,105,96,227
20210407,07APR2021:00:00:00,UFU ALVAREZ,260,240,327,114,60,501,452,49,455,46,19,30,171,104,83,64,23,7,0,98,233,119,452
20210407,07APR2021:00:00:00,UFU ARGERICH,160,167,151,150,26,327,303,24,305,22,15,21,113,82,42,27,16,11,0,71,103,125,303
20210407,07APR2021:00:00:00,UFU BORDA-MOYANO,108,68,110,66,0,176,168,8,168,8,2,5,38,36,39,27,16,13,0,20,79,69,168
20210407,07APR2021:00:00:00,UFU DURAND,214,241,323,101,31,455,443,12,443,12,0,14,128,138,84,44,45,2,0,104,187,152,443
20210407,07APR2021:00:00:00,UFU ELIZALDE,134,50,46,131,8,185,159,26,174,11,53,90,12,17,6,5,2,0,0,14,93,52,159
20210407,07APR2021:00:00:00,UFU FERNANDEZ,184,189,256,60,58,374,313,61,354,20,1,16,148,93,59,39,10,8,0,6,10,297,313
20210407,07APR2021:00:00:00,UFU FERRER,117,129,81,130,36,247,232,15,233,14,1,5,92,71,45,24,0,9,0,65,82,85,232
20210407,07APR2021:00:00:00,UFU GRIERSON,173,168,118,124,99,341,331,10,331,10,0,11,99,96,65,54,12,4,0,23,65,243,331
20210407,07APR2021:00:00:00,UFU GUTIERREZ,98,69,111,51,6,168,135,33,166,2,65,56,10,16,8,10,2,1,0,16,61,58,135
20210407,07APR2021:00:00:00,UFU MUÑIZ,482,442,310,465,150,925,611,314,752,173,3,17,282,262,189,106,53,13,0,103,341,166,611
20210407,07APR2021:00:00:00,UFU PENNA,77,79,104,25,27,156,146,10,152,4,0,2,49,51,24,23,6,1,0,26,75,45,146
20210407,07APR2021:00:00:00,UFU PIROVANO,240,237,354,57,67,478,441,37,464,14,1,18,149,124,86,69,19,12,0,68,256,114,441
20210407,07APR2021:00:00:00,UFU PIÑERO,227,155,200,122,61,383,372,11,377,6,1,15,121,118,70,32,11,15,0,60,224,88,372
20210407,07APR2021:00:00:00,UFU RAMOS MEJIA,229,195,305,72,49,426,372,54,413,13,13,16,117,109,62,54,40,15,0,97,112,161,372
20210407,07APR2021:00:00:00,UFU RIVADAVIA,201,178,233,89,58,380,359,21,366,14,3,19,116,100,61,58,16,7,0,102,120,136,359
20210407,07APR2021:00:00:00,UFU SANTOJANNI,243,188,199,155,78,432,387,45,420,12,1,41,135,97,79,40,26,13,0,54,177,156,387
20210407,07APR2021:00:00:00,UFU TORNU,198,166,223,80,62,365,312,53,327,38,12,34,80,106,70,27,26,10,0,54,142,116,312
20210407,07APR2021:00:00:00,UFU VELEZ SARSFIELD,164,160,244,60,21,325,302,23,325,0,1,17,103,59,61,47,26,11,0,75,103,124,302
20210407,07APR2021:00:00:00,UFU ZUBIZARRETA,130,115,151,89,6,246,243,3,246,0,1,16,86,53,38,22,18,12,0,48,96,99,243
20210408,08APR2021:00:00:00,UFU ALVAREZ,383,326,471,156,82,709,671,38,673,36,20,56,227,160,103,79,53,11,0,101,363,204,671
20210408,08APR2021:00:00:00,UFU ARGERICH,133,82,94,92,29,215,203,12,203,12,12,26,59,56,40,17,4,1,0,37,103,62,203
20210408,08APR2021:00:00:00,UFU BORDA-MOYANO,129,93,154,64,4,222,200,22,200,22,0,5,43,50,47,30,30,17,0,30,81,87,200
20210408,08APR2021:00:00:00,UFU DURAND,239,234,346,114,13,473,461,12,467,6,2,20,150,132,78,39,47,5,0,129,162,170,461
20210315,15MAR2021:00:00:00,UFU FERRER,62,51,65,46,2,113,107,6,109,4,0,1,31,37,19,19,6,0,0,13,53,41,107
20210315,15MAR2021:00:00:00,UFU GRIERSON,104,113,93,95,29,217,205,12,213,4,0,12,36,64,47,45,8,5,0,23,95,87,205
20210315,15MAR2021:00:00:00,UFU GUTIERREZ,79,79,92,66,0,158,124,34,156,2,69,50,13,12,14,0,0,0,0,1,70,53,124
20210315,15MAR2021:00:00:00,UFU MUÑIZ,270,237,229,255,23,507,409,98,425,82,0,35,127,78,130,85,34,18,0,47,230,131,409
20210315,15MAR2021:00:00:00,UFU PENNA,55,39,61,25,9,95,72,23,74,21,1,6,26,22,12,15,11,2,0,8,41,23,72
20210315,15MAR2021:00:00:00,UFU PIROVANO,154,136,227,46,17,290,268,22,280,10,0,9,61,89,74,32,20,5,0,38,114,116,268
20210315,15MAR2021:00:00:00,UFU PIÑERO,109,126,150,77,8,235,213,22,225,10,4,5,67,54,48,23,28,6,0,14,139,60,213
20210315,15MAR2021:00:00:00,UFU RAMOS MEJIA,129,118,168,68,11,247,225,22,241,6,18,13,56,57,46,27,19,11,0,26,94,104,225
20210315,15MAR2021:00:00:00,UFU RIVADAVIA,222,194,262,105,49,416,368,48,370,46,0,8,130,122,82,40,24,10,0,31,173,159,368
20210315,15MAR2021:00:00:00,UFU SANTOJANNI,119,99,104,114,0,218,210,8,216,2,11,10,52,43,34,36,26,6,0,22,107,81,210
20210315,15MAR2021:00:00:00,UFU TORNU,64,82,104,32,10,146,136,10,138,8,6,14,28,41,16,18,10,13,0,18,64,54,136
20210315,15MAR2021:00:00:00,UFU VELEZ SARSFIELD,92,88,122,54,4,180,176,4,178,2,0,9,41,50,23,34,14,9,0,22,85,69,176
20210315,15MAR2021:00:00:00,UFU ZUBIZARRETA,121,110,124,100,7,231,225,6,231,0,0,9,43,62,48,22,30,17,0,22,113,90,225
20210316,16MAR2021:00:00:00,UFU ALVAREZ,120,111,178,49,4,231,209,22,209,22,11,21,60,62,20,30,15,12,0,24,103,82,209
20210316,16MAR2021:00:00:00,UFU ARGERICH,68,33,53,44,4,101,83,18,91,10,12,8,24,34,9,13,1,0,0,11,34,37,83
20210316,16MAR2021:00:00:00,UFU BORDA-MOYANO,58,100,104,51,3,158,152,6,152,6,0,8,34,20,26,45,21,4,0,0,85,67,152
20210316,16MAR2021:00:00:00,UFU DURAND,146,98,226,18,0,244,236,8,236,8,11,10,59,65,61,18,11,9,0,35,107,94,236
20210316,16MAR2021:00:00:00,UFU ELIZALDE,92,73,43,114,8,165,131,34,157,8,82,40,8,19,10,4,2,0,0,4,78,49,131
20210316,16MAR2021:00:00:00,UFU FERNANDEZ,145,97,194,44,4,242,112,130,232,10,0,7,65,72,41,24,21,12,0,10,55,47,112
20210316,16MAR2021:00:00:00,UFU FERRER,58,70,55,73,0,128,118,10,124,4,0,0,50,22,27,24,2,3,0,16,52,50,118
20210316,16MAR2021:00:00:00,UFU GRIERSON,117,120,118,97,22,237,235,2,235,2,0,11,60,56,55,40,13,2,0,40,103,92,235
20210316,16MAR2021:00:00:00,UFU GUTIERREZ,90,76,104,62,0,166,128,38,164,2,68,56,10,11,13,3,4,1,0,3,70,52,128
20210316,16MAR2021:00:00:00,UFU MUÑIZ,241,294,206,298,31,535,371,164,421,114,2,22,154,139,100,73,38,7,0,35,238,98,371
20210316,16MAR2021:00:00:00,UFU PENNA,47,39,63,20,3,86,68,18,70,16,0,4,26,22,5,12,15,2,0,4,38,26,68
20210316,16MAR2021:00:00:00,UFU PIROVANO,155,130,235,47,3,285,273,12,279,6,0,13,63,83,41,41,27,17,0,29,128,116,273
20210316,16MAR2021:00:00:00,UFU PIÑERO,113,102,139,71,5,215,201,14,205,10,0,10,62,53,38,30,20,2,0,15,115,69,201
20210316,16MAR2021:00:00:00,UFU RAMOS MEJIA,104,87,141,41,9,191,177,14,177,14,1,24,52,55,30,17,9,3,0,20,83,74,177
20210316,16MAR2021:00:00:00,UFU RIVADAVIA,219,184,258,95,50,403,363,40,369,34,1,14,125,113,51,55,30,14,0,39,170,152,363
20210316,16MAR2021:00:00:00,UFU SANTOJANNI,140,124,151,105,8,264,242,22,256,8,6,31,59,32,53,42,29,12,0,27,113,102,242
20210316,16MAR2021:00:00:00,UFU TORNU,72,52,94,22,8,124,94,30,112,12,15,9,17,36,17,11,9,10,0,7,46,41,94
20210316,16MAR2021:00:00:00,UFU VELEZ SARSFIELD,105,143,150,88,10,248,244,4,248,0,0,13,60,69,39,33,27,7,0,38,104,102,244
20210316,16MAR2021:00:00:00,UFU ZUBIZARRETA,67,60,92,30,5,127,113,14,127,0,0,17,18,28,26,14,15,9,0,14,51,48,113
20210317,17MAR2021:00:00:00,UFU ALVAREZ,133,122,202,45,8,255,179,76,181,74,12,13,82,50,42,27,18,11,0,20,87,72,179
20210317,17MAR2021:00:00:00,UFU ARGERICH,55,48,56,36,11,103,81,22,83,20,4,7,18,37,25,6,2,4,0,13,34,32,81
20210317,17MAR2021:00:00:00,UFU BORDA-MOYANO,50,43,50,43,0,93,87,6,87,6,2,6,17,14,24,11,7,12,0,3,44,40,87
20210317,17MAR2021:00:00:00,UFU DURAND,121,88,181,26,2,209,199,10,201,8,8,7,39,81,37,17,17,3,0,33,85,81,199
20210317,17MAR2021:00:00:00,UFU ELIZALDE,76,62,50,87,1,138,112,26,128,10,33,57,12,18,9,5,2,2,0,2,72,38,112
20210317,17MAR2021:00:00:00,UFU FERNANDEZ,158,134,235,54,3,292,142,150,292,0,0,13,83,72,60,32,21,11,0,26,52,64,142
20210317,17MAR2021:00:00:00,UFU FERRER,64,72,63,73,0,136,120,16,124,12,2,2,46,49,28,6,1,2,0,26,48,46,120
20210317,17MAR2021:00:00:00,UFU GRIERSON,102,127,99,88,42,229,217,12,217,12,0,10,96,42,50,18,12,1,0,32,93,92,217
20210317,17MAR2021:00:00:00,UFU GUTIERREZ,66,60,84,42,0,126,104,22,124,2,61,42,4,9,6,0,2,2,0,7,57,40,104
20210317,17MAR2021:00:00:00,UFU MUÑIZ,233,271,221,255,28,504,360,144,402,102,9,22,149,113,72,80,40,19,0,27,225,108,360
20210317,17MAR2021:00:00:00,UFU PENNA,46,39,59,19,7,85,73,12,79,6,0,5,17,26,17,4,10,6,0,7,39,27,73
20210317,17MAR2021:00:00:00,UFU PIROVANO,142,105,196,51,0,247,225,22,245,2,0,13,73,67,43,25,10,16,0,32,98,95,225
20210317,17MAR2021:00:00:00,UFU PIÑERO,122,118,160,62,18,240,214,26,238,2,2,13,69,60,54,15,21,6,0,16,136,62,214
20210317,17MAR2021:00:00:00,UFU RAMOS MEJIA,101,100,151,50,0,201,163,38,191,10,2,20,38,51,41,36,8,5,0,23,83,57,163
20210317,17MAR2021:00:00:00,UFU RIVADAVIA,171,162,220,69,44,333,304,29,308,25,0,2,102,99,34,52,35,9,0,45,139,120,304
20210317,17MAR2021:00:00:00,UFU SANTOJANNI,150,109,132,123,4,259,219,40,253,6,6,20,62,54,41,49,13,14,0,25,103,91,219
20210317,17MAR2021:00:00:00,UFU TORNU,72,61,109,18,6,133,119,14,121,12,10,10,34,28,17,23,6,5,0,22,47,50,119
20210317,17MAR2021:00:00:00,UFU VELEZ SARSFIELD,141,112,168,79,6,253,245,8,253,0,0,9,67,64,48,42,20,3,0,37,103,105,245
20210317,17MAR2021:00:00:00,UFU ZUBIZARRETA,49,47,65,31,0,96,94,2,96,0,0,8,23,24,15,17,7,2,0,13,39,42,94
20210318,18MAR2021:00:00:00,UFU ALVAREZ,169,116,229,48,8,285,251,34,257,28,21,26,71,70,51,25,16,5,0,30,118,103,251
20210318,18MAR2021:00:00:00,UFU ARGERICH,30,20,26,20,4,50,38,12,38,12,0,6,14,6,14,3,3,4,0,6,15,17,38
20210318,18MAR2021:00:00:00,UFU BORDA-MOYANO,50,36,47,37,2,86,84,2,84,2,0,3,20,14,31,8,8,2,0,1,53,30,84
20210318,18MAR2021:00:00:00,UFU DURAND,120,82,170,32,0,202,194,8,194,8,0,12,44,75,33,22,14,2,0,28,85,81,194
20210318,18MAR2021:00:00:00,UFU ELIZALDE,85,52,34,103,0,137,111,26,129,8,64,39,3,11,10,5,3,2,0,1,66,44,111
20210318,18MAR2021:00:00:00,UFU FERNANDEZ,127,100,193,29,5,227,139,88,213,14,0,8,55,49,60,23,24,8,0,4,17,118,139
20210318,18MAR2021:00:00:00,UFU FERRER,44,62,62,44,0,106,81,25,99,7,0,1,35,20,27,19,4,0,0,18,32,31,81
20210318,18MAR2021:00:00:00,UFU GRIERSON,111,92,96,84,23,203,199,4,201,2,0,19,40,52,35,39,5,13,0,40,77,82,199
20210318,18MAR2021:00:00:00,UFU GUTIERREZ,39,31,37,33,0,70,60,10,68,2,32,24,2,8,2,2,0,0,0,0,32,27,60
20210318,18MAR2021:00:00:00,UFU MUÑIZ,222,257,208,249,22,479,341,138,357,122,0,11,135,126,110,49,34,14,0,40,197,104,341
20210318,18MAR2021:00:00:00,UFU PENNA,50,41,70,19,2,91,63,28,67,24,0,5,34,15,16,10,7,4,0,10,30,23,63
20210318,18MAR2021:00:00:00,UFU PIROVANO,132,109,211,23,7,241,225,16,235,6,0,7,64,86,40,19,17,8,0,25,107,93,225
20210318,18MAR2021:00:00:00,UFU PIÑERO,85,82,111,39,17,167,147,20,161,6,1,2,46,34,41,21,7,15,0,12,93,42,147
20210318,18MAR2021:00:00:00,UFU RAMOS MEJIA,89,79,116,43,9,168,150,18,160,8,7,12,38,42,28,22,16,3,0,18,70,62,150
20210318,18MAR2021:00:00:00,UFU RIVADAVIA,184,142,228,59,39,326,290,36,298,28,0,11,91,118,56,29,15,6,0,32,129,128,290
20210318,18MAR2021:00:00:00,UFU SANTOJANNI,98,81,108,69,2,179,163,16,175,4,2,5,50,30,43,26,19,4,0,26,72,65,163
20210318,18MAR2021:00:00:00,UFU TORNU,84,75,111,45,3,159,141,18,145,14,4,20,39,41,20,20,7,8,0,16,70,55,141
20210318,18MAR2021:00:00:00,UFU VELEZ SARSFIELD,102,69,138,29,4,171,147,24,167,4,0,8,43,27,42,29,11,11,0,28,64,55,147
20210318,18MAR2021:00:00:00,UFU ZUBIZARRETA,89,80,95,63,11,169,163,6,169,0,0,11,49,32,23,34,15,5,0,20,77,66,163
20210319,19MAR2021:00:00:00,UFU ALVAREZ,158,116,211,51,12,274,216,58,222,52,19,31,40,61,34,42,31,16,0,27,94,95,216
20210319,19MAR2021:00:00:00,UFU ARGERICH,38,29,39,22,6,67,39,28,39,28,4,1,25,12,11,6,4,4,0,7,16,16,39
20210319,19MAR2021:00:00:00,UFU BORDA-MOYANO,47,26,22,49,2,73,71,2,71,2,0,6,11,11,16,13,4,12,0,3,31,37,71
20210319,19MAR2021:00:00:00,UFU DURAND,116,101,197,18,2,217,203,14,207,10,3,15,55,55,39,34,8,8,0,34,113,56,203
20210319,19MAR2021:00:00:00,UFU ELIZALDE,47,71,29,73,16,118,96,22,112,6,51,30,2,19,5,5,6,0,0,1,54,41,96
20210319,19MAR2021:00:00:00,UFU FERNANDEZ,170,137,244,51,12,307,123,184,301,6,0,8,93,70,56,38,30,12,0,17,51,54,123
20210319,19MAR2021:00:00:00,UFU FERRER,61,52,57,53,3,113,109,4,109,4,0,2,25,40,37,8,0,1,0,19,43,47,109
20210319,19MAR2021:00:00:00,UFU GRIERSON,83,92,78,85,12,175,173,2,173,2,0,9,34,59,29,30,10,4,0,25,48,100,173
20210319,19MAR2021:00:00:00,UFU GUTIERREZ,50,37,73,14,0,87,77,10,87,0,34,31,2,6,12,0,2,0,0,6,36,35,77
20210319,19MAR2021:00:00:00,UFU MUÑIZ,290,384,256,379,39,674,514,160,524,150,0,12,215,172,121,92,42,20,0,43,327,144,514
20210319,19MAR2021:00:00:00,UFU PENNA,48,25,51,22,0,73,63,10,71,2,0,1,29,14,14,5,6,4,0,7,33,23,63
20210319,19MAR2021:00:00:00,UFU PIROVANO,171,113,215,63,6,284,252,32,274,10,0,4,77,77,53,45,18,10,0,25,125,102,252
20210319,19MAR2021:00:00:00,UFU PIÑERO,89,91,146,20,14,180,172,8,174,6,11,18,34,44,44,18,8,3,0,16,104,52,172
20210319,19MAR2021:00:00:00,UFU RAMOS MEJIA,148,84,159,44,29,232,206,26,206,26,14,25,42,61,41,30,12,7,0,32,88,86,206
20210319,19MAR2021:00:00:00,UFU RIVADAVIA,205,136,205,78,58,341,313,28,319,22,1,10,109,105,51,27,23,15,0,34,154,124,313
20210319,19MAR2021:00:00:00,UFU SANTOJANNI,120,86,129,74,3,206,182,24,202,4,11,16,49,51,25,29,13,12,0,22,87,73,182
20210319,19MAR2021:00:00:00,UFU TORNU,80,116,124,63,9,196,172,24,186,10,8,18,65,38,20,30,16,1,0,25,77,68,172
20210319,19MAR2021:00:00:00,UFU VELEZ SARSFIELD,119,117,171,54,11,236,224,12,230,6,0,20,61,55,50,27,7,16,0,34,96,94,224
20210319,19MAR2021:00:00:00,UFU ZUBIZARRETA,128,93,138,76,7,221,219,2,221,0,0,22,49,52,42,31,19,6,0,23,105,91,219
20210320,20MAR2021:00:00:00,UFU ALVAREZ,81,73,127,19,8,154,140,14,140,14,7,8,45,25,23,26,13,7,0,22,60,58,140
20210320,20MAR2021:00:00:00,UFU ARGERICH,2,0,0,2,0,2,2,0,2,0,2,0,0,0,0,0,0,0,0,0,1,1,2
20210320,20MAR2021:00:00:00,UFU BORDA-MOYANO,10,7,13,4,0,17,15,2,15,2,0,6,4,2,3,2,0,0,0,2,9,4,15
20210320,20MAR2021:00:00:00,UFU DURAND,70,64,115,16,3,134,130,4,132,2,2,11,40,28,25,13,10,5,0,12,65,53,130
20210320,20MAR2021:00:00:00,UFU ELIZALDE,52,56,29,79,0,108,56,52,104,4,56,33,1,13,2,3,0,0,0,2,33,21,56
20210320,20MAR2021:00:00:00,UFU FERNANDEZ,95,109,164,34,6,204,108,96,202,2,0,9,49,56,41,23,16,10,0,18,42,48,108
20210320,20MAR2021:00:00:00,UFU FERRER,38,36,35,39,0,74,72,2,72,2,0,1,24,26,14,5,4,0,0,13,29,30,72
20210320,20MAR2021:00:00:00,UFU GRIERSON,107,62,76,83,10,169,159,10,163,6,0,13,47,42,38,19,9,1,0,24,60,75,159
20210320,20MAR2021:00:00:00,UFU GUTIERREZ,40,40,41,39,0,80,70,10,80,0,29,27,6,5,4,7,2,0,0,3,32,35,70
20210320,20MAR2021:00:00:00,UFU MUÑIZ,204,268,224,230,18,472,298,174,344,128,1,13,103,138,112,50,45,10,0,34,169,95,298
20210320,20MAR2021:00:00:00,UFU PENNA,21,30,34,17,0,51,49,2,49,2,0,2,10,12,1,7,11,8,0,5,22,22,49
20210320,20MAR2021:00:00:00,UFU PIROVANO,113,99,169,31,12,212,180,32,206,6,0,0,54,60,56,22,16,4,0,18,83,79,180
20210320,20MAR2021:00:00:00,UFU PIÑERO,101,85,100,79,7,186,180,6,180,6,0,12,51,46,46,23,5,3,0,19,111,50,180
20210320,20MAR2021:00:00:00,UFU RAMOS MEJIA,85,71,123,27,6,156,133,23,135,21,5,7,29,52,27,17,13,6,0,14,60,58,133
20210320,20MAR2021:00:00:00,UFU RIVADAVIA,150,129,207,43,29,279,263,16,263,16,0,6,108,68,43,26,17,11,0,34,116,111,263
20210320,20MAR2021:00:00:00,UFU SANTOJANNI,97,57,81,71,2,154,140,14,150,4,2,6,40,30,24,31,13,8,0,26,55,59,140
20210320,20MAR2021:00:00:00,UFU TORNU,62,69,81,41,9,131,115,16,127,4,0,13,26,30,36,16,10,0,0,17,45,53,115
20210320,20MAR2021:00:00:00,UFU VELEZ SARSFIELD,97,78,134,36,5,175,167,8,171,4,0,3,34,23,44,39,15,17,0,19,79,69,167
20210320,20MAR2021:00:00:00,UFU ZUBIZARRETA,97,96,130,39,24,193,185,8,193,0,0,17,43,41,43,30,17,2,0,21,91,73,185
20210321,21MAR2021:00:00:00,UFU ALVAREZ,84,60,125,19,0,144,138,6,138,6,5,15,33,40,16,12,16,7,0,24,56,58,138
20210321,21MAR2021:00:00:00,UFU ARGERICH,9,2,9,2,0,11,9,2,11,0,1,0,0,4,1,1,2,2,0,0,6,3,9
20210321,21MAR2021:00:00:00,UFU BORDA-MOYANO,12,6,14,3,1,18,14,4,14,4,0,0,6,7,1,4,0,0,0,2,7,5,14
20210321,21MAR2021:00:00:00,UFU ELIZALDE,72,72,26,117,1,144,110,34,124,20,71,36,10,17,8,2,0,0,0,3,65,42,110
20210321,21MAR2021:00:00:00,UFU FERNANDEZ,158,139,259,36,2,297,103,194,283,14,0,12,78,77,57,33,30,10,0,13,39,48,103
20210321,21MAR2021:00:00:00,UFU FERRER,33,28,34,27,0,61,57,4,57,4,0,0,13,12,25,6,1,4,0,12,26,19,57
20210321,21MAR2021:00:00:00,UFU GRIERSON,80,60,63,77,0,140,138,2,140,0,3,5,34,28,39,20,9,2,0,29,50,59,138
20210321,21MAR2021:00:00:00,UFU GUTIERREZ,39,41,52,28,0,80,80,0,80,0,36,27,6,4,4,3,0,0,0,3,42,35,80
20210321,21MAR2021:00:00:00,UFU MUÑIZ,211,150,152,198,11,361,273,88,303,58,2,7,70,97,90,58,29,8,0,29,170,74,273
20210321,21MAR2021:00:00:00,UFU PENNA,22,9,22,7,2,31,27,4,27,4,0,3,14,2,4,4,0,4,0,5,10,12,27
20210321,21MAR2021:00:00:00,UFU PIROVANO,98,107,181,20,4,205,185,20,199,6,0,5,58,61,37,28,9,7,0,33,79,73,185
20210321,21MAR2021:00:00:00,UFU PIÑERO,98,70,93,61,14,168,160,8,162,6,3,11,41,35,30,16,21,11,0,10,104,44,160
20210321,21MAR2021:00:00:00,UFU RAMOS MEJIA,54,60,98,9,7,114,114,0,114,0,10,14,20,17,19,13,17,4,0,18,50,46,114
20210321,21MAR2021:00:00:00,UFU RIVADAVIA,110,88,140,35,23,198,164,34,164,34,0,2,66,48,42,6,24,10,0,31,65,67,164
20210321,21MAR2021:00:00:00,UFU SANTOJANNI,74,75,75,70,4,149,141,8,145,4,0,12,32,24,31,31,17,2,0,28,57,56,141
20210321,21MAR2021:00:00:00,UFU TORNU,28,36,42,14,8,64,60,4,60,4,1,0,17,23,10,6,5,2,0,11,25,24,60
20210321,21MAR2021:00:00:00,UFU VELEZ SARSFIELD,75,69,106,31,7,144,136,8,142,2,0,12,18,23,36,34,19,2,0,30,50,56,136
20210321,21MAR2021:00:00:00,UFU ZUBIZARRETA,97,84,124,43,14,181,155,26,181,0,0,7,39,41,35,30,19,10,0,24,67,64,155
20210322,22MAR2021:00:00:00,UFU ALVAREZ,131,155,224,53,9,286,206,80,206,80,12,32,79,50,41,36,25,11,0,28,87,91,206
20210322,22MAR2021:00:00:00,UFU ARGERICH,33,44,38,28,11,77,47,30,47,30,6,5,9,16,15,16,9,1,0,7,23,17,47
20210322,22MAR2021:00:00:00,UFU BORDA-MOYANO,42,33,49,24,2,75,73,2,73,2,0,3,20,23,12,10,2,5,0,2,40,31,73
20210322,22MAR2021:00:00:00,UFU DURAND,158,111,249,20,0,269,261,8,263,6,6,9,63,78,48,45,11,9,0,42,131,88,261
20210322,22MAR2021:00:00:00,UFU ELIZALDE,151,116,86,179,2,267,193,74,253,14,114,72,20,28,21,4,6,2,0,11,105,77,193
20210322,22MAR2021:00:00:00,UFU FERNANDEZ,240,164,330,64,10,404,240,164,384,20,0,14,114,114,61,53,34,14,0,38,102,100,240
20210322,22MAR2021:00:00:00,UFU FERRER,84,91,99,76,0,175,167,8,167,8,2,2,51,44,42,21,11,2,0,39,63,65,167
20210322,22MAR2021:00:00:00,UFU GRIERSON,146,101,112,116,19,247,243,4,243,4,0,6,79,56,59,30,15,2,0,50,95,98,243
20210322,22MAR2021:00:00:00,UFU GUTIERREZ,94,69,95,68,0,163,135,28,157,6,56,66,2,15,13,7,2,2,0,2,76,57,135
20210322,22MAR2021:00:00:00,UFU MUÑIZ,309,320,216,378,35,629,477,152,495,134,5,23,145,163,138,97,47,11,0,42,302,133,477
20210322,22MAR2021:00:00:00,UFU PENNA,48,37,67,13,5,85,69,16,77,8,0,10,16,19,15,8,7,10,0,8,33,27,69
20210322,22MAR2021:00:00:00,UFU PIROVANO,146,148,231,54,9,294,270,24,280,14,0,7,57,112,48,48,15,7,0,38,114,118,270
20210322,22MAR2021:00:00:00,UFU PIÑERO,139,120,158,81,20,259,253,6,257,2,2,0,55,70,65,40,23,4,0,33,144,72,253
20210322,22MAR2021:00:00:00,UFU RAMOS MEJIA,139,97,187,33,16,236,200,36,214,22,3,21,58,75,38,25,8,8,0,28,91,81,200
20210322,22MAR2021:00:00:00,UFU RIVADAVIA,249,174,293,81,49,423,287,136,289,134,0,8,146,103,54,66,36,10,0,33,127,127,287
20210322,22MAR2021:00:00:00,UFU SANTOJANNI,208,115,167,145,11,323,295,28,309,14,6,28,93,58,46,44,41,7,0,28,139,128,295
20210322,22MAR2021:00:00:00,UFU TORNU,78,72,117,28,5,150,128,22,130,20,5,18,12,50,28,22,12,3,0,20,53,55,128
20210322,22MAR2021:00:00:00,UFU VELEZ SARSFIELD,148,87,157,72,6,235,211,24,233,2,2,11,48,43,61,29,30,11,0,29,98,84,211
20210322,22MAR2021:00:00:00,UFU ZUBIZARRETA,113,98,132,63,16,211,209,2,211,0,0,8,40,70,43,14,14,22,0,24,96,89,209
20210323,23MAR2021:00:00:00,UFU ALVAREZ,158,165,275,40,8,323,263,60,269,54,3,19,88,94,47,34,21,17,0,44,115,104,263
20210323,23MAR2021:00:00:00,UFU ARGERICH,43,51,60,31,3,94,60,34,60,34,11,3,24,15,20,12,7,2,0,5,12,43,60
20210323,23MAR2021:00:00:00,UFU BORDA-MOYANO,36,18,35,17,2,54,54,0,54,0,0,2,14,11,17,4,6,0,0,8,23,23,54
20210323,23MAR2021:00:00:00,UFU DURAND,133,103,215,19,2,236,234,2,234,2,7,17,55,56,48,22,26,5,0,40,104,90,234
20210323,23MAR2021:00:00:00,UFU ELIZALDE,130,130,98,152,10,260,208,52,252,8,113,54,18,33,20,9,11,2,0,9,106,93,208
20210323,23MAR2021:00:00:00,UFU FERNANDEZ,230,171,320,66,15,401,177,224,389,12,0,17,102,97,97,50,27,11,0,38,61,76,177
20210323,23MAR2021:00:00:00,UFU FERRER,63,72,48,87,0,135,125,10,125,10,0,0,53,49,20,11,2,0,0,37,36,52,125
20210323,23MAR2021:00:00:00,UFU GRIERSON,138,123,110,119,32,261,241,20,255,6,0,17,79,55,53,28,14,15,0,43,101,97,241
20210323,23MAR2021:00:00:00,UFU GUTIERREZ,80,73,88,62,3,153,133,20,153,0,70,56,6,11,4,4,2,0,0,0,82,50,133
20210323,23MAR2021:00:00:00,UFU MUÑIZ,289,283,239,310,23,572,412,160,426,146,2,8,142,140,117,87,53,23,0,54,231,127,412
20210323,23MAR2021:00:00:00,UFU PENNA,39,19,41,15,2,58,56,2,56,2,0,1,6,18,13,11,5,4,0,8,28,19,56
20210323,23MAR2021:00:00:00,UFU PIROVANO,165,118,205,73,5,283,259,24,277,6,0,4,81,81,51,26,24,16,0,39,113,107,259
20210323,23MAR2021:00:00:00,UFU PIÑERO,138,161,179,87,33,299,291,8,293,6,4,6,88,73,55,27,30,16,0,35,171,85,291
20210323,23MAR2021:00:00:00,UFU RAMOS MEJIA,108,85,127,39,27,193,185,8,187,6,8,9,42,55,28,23,19,9,0,27,81,77,185
20210323,23MAR2021:00:00:00,UFU RIVADAVIA,217,167,232,89,63,384,358,26,358,26,0,10,115,100,72,36,30,21,0,57,161,140,358
20210323,23MAR2021:00:00:00,UFU SANTOJANNI,179,133,169,137,6,312,268,44,308,4,3,11,67,74,65,48,23,21,0,37,119,112,268
20210323,23MAR2021:00:00:00,UFU TORNU,82,77,93,54,12,159,143,16,143,16,4,9,50,38,25,13,10,10,0,25,59,59,143
20210323,23MAR2021:00:00:00,UFU VELEZ SARSFIELD,140,123,191,70,2,263,245,18,263,0,0,15,59,74,35,33,30,17,0,44,68,133,245
20210323,23MAR2021:00:00:00,UFU ZUBIZARRETA,144,129,183,86,4,273,241,32,273,0,0,36,36,68,55,34,30,14,0,28,110,103,241
20210324,24MAR2021:00:00:00,UFU ALVAREZ,134,112,183,44,19,246,214,32,214,32,4,19,69,47,31,53,14,9,0,53,78,83,214
20210324,24MAR2021:00:00:00,UFU ARGERICH,16,29,30,15,0,45,43,2,45,0,0,6,12,11,8,5,1,2,0,3,10,30,43
20210324,24MAR2021:00:00:00,UFU BORDA-MOYANO,11,11,14,6,2,22,22,0,22,0,0,2,9,1,7,3,0,0,0,2,13,7,22
20210324,24MAR2021:00:00:00,UFU DURAND,143,94,197,38,2,237,235,2,235,2,0,29,71,64,30,25,13,5,0,44,108,83,235
20210324,24MAR2021:00:00:00,UFU ELIZALDE,95,73,54,111,3,168,126,42,156,12,57,75,5,18,5,8,0,0,0,10,65,51,126
20210324,24MAR2021:00:00:00,UFU FERNANDEZ,140,109,223,24,2,249,129,120,245,4,0,8,88,44,50,23,20,16,0,27,50,51,129
20210324,24MAR2021:00:00:00,UFU FERRER,78,62,68,70,2,140,132,8,132,8,0,0,44,35,33,20,6,2,0,28,54,50,132
20210324,24MAR2021:00:00:00,UFU GRIERSON,168,117,127,150,8,285,273,12,279,6,2,12,113,37,54,38,21,8,0,50,93,130,273
20210324,24MAR2021:00:00:00,UFU GUTIERREZ,39,51,57,33,0,90,78,12,90,0,46,29,6,3,4,0,2,0,0,4,35,39,78
20210324,24MAR2021:00:00:00,UFU MUÑIZ,227,223,199,230,21,450,326,124,366,84,1,4,98,132,106,53,45,11,0,59,174,93,326
20210324,24MAR2021:00:00:00,UFU PENNA,21,13,28,6,0,34,34,0,34,0,0,0,13,3,4,1,7,6,0,5,12,17,34
20210324,24MAR2021:00:00:00,UFU PIROVANO,125,130,232,23,0,255,245,10,249,6,0,0,57,97,47,33,13,8,0,43,112,90,245
20210324,24MAR2021:00:00:00,UFU PIÑERO,145,122,167,67,33,267,255,12,257,10,0,22,57,56,63,45,12,12,0,31,151,72,255
20210324,24MAR2021:00:00:00,UFU RAMOS MEJIA,140,130,217,51,2,270,193,77,227,43,6,13,68,65,36,46,28,8,0,28,76,89,193
20210324,24MAR2021:00:00:00,UFU RIVADAVIA,195,140,249,74,12,335,315,20,323,12,1,11,110,104,37,38,26,8,0,46,142,127,315
20210324,24MAR2021:00:00:00,UFU SANTOJANNI,112,107,99,102,18,219,209,10,211,8,2,14,46,44,60,31,15,7,0,32,93,84,209
20210324,24MAR2021:00:00:00,UFU TORNU,65,60,71,45,9,125,113,12,113,12,8,16,31,18,25,15,8,4,0,22,44,47,113
20210324,24MAR2021:00:00:00,UFU VELEZ SARSFIELD,138,126,206,56,2,264,258,6,264,0,0,13,48,66,78,30,25,4,0,54,98,106,258
20210324,24MAR2021:00:00:00,UFU ZUBIZARRETA,114,106,131,74,15,220,204,16,220,0,0,8,51,45,38,33,19,26,0,23,98,83,204
20210325,25MAR2021:00:00:00,UFU ALVAREZ,149,156,243,54,8,305,287,18,287,18,9,20,82,62,46,50,30,6,0,48,115,122,287
20210325,25MAR2021:00:00:00,UFU ARGERICH,59,59,63,47,8,118,87,31,89,29,1,6,28,22,29,16,12,4,0,22,34,31,87
20210325,25MAR2021:00:00:00,UFU BORDA-MOYANO,30,15,16,29,0,45,43,2,43,2,0,6,9,8,8,5,4,5,0,5,22,16,43
20210325,25MAR2021:00:00:00,UFU DURAND,122,103,191,34,0,225,221,4,221,4,6,6,61,58,40,33,16,5,0,47,88,85,221
20210325,25MAR2021:00:00:00,UFU ELIZALDE,90,53,49,85,9,143,117,26,133,10,29,61,13,14,8,9,7,2,0,6,74,37,117
20210325,25MAR2021:00:00:00,UFU FERNANDEZ,325,219,441,87,16,544,216,328,514,30,0,22,149,122,121,66,40,24,0,41,64,108,216
20210325,25MAR2021:00:00:00,UFU FERRER,66,64,73,55,2,130,128,2,128,2,0,0,28,38,26,20,18,0,0,19,54,55,128
20210325,25MAR2021:00:00:00,UFU GRIERSON,161,118,138,110,31,279,267,12,271,8,0,17,99,75,53,24,9,2,0,2,7,258,267
20210325,25MAR2021:00:00:00,UFU GUTIERREZ,56,42,75,23,0,98,96,2,98,0,27,36,10,6,11,4,4,0,0,9,48,39,96
20210325,25MAR2021:00:00:00,UFU MUÑIZ,265,247,215,265,32,512,400,112,422,90,0,7,164,151,94,72,20,4,0,58,229,113,400
20210325,25MAR2021:00:00:00,UFU PENNA,27,44,47,22,2,71,47,24,71,0,0,1,16,15,6,4,9,20,0,5,23,19,47
20210325,25MAR2021:00:00:00,UFU PIROVANO,176,134,241,54,15,310,276,34,294,16,0,8,86,83,55,44,22,12,0,52,118,106,276
20210325,25MAR2021:00:00:00,UFU PIÑERO,133,99,112,69,51,232,222,10,222,10,0,16,53,65,33,38,18,9,0,32,126,64,222
20210325,25MAR2021:00:00:00,UFU RAMOS MEJIA,106,103,147,45,17,209,177,32,191,18,6,12,42,54,37,30,20,8,0,35,72,70,177
20210325,25MAR2021:00:00:00,UFU RIVADAVIA,225,154,247,82,50,379,369,10,371,8,0,10,120,99,70,46,26,8,0,52,161,155,369
20210325,25MAR2021:00:00:00,UFU SANTOJANNI,106,71,82,88,7,177,161,16,169,8,1,15,44,31,42,25,11,8,0,37,56,68,161
20210325,25MAR2021:00:00:00,UFU TORNU,90,60,109,34,7,150,132,18,134,16,4,13,25,33,40,23,11,1,0,27,54,51,132
20210325,25MAR2021:00:00:00,UFU VELEZ SARSFIELD,139,169,237,65,6,308,286,22,304,4,0,14,84,65,68,35,32,10,0,61,114,111,286
20210325,25MAR2021:00:00:00,UFU ZUBIZARRETA,73,82,115,34,6,155,153,2,155,0,0,7,38,33,35,20,15,7,0,9,1,143,153
20210326,26MAR2021:00:00:00,UFU ALVAREZ,182,157,267,66,6,339,273,66,285,54,15,17,77,91,55,41,26,17,0,57,100,116,273
20210326,26MAR2021:00:00:00,UFU ARGERICH,79,54,69,56,8,133,87,46,93,40,6,6,24,38,20,24,13,2,0,24,25,38,87
20210326,26MAR2021:00:00:00,UFU BORDA-MOYANO,32,49,43,34,4,81,79,2,79,2,0,5,12,23,14,19,8,0,0,5,41,33,79
20210326,26MAR2021:00:00:00,UFU DURAND,154,134,254,27,7,288,274,14,274,14,4,27,72,66,52,29,21,17,0,68,112,90,274
20210326,26MAR2021:00:00:00,UFU ELIZALDE,100,91,62,127,2,191,137,54,161,30,63,62,14,25,14,8,3,2,0,7,82,48,137
20210326,26MAR2021:00:00:00,UFU FERNANDEZ,260,214,385,80,9,474,217,257,457,17,0,20,119,147,81,61,32,14,0,40,87,89,217
20210326,26MAR2021:00:00:00,UFU FERRER,80,79,67,83,9,159,149,10,149,10,0,0,49,45,30,27,6,2,0,39,47,63,149
20210326,26MAR2021:00:00:00,UFU GRIERSON,169,148,129,143,45,317,309,8,313,4,0,33,86,74,55,49,13,7,0,4,9,296,309
20210326,26MAR2021:00:00:00,UFU GUTIERREZ,72,57,92,31,6,129,109,20,127,2,43,44,9,21,7,4,1,0,0,4,56,49,109
20210326,26MAR2021:00:00:00,UFU MUÑIZ,295,318,212,373,28,613,475,138,491,122,3,13,168,182,108,80,46,13,0,81,253,141,475
20210326,26MAR2021:00:00:00,UFU PENNA,32,42,61,9,4,74,62,12,74,0,0,1,17,12,17,10,11,6,0,11,26,25,62
20210326,26MAR2021:00:00:00,UFU PIROVANO,186,133,256,61,2,319,271,48,309,10,0,25,85,90,59,31,18,11,0,44,120,107,271
20210326,26MAR2021:00:00:00,UFU PIÑERO,212,214,250,148,28,426,406,20,412,14,4,36,113,73,95,65,23,17,0,57,199,146,406
20210326,26MAR2021:00:00:00,UFU RAMOS MEJIA,103,112,150,47,18,215,191,24,197,18,8,9,42,64,33,29,20,10,0,42,68,78,191
20210326,26MAR2021:00:00:00,UFU RIVADAVIA,276,205,304,90,87,481,437,44,445,36,0,17,171,112,71,52,42,16,0,92,174,170,437
20210326,26MAR2021:00:00:00,UFU SANTOJANNI,176,158,187,137,10,334,290,44,322,12,2,24,113,79,59,34,10,13,0,36,135,119,290
20210326,26MAR2021:00:00:00,UFU TORNU,88,114,156,29,17,202,190,12,194,8,6,12,47,64,36,22,13,2,0,26,80,84,190
20210326,26MAR2021:00:00:00,UFU VELEZ SARSFIELD,161,125,210,72,4,286,242,44,286,0,0,15,66,92,59,27,18,9,0,39,82,121,242
20210326,26MAR2021:00:00:00,UFU ZUBIZARRETA,147,99,142,97,7,246,238,8,246,0,0,7,72,52,42,39,26,8,0,42,101,95,238
20210327,27MAR2021:00:00:00,UFU ALVAREZ,180,163,247,61,35,343,325,18,325,18,4,42,79,76,60,50,19,13,0,59,131,134,325
20210327,27MAR2021:00:00:00,UFU ARGERICH,14,7,10,11,0,21,21,0,21,0,4,2,7,4,0,1,3,0,0,4,8,9,21
20210327,27MAR2021:00:00:00,UFU BORDA-MOYANO,20,21,19,22,0,41,41,0,41,0,1,7,1,6,11,9,4,2,0,3,20,18,41
20210327,27MAR2021:00:00:00,UFU DURAND,159,148,270,31,6,307,297,10,297,10,2,20,85,84,48,34,24,10,0,99,103,95,297
20210327,27MAR2021:00:00:00,UFU ELIZALDE,60,56,57,56,3,116,86,30,106,10,48,47,6,3,12,0,0,0,0,8,46,32,86
20210327,27MAR2021:00:00:00,UFU FERNANDEZ,176,145,258,55,8,321,141,180,299,22,0,11,88,95,52,41,20,14,0,8,26,106,141
20210327,27MAR2021:00:00:00,UFU FERRER,57,65,50,68,4,122,114,8,114,8,0,2,34,41,30,7,6,2,0,24,38,52,114
20210327,27MAR2021:00:00:00,UFU GRIERSON,144,90,110,116,8,234,222,12,228,6,0,13,76,51,40,36,14,4,0,0,4,218,222
20210327,27MAR2021:00:00:00,UFU GUTIERREZ,40,36,44,28,4,76,58,18,68,8,31,21,3,11,10,0,0,0,0,7,29,21,58
20210327,27MAR2021:00:00:00,UFU MUÑIZ,223,261,167,299,18,484,330,154,346,138,0,8,128,139,73,88,39,9,0,58,173,99,330
20210327,27MAR2021:00:00:00,UFU PENNA,20,55,60,6,10,76,65,11,69,7,1,14,33,9,8,4,0,7,0,18,21,26,65
20210327,27MAR2021:00:00:00,UFU PIROVANO,129,84,179,26,8,213,185,28,207,6,0,2,69,74,23,28,12,5,0,25,82,78,185
20210327,27MAR2021:00:00:00,UFU PIÑERO,208,172,217,135,28,380,360,20,360,20,2,14,115,78,78,54,28,11,0,60,171,114,360
20210327,27MAR2021:00:00:00,UFU RAMOS MEJIA,107,86,158,24,11,193,149,44,151,42,12,9,44,67,25,21,8,7,0,25,67,57,149
20210327,27MAR2021:00:00:00,UFU RIVADAVIA,124,95,158,58,3,219,215,4,215,4,0,4,84,51,34,28,15,3,0,31,92,91,215
20210327,27MAR2021:00:00:00,UFU SANTOJANNI,179,119,155,134,9,298,270,28,286,12,0,17,82,91,63,26,10,9,0,38,120,112,270
20210327,27MAR2021:00:00:00,UFU TORNU,87,78,110,46,9,165,143,22,145,20,6,10,35,45,29,16,15,9,0,19,61,63,143
20210327,27MAR2021:00:00:00,UFU VELEZ SARSFIELD,161,120,195,76,10,281,261,20,277,4,0,5,53,69,66,54,21,13,0,49,85,127,261
20210327,27MAR2021:00:00:00,UFU ZUBIZARRETA,97,74,98,56,17,171,159,12,171,0,0,4,40,53,37,16,16,5,0,30,68,61,159
20210328,28MAR2021:00:00:00,UFU ALVAREZ,199,151,264,58,28,350,322,28,324,26,8,36,66,78,69,49,31,13,0,73,114,130,322
20210328,28MAR2021:00:00:00,UFU ARGERICH,18,43,24,37,0,61,59,2,61,0,2,4,19,8,16,9,3,0,0,7,14,38,59
20210328,28MAR2021:00:00:00,UFU BORDA-MOYANO,11,13,5,17,2,24,20,4,20,4,0,0,5,10,2,2,5,0,0,2,10,8,20
20210328,28MAR2021:00:00:00,UFU DURAND,7,4,7,3,1,11,9,2,11,0,0,2,2,2,0,2,1,2,0,4,5,0,9
20210328,28MAR2021:00:00:00,UFU ELIZALDE,87,70,46,109,2,157,131,26,151,6,52,58,8,9,26,4,0,0,0,4,76,51,131
20210328,28MAR2021:00:00:00,UFU FERNANDEZ,225,150,294,61,20,375,127,248,355,20,0,18,84,109,72,49,16,27,0,34,40,51,127
20210328,28MAR2021:00:00:00,UFU FERRER,78,52,68,59,3,130,124,6,124,6,0,2,38,37,24,20,5,4,0,29,46,49,124
20210328,28MAR2021:00:00:00,UFU GRIERSON,173,122,82,199,14,295,273,22,289,6,0,14,71,96,44,41,23,6,0,3,6,264,273
20210328,28MAR2021:00:00:00,UFU GUTIERREZ,45,28,33,40,0,73,69,4,71,2,34,23,2,6,3,0,3,2,0,5,36,28,69
20210328,28MAR2021:00:00:00,UFU MUÑIZ,241,226,193,232,42,467,396,71,420,47,0,11,116,129,82,69,38,22,0,66,216,113,396
20210328,28MAR2021:00:00:00,UFU PENNA,23,14,23,14,0,37,33,4,33,4,0,1,4,2,13,9,6,2,0,4,16,13,33
20210328,28MAR2021:00:00:00,UFU PIROVANO,165,123,234,41,13,288,274,14,284,4,2,11,72,87,51,40,16,9,0,43,116,115,274
20210328,28MAR2021:00:00:00,UFU PIÑERO,147,149,180,78,38,296,284,12,284,12,0,20,106,48,72,44,6,0,0,39,151,81,284
20210328,28MAR2021:00:00:00,UFU RAMOS MEJIA,102,90,145,38,9,192,172,20,174,18,3,20,36,43,40,30,11,9,0,37,64,71,172
20210328,28MAR2021:00:00:00,UFU RIVADAVIA,195,170,269,74,22,365,337,28,339,26,0,12,102,107,62,43,28,11,0,64,133,138,337
20210328,28MAR2021:00:00:00,UFU SANTOJANNI,131,119,160,76,14,250,230,20,238,12,0,13,57,67,35,38,25,15,0,54,86,90,230
20210328,28MAR2021:00:00:00,UFU TORNU,69,65,83,37,14,134,120,14,120,14,0,7,26,30,29,27,13,2,0,29,42,49,120
20210328,28MAR2021:00:00:00,UFU VELEZ SARSFIELD,155,113,200,45,23,268,256,12,264,4,0,7,71,55,50,42,26,17,0,54,103,99,256
20210328,28MAR2021:00:00:00,UFU ZUBIZARRETA,99,74,101,64,8,173,153,20,173,0,0,4,39,42,20,35,18,15,0,20,70,63,153
20210329,29MAR2021:00:00:00,UFU ALVAREZ,178,173,253,84,14,351,242,109,242,109,13,27,86,83,57,39,28,18,0,42,103,97,242
20210329,29MAR2021:00:00:00,UFU ARGERICH,100,99,76,120,3,199,115,84,115,84,11,15,63,43,32,18,6,11,0,32,37,46,115
20210418,18APR2021:00:00:00,UFU FERNANDEZ,192,186,288,67,23,378,170,208,366,12,0,8,89,114,51,56,40,20,0,37,60,73,170
20210418,18APR2021:00:00:00,UFU FERRER,109,121,111,119,0,230,220,10,220,10,2,5,52,72,51,23,22,3,0,59,99,62,220
20210418,18APR2021:00:00:00,UFU GRIERSON,117,119,92,99,45,236,234,2,234,2,0,11,61,63,39,46,13,3,0,58,86,90,234
20210418,18APR2021:00:00:00,UFU GUTIERREZ,127,69,134,53,9,196,158,38,194,2,37,30,42,31,36,11,8,1,0,30,74,54,158
20210418,18APR2021:00:00:00,UFU MUÑIZ,217,189,181,207,18,406,286,120,334,72,0,10,110,78,90,57,44,17,0,53,155,78,286
20210418,18APR2021:00:00:00,UFU PENNA,45,52,76,17,4,97,83,14,89,8,0,2,24,31,22,5,9,4,0,20,34,29,83
20210418,18APR2021:00:00:00,UFU PIROVANO,157,164,266,50,5,321,309,12,319,2,0,15,56,67,75,53,40,15,0,76,129,97,309
20210418,18APR2021:00:00:00,UFU PIÑERO,176,151,239,67,21,327,305,22,311,16,2,19,63,66,81,51,24,21,0,51,163,88,305
20210418,18APR2021:00:00:00,UFU RAMOS MEJIA,133,106,175,45,19,239,213,26,219,20,1,5,60,52,59,34,14,14,0,57,72,84,213
20210418,18APR2021:00:00:00,UFU RIVADAVIA,133,109,176,53,13,242,232,10,232,10,0,4,58,64,65,34,14,3,0,70,73,81,232
20210418,18APR2021:00:00:00,UFU SANTOJANNI,179,164,176,154,13,343,325,18,331,12,2,17,70,86,64,59,28,17,0,65,131,129,325
20210418,18APR2021:00:00:00,UFU TORNU,151,132,154,102,27,283,273,10,275,8,2,9,53,101,60,33,22,3,0,50,127,96,273
20210418,18APR2021:00:00:00,UFU VELEZ SARSFIELD,152,133,220,64,1,285,279,6,283,2,0,14,64,49,69,52,25,12,0,67,132,80,279
20210418,18APR2021:00:00:00,UFU ZUBIZARRETA,143,77,148,61,11,220,204,16,220,0,0,3,45,42,45,36,29,20,0,18,114,72,204
20210419,19APR2021:00:00:00,UFU ALVAREZ,322,303,416,172,37,625,470,155,470,155,18,52,167,147,119,69,35,18,0,111,207,151,470
20210419,19APR2021:00:00:00,UFU ARGERICH,210,157,208,149,10,367,351,16,357,10,19,25,82,97,83,40,18,3,0,68,188,95,351
20210419,19APR2021:00:00:00,UFU BORDA-MOYANO,80,65,62,72,11,145,141,4,141,4,0,3,26,37,38,25,11,5,0,21,63,57,141
20210419,19APR2021:00:00:00,UFU DURAND,235,225,348,87,25,460,450,10,452,8,8,16,94,148,88,58,29,19,0,119,205,126,450
20210419,19APR2021:00:00:00,UFU ELIZALDE,120,93,83,128,2,213,171,42,201,12,81,90,6,18,14,2,2,0,0,20,87,64,171
20210419,19APR2021:00:00:00,UFU FERNANDEZ,144,134,198,61,19,278,236,42,258,20,0,4,47,85,60,30,44,8,0,60,84,92,236
20210419,19APR2021:00:00:00,UFU FERRER,113,147,118,136,6,260,252,8,252,8,0,2,67,89,58,31,8,5,0,67,109,76,252
20210419,19APR2021:00:00:00,UFU GRIERSON,144,158,138,126,38,302,280,22,292,10,0,6,61,89,83,37,24,2,0,55,132,93,280
20210419,19APR2021:00:00:00,UFU GUTIERREZ,153,93,171,62,13,246,228,18,244,2,61,30,53,56,23,14,9,0,0,41,109,76,228
20210419,19APR2021:00:00:00,UFU MUÑIZ,319,397,268,423,25,716,490,226,546,170,0,6,193,191,120,126,64,16,0,87,279,124,490
20210419,19APR2021:00:00:00,UFU PENNA,98,75,127,46,0,173,153,20,169,4,0,6,39,46,28,29,18,7,0,44,67,42,153
20210419,19APR2021:00:00:00,UFU PIROVANO,200,202,287,84,31,402,368,34,396,6,6,10,91,108,82,61,34,10,0,80,147,141,368
20210419,19APR2021:00:00:00,UFU PIÑERO,198,201,264,118,17,399,391,8,397,2,2,24,124,98,75,48,23,5,0,74,204,113,391
20210419,19APR2021:00:00:00,UFU RAMOS MEJIA,231,192,319,77,27,423,379,44,397,26,4,20,95,134,54,57,35,24,0,78,151,149,379
20210419,19APR2021:00:00:00,UFU RIVADAVIA,233,155,231,125,32,388,360,28,362,26,0,10,106,120,56,56,17,23,0,92,121,144,360
20210419,19APR2021:00:00:00,UFU SANTOJANNI,224,191,214,183,18,415,395,20,411,4,8,16,83,106,106,55,29,12,0,82,178,134,395
20210419,19APR2021:00:00:00,UFU TORNU,193,219,285,111,16,412,386,26,388,24,9,15,73,115,103,69,12,16,0,75,162,145,386
20210419,19APR2021:00:00:00,UFU VELEZ SARSFIELD,114,153,184,75,8,267,251,16,263,4,0,3,50,78,51,42,26,17,0,58,93,100,251
20210419,19APR2021:00:00:00,UFU ZUBIZARRETA,169,171,178,152,10,340,332,8,340,0,0,4,82,89,71,47,32,15,0,51,187,94,332
20210420,20APR2021:00:00:00,UFU ALVAREZ,297,226,392,114,17,523,487,36,491,32,23,29,136,147,75,66,31,16,0,95,257,135,487
20210420,20APR2021:00:00:00,UFU ARGERICH,141,131,157,103,12,272,240,32,250,22,16,4,70,73,58,25,21,5,0,56,97,84,240
20210420,20APR2021:00:00:00,UFU BORDA-MOYANO,56,49,62,38,5,105,103,2,103,2,2,6,13,33,17,13,13,8,0,17,44,42,103
20210420,20APR2021:00:00:00,UFU DURAND,210,159,303,52,14,369,349,20,349,20,2,11,93,97,77,43,36,10,0,94,151,104,349
20210420,20APR2021:00:00:00,UFU ELIZALDE,127,80,63,140,4,207,161,46,189,18,80,67,19,24,12,3,2,0,0,9,87,65,161
20210420,20APR2021:00:00:00,UFU FERNANDEZ,129,128,190,56,11,257,241,16,247,10,0,4,60,78,37,45,15,18,0,61,88,92,241
20210420,20APR2021:00:00:00,UFU FERRER,125,96,127,84,10,221,213,8,213,8,0,1,74,61,36,23,23,3,0,53,96,64,213
20210420,20APR2021:00:00:00,UFU GRIERSON,128,119,106,109,32,247,247,0,247,0,0,12,70,64,59,29,9,4,0,41,116,90,247
20210420,20APR2021:00:00:00,UFU GUTIERREZ,118,135,162,73,18,253,225,28,251,2,61,43,57,64,11,11,3,3,0,44,111,69,225
20210420,20APR2021:00:00:00,UFU MUÑIZ,310,383,248,410,35,693,485,208,505,188,0,3,163,176,145,110,77,19,0,97,264,124,485
20210420,20APR2021:00:00:00,UFU PENNA,111,62,135,24,14,173,159,14,169,4,0,9,56,48,26,21,11,2,0,30,80,49,159
20210420,20APR2021:00:00:00,UFU PIROVANO,214,140,277,58,19,354,294,60,346,8,0,8,77,90,80,61,24,14,0,64,113,117,294
20210420,20APR2021:00:00:00,UFU PIÑERO,242,174,272,109,35,416,408,8,408,8,12,23,127,115,53,57,18,11,0,69,215,122,408
20210420,20APR2021:00:00:00,UFU RAMOS MEJIA,202,204,309,69,28,406,372,34,396,10,17,19,87,91,81,65,33,13,0,76,161,135,372
20210420,20APR2021:00:00:00,UFU RIVADAVIA,229,175,267,113,24,404,386,18,396,8,0,2,137,104,69,54,28,10,0,84,114,184,386
20210420,20APR2021:00:00:00,UFU SANTOJANNI,214,177,192,191,8,391,379,12,383,8,2,8,96,92,101,44,33,15,0,97,114,168,379
20210420,20APR2021:00:00:00,UFU TORNU,188,145,218,97,18,333,311,22,311,22,2,17,85,107,51,33,19,19,0,55,149,107,311
20210420,20APR2021:00:00:00,UFU VELEZ SARSFIELD,178,161,256,62,21,339,325,14,337,2,0,3,55,88,85,70,29,9,0,54,167,104,325
20210420,20APR2021:00:00:00,UFU ZUBIZARRETA,212,148,192,152,16,360,338,22,360,0,0,8,98,74,82,55,31,12,0,51,191,96,338
20210421,21APR2021:00:00:00,UFU ALVAREZ,254,196,352,83,15,450,378,72,378,72,13,20,118,102,90,79,25,3,0,103,169,106,378
20210421,21APR2021:00:00:00,UFU ARGERICH,154,150,168,125,11,304,274,30,282,22,16,30,54,78,67,29,18,12,0,66,129,77,274
20210421,21APR2021:00:00:00,UFU BORDA-MOYANO,44,41,63,22,0,85,81,4,81,4,0,3,17,14,14,13,13,11,0,13,30,38,81
20210421,21APR2021:00:00:00,UFU DURAND,179,173,289,48,15,352,338,14,338,14,2,15,66,112,72,47,27,11,0,66,176,96,338
20210421,21APR2021:00:00:00,UFU ELIZALDE,75,64,61,78,0,139,113,26,129,10,54,45,11,12,7,4,6,0,0,13,60,40,113
20210421,21APR2021:00:00:00,UFU FERNANDEZ,128,128,190,43,23,256,216,40,242,14,0,7,57,67,41,41,29,14,0,73,64,79,216
20210421,21APR2021:00:00:00,UFU FERRER,89,97,103,79,4,186,184,2,184,2,0,0,68,46,34,19,19,0,0,36,98,50,184
20210421,21APR2021:00:00:00,UFU GRIERSON,122,134,119,121,16,256,252,4,252,4,0,6,86,74,54,25,8,3,0,53,102,97,252
20210421,21APR2021:00:00:00,UFU GUTIERREZ,172,133,169,109,27,305,279,26,305,0,67,53,53,61,37,31,3,0,0,41,147,91,279
20210421,21APR2021:00:00:00,UFU MUÑIZ,295,325,194,405,21,620,392,228,464,156,0,5,149,182,114,107,47,16,0,92,207,93,392
20210421,21APR2021:00:00:00,UFU PENNA,90,72,132,22,8,162,142,20,152,10,0,17,45,39,33,11,11,6,0,24,88,29,142
20210421,21APR2021:00:00:00,UFU PIROVANO,185,128,249,50,14,313,277,36,309,4,0,7,53,89,61,43,27,33,0,67,107,103,277
20210421,21APR2021:00:00:00,UFU PIÑERO,204,158,257,80,25,362,346,16,354,8,0,13,101,81,91,37,27,12,0,53,206,81,346
20210421,21APR2021:00:00:00,UFU RAMOS MEJIA,219,193,311,80,21,412,336,76,394,18,6,28,89,117,81,57,23,11,0,70,133,133,336
20210421,21APR2021:00:00:00,UFU RIVADAVIA,200,157,265,64,28,357,292,65,300,57,0,13,90,110,48,54,23,19,0,77,96,116,292
20210421,21APR2021:00:00:00,UFU SANTOJANNI,259,287,314,202,30,546,532,14,538,8,11,41,127,117,105,83,41,21,0,186,209,137,532
20210421,21APR2021:00:00:00,UFU TORNU,204,148,258,80,14,352,334,18,336,16,9,25,71,73,70,70,26,8,0,53,173,108,334
20210421,21APR2021:00:00:00,UFU VELEZ SARSFIELD,150,149,211,66,22,299,283,16,295,4,0,6,71,76,48,44,33,21,0,57,147,79,283
20210421,21APR2021:00:00:00,UFU ZUBIZARRETA,188,110,157,129,12,298,288,10,298,0,0,23,58,85,76,26,27,3,0,35,177,76,288
20210422,22APR2021:00:00:00,UFU ALVAREZ,244,233,363,105,9,477,441,36,441,36,14,37,137,133,39,61,43,13,0,71,266,104,441
20210422,22APR2021:00:00:00,UFU ARGERICH,138,125,159,99,5,263,245,18,245,18,17,19,51,56,39,30,27,24,0,49,119,76,245
20210422,22APR2021:00:00:00,UFU BORDA-MOYANO,50,48,49,45,4,98,90,8,90,8,0,6,7,30,35,10,6,4,0,15,42,33,90
20210422,22APR2021:00:00:00,UFU DURAND,201,103,258,39,7,304,284,20,292,12,9,15,75,92,46,42,20,5,0,60,156,68,284
20210422,22APR2021:00:00:00,UFU ELIZALDE,59,53,47,65,0,112,96,16,108,4,41,52,1,11,6,0,1,0,0,16,49,31,96
20210422,22APR2021:00:00:00,UFU FERNANDEZ,151,108,196,47,16,259,227,32,237,22,0,4,64,77,39,52,15,8,0,59,70,98,227
20210422,22APR2021:00:00:00,UFU FERRER,124,114,105,129,4,238,238,0,238,0,0,6,58,82,43,29,20,0,0,50,119,69,238
20210422,22APR2021:00:00:00,UFU GRIERSON,133,102,110,109,16,235,209,26,227,8,0,10,80,67,38,26,7,7,0,40,85,84,209
20210422,22APR2021:00:00:00,UFU GUTIERREZ,163,138,211,73,17,301,287,14,301,0,44,36,65,86,33,27,5,5,0,40,152,94,287
20210422,22APR2021:00:00:00,UFU MUÑIZ,285,357,228,364,50,642,470,172,492,150,0,8,154,157,137,129,48,9,0,91,263,116,470
20210422,22APR2021:00:00:00,UFU PENNA,65,64,102,25,2,129,111,18,127,2,0,2,30,21,22,31,18,5,0,23,58,30,111
20210422,22APR2021:00:00:00,UFU PIROVANO,158,175,256,57,20,333,289,44,327,6,2,9,96,76,65,45,25,15,0,53,110,125,289
20210422,22APR2021:00:00:00,UFU PIÑERO,186,132,208,80,30,318,316,2,318,0,1,18,67,71,90,39,27,5,0,55,173,85,316
20210422,22APR2021:00:00:00,UFU RAMOS MEJIA,203,153,251,83,22,356,302,54,334,22,11,20,81,91,70,43,23,17,0,77,103,122,302
20210422,22APR2021:00:00:00,UFU RIVADAVIA,206,173,209,134,36,379,363,16,371,8,0,13,108,110,68,42,33,5,0,82,133,145,363
20210422,22APR2021:00:00:00,UFU SANTOJANNI,304,206,255,235,20,510,478,32,500,10,3,39,109,120,118,79,29,13,0,169,201,108,478
20210422,22APR2021:00:00:00,UFU TORNU,169,139,224,70,14,308,294,14,302,6,20,16,53,85,65,39,27,3,0,51,142,101,294
20210422,22APR2021:00:00:00,UFU VELEZ SARSFIELD,199,164,247,99,17,363,344,19,354,9,0,15,85,67,84,55,41,16,0,71,155,118,344
20210422,22APR2021:00:00:00,UFU ZUBIZARRETA,132,93,98,120,7,225,223,2,225,0,0,5,64,52,42,38,21,3,0,24,146,53,223
20210423,23APR2021:00:00:00,UFU ALVAREZ,261,166,315,99,13,427,347,80,351,76,13,24,119,90,77,77,20,7,0,62,184,101,347
20210423,23APR2021:00:00:00,UFU ARGERICH,139,123,137,109,16,262,226,36,230,32,5,14,48,66,60,38,19,12,0,40,121,64,226
20210423,23APR2021:00:00:00,UFU BORDA-MOYANO,58,52,52,53,5,110,99,11,99,11,0,4,17,22,32,24,9,2,0,13,51,35,99
20210423,23APR2021:00:00:00,UFU DURAND,177,154,276,49,6,331,323,8,323,8,1,3,102,99,59,42,16,9,0,80,152,91,323
20210423,23APR2021:00:00:00,UFU ELIZALDE,72,51,56,63,4,123,101,22,113,10,55,44,4,5,12,3,0,0,0,9,53,39,101
20210423,23APR2021:00:00:00,UFU FERNANDEZ,135,120,179,54,22,255,221,34,231,24,0,7,57,76,52,38,20,5,0,44,24,153,221
20210423,23APR2021:00:00:00,UFU FERRER,119,81,94,86,20,200,190,10,192,8,2,4,66,53,46,21,6,2,0,41,102,47,190
20210423,23APR2021:00:00:00,UFU GRIERSON,149,129,127,122,29,278,246,32,268,10,0,21,74,64,52,35,16,16,0,52,106,88,246
20210423,23APR2021:00:00:00,UFU GUTIERREZ,158,128,201,59,26,286,258,28,286,0,43,55,37,63,45,28,13,2,0,54,118,84,258
20210423,23APR2021:00:00:00,UFU MUÑIZ,265,310,215,335,25,575,369,206,457,118,2,2,151,164,113,77,42,24,0,76,205,88,369
20210423,23APR2021:00:00:00,UFU PENNA,68,88,116,38,2,156,130,26,152,4,0,2,36,40,26,33,13,6,0,32,61,36,130
20210423,23APR2021:00:00:00,UFU PIROVANO,165,189,272,51,31,354,284,70,350,4,2,8,79,108,66,44,29,18,0,59,113,112,284
20210423,23APR2021:00:00:00,UFU PIÑERO,188,152,217,107,16,340,326,14,330,10,2,7,90,118,64,33,18,8,0,58,170,96,326
20210423,23APR2021:00:00:00,UFU RAMOS MEJIA,213,149,253,89,20,362,282,80,300,62,11,13,90,83,81,51,20,13,0,74,102,106,282
20210423,23APR2021:00:00:00,UFU RIVADAVIA,174,142,200,89,27,316,290,26,300,16,0,6,82,72,76,52,22,6,0,87,82,119,290
20210423,23APR2021:00:00:00,UFU SANTOJANNI,221,197,217,180,21,418,392,26,412,6,2,21,90,116,89,69,21,10,0,101,206,85,392
20210423,23APR2021:00:00:00,UFU TORNU,165,157,223,81,18,322,278,44,302,20,12,20,68,85,64,52,13,8,0,45,140,93,278
20210423,23APR2021:00:00:00,UFU VELEZ SARSFIELD,157,127,199,64,21,284,268,16,280,4,0,9,79,58,57,41,22,18,0,58,130,80,268
20210423,23APR2021:00:00:00,UFU ZUBIZARRETA,214,136,217,116,17,350,350,0,350,0,0,16,77,96,62,45,41,13,0,57,192,101,350
20210424,24APR2021:00:00:00,UFU ALVAREZ,255,177,310,97,25,432,409,23,413,19,10,29,103,121,85,47,29,8,0,83,203,122,409
20210424,24APR2021:00:00:00,UFU ARGERICH,31,32,36,27,0,63,63,0,63,0,0,0,12,21,12,4,11,3,0,19,25,19,63
20210424,24APR2021:00:00:00,UFU BORDA-MOYANO,53,46,59,40,0,99,91,8,91,8,0,4,26,32,16,14,5,2,0,15,43,33,91
20210424,24APR2021:00:00:00,UFU DURAND,167,125,252,33,7,292,288,4,288,4,16,13,62,74,51,40,21,15,0,69,141,76,288
20210424,24APR2021:00:00:00,UFU ELIZALDE,61,67,60,68,0,128,104,24,120,8,60,42,7,12,6,1,0,0,0,14,51,39,104
20210424,24APR2021:00:00:00,UFU FERNANDEZ,126,118,181,47,16,244,142,102,238,6,0,9,74,54,37,31,22,17,0,39,11,92,142
20210424,24APR2021:00:00:00,UFU FERRER,70,105,78,90,7,175,173,2,173,2,0,0,40,76,35,9,13,2,0,45,77,51,173
20210424,24APR2021:00:00:00,UFU GRIERSON,123,97,101,78,41,220,214,6,214,6,0,7,37,66,52,43,11,4,0,58,81,75,214
20210424,24APR2021:00:00:00,UFU GUTIERREZ,141,110,175,50,26,251,235,16,241,10,41,29,45,63,36,35,2,0,0,45,110,75,235
20210424,24APR2021:00:00:00,UFU MUÑIZ,187,248,201,220,14,435,253,182,361,74,0,2,104,131,110,60,19,9,0,55,127,70,253
20210424,24APR2021:00:00:00,UFU PENNA,31,55,54,30,2,86,76,10,84,2,0,4,21,11,17,20,7,6,0,19,36,21,76
20210424,24APR2021:00:00:00,UFU PIROVANO,96,87,139,31,13,183,159,24,179,4,0,0,48,45,41,20,18,11,0,32,55,72,159
20210424,24APR2021:00:00:00,UFU PIÑERO,148,209,190,157,10,357,327,30,335,22,0,14,85,125,70,51,12,0,0,41,190,96,327
20210424,24APR2021:00:00:00,UFU RAMOS MEJIA,143,163,222,50,34,306,230,76,276,30,0,5,79,75,54,56,14,23,0,65,80,84,230
20210424,24APR2021:00:00:00,UFU RIVADAVIA,176,126,229,49,24,302,218,84,218,84,0,3,99,73,47,41,27,12,0,56,67,93,218
20210424,24APR2021:00:00:00,UFU SANTOJANNI,214,204,217,181,20,418,402,16,416,2,0,13,122,73,100,57,36,17,0,138,171,93,402
20210424,24APR2021:00:00:00,UFU TORNU,130,159,206,48,35,289,267,22,267,22,8,20,41,77,81,30,24,8,0,48,132,86,267
20210424,24APR2021:00:00:00,UFU VELEZ SARSFIELD,73,59,104,24,4,132,128,4,130,2,0,3,32,36,30,14,6,11,0,13,71,44,128
20210501,01MAY2021:00:00:00,UFU RAMOS MEJIA,117,90,151,36,20,207,169,38,197,10,0,5,36,63,54,34,10,5,0,47,63,58,169
20210501,01MAY2021:00:00:00,UFU RIVADAVIA,137,122,180,56,23,259,245,14,245,14,4,7,64,47,50,51,26,10,0,51,79,115,245
20210501,01MAY2021:00:00:00,UFU SANTOJANNI,231,189,229,184,7,420,406,14,416,4,2,30,85,79,86,81,41,16,0,124,191,91,406
20210501,01MAY2021:00:00:00,UFU TORNU,87,83,72,78,20,170,152,18,154,16,4,5,34,54,40,22,5,6,0,28,74,50,152
20210501,01MAY2021:00:00:00,UFU VELEZ SARSFIELD,122,121,191,38,14,243,233,10,237,6,0,1,45,58,66,49,21,3,0,44,116,73,233
20210501,01MAY2021:00:00:00,UFU ZUBIZARRETA,83,85,103,57,8,168,168,0,168,0,0,3,32,30,49,26,14,14,0,9,105,54,168
20210502,02MAY2021:00:00:00,UFU ALVAREZ,172,149,261,42,18,321,299,22,299,22,1,24,64,74,52,57,42,7,0,64,141,94,299
20210502,02MAY2021:00:00:00,UFU ARGERICH,40,32,34,34,4,72,70,2,72,0,0,2,12,17,17,14,5,5,0,24,15,30,70
20210502,02MAY2021:00:00:00,UFU BORDA-MOYANO,11,24,26,9,0,35,35,0,35,0,0,2,0,8,18,5,2,0,0,4,18,13,35
20210502,02MAY2021:00:00:00,UFU DURAND,138,76,198,16,0,214,208,6,208,6,7,7,43,57,36,21,35,8,0,51,98,59,208
20210502,02MAY2021:00:00:00,UFU ELIZALDE,75,38,38,67,8,113,72,41,96,17,44,40,6,9,12,1,1,0,0,6,42,24,72
20210502,02MAY2021:00:00:00,UFU FERNANDEZ,75,40,92,19,4,115,99,16,107,8,0,4,21,28,23,13,20,6,0,25,6,68,99
20210502,02MAY2021:00:00:00,UFU FERRER,71,52,75,44,4,123,115,8,115,8,0,0,18,44,26,14,10,11,0,24,54,37,115
20210502,02MAY2021:00:00:00,UFU GRIERSON,85,55,69,65,6,140,128,12,132,8,0,8,31,22,37,32,8,2,0,35,49,44,128
20210502,02MAY2021:00:00:00,UFU GUTIERREZ,117,92,157,45,7,209,191,18,203,6,46,24,35,38,31,27,8,0,0,28,109,52,191
20210502,02MAY2021:00:00:00,UFU MUÑIZ,157,192,161,178,10,349,255,94,315,34,2,14,80,81,71,50,40,11,0,55,126,74,255
20210502,02MAY2021:00:00:00,UFU PENNA,65,50,87,28,0,115,109,6,111,4,0,1,26,23,34,17,10,4,0,25,49,34,109
20210502,02MAY2021:00:00:00,UFU PIROVANO,99,109,149,47,12,208,178,30,202,6,6,12,53,27,44,25,24,17,0,47,63,68,178
20210502,02MAY2021:00:00:00,UFU PIÑERO,124,131,162,83,10,255,235,20,243,12,0,5,56,68,33,33,28,32,0,54,119,62,235
20210502,02MAY2021:00:00:00,UFU RAMOS MEJIA,143,123,188,59,19,266,218,48,254,12,13,10,42,92,30,45,27,7,0,48,79,91,218
20210502,02MAY2021:00:00:00,UFU RIVADAVIA,94,90,131,39,14,184,168,16,168,16,0,6,34,54,31,33,18,8,0,45,50,68,168
20210502,02MAY2021:00:00:00,UFU SANTOJANNI,224,190,220,186,8,414,400,14,400,14,2,34,68,72,92,83,36,27,0,112,184,104,400
20210502,02MAY2021:00:00:00,UFU TORNU,121,63,103,59,22,184,172,12,172,12,7,2,28,35,39,34,24,15,0,32,85,55,172
20210502,02MAY2021:00:00:00,UFU VELEZ SARSFIELD,134,99,155,76,2,233,229,4,233,0,0,8,25,66,47,37,39,11,0,47,109,73,229
20210502,02MAY2021:00:00:00,UFU ZUBIZARRETA,105,58,94,57,12,163,149,14,163,0,0,5,48,34,33,16,19,8,0,19,83,47,149
20210503,03MAY2021:00:00:00,UFU ALVAREZ,224,199,312,94,17,423,317,106,317,106,13,21,95,120,71,67,26,10,0,68,148,101,317
20210503,03MAY2021:00:00:00,UFU ARGERICH,114,96,130,78,2,210,172,38,178,32,9,18,33,62,31,22,20,15,0,50,51,71,172
20210503,03MAY2021:00:00:00,UFU BORDA-MOYANO,32,51,53,26,4,83,77,6,77,6,0,5,14,18,22,14,6,4,0,12,36,29,77
20210503,03MAY2021:00:00:00,UFU DURAND,191,130,267,46,8,321,315,6,315,6,8,9,80,76,71,45,28,4,0,70,159,86,315
20210503,03MAY2021:00:00:00,UFU ELIZALDE,125,75,81,114,5,200,186,14,196,4,70,92,9,11,12,3,3,0,0,19,107,60,186
20210503,03MAY2021:00:00:00,UFU FERNANDEZ,151,113,194,45,25,264,239,25,247,17,0,8,65,70,52,38,24,7,0,45,15,179,239
20210503,03MAY2021:00:00:00,UFU FERRER,91,112,114,79,10,203,191,12,193,10,0,2,41,66,34,35,19,6,0,50,86,55,191
20210503,03MAY2021:00:00:00,UFU GRIERSON,160,138,148,117,33,298,288,10,290,8,0,8,78,82,60,38,22,10,0,90,101,96,288
20210503,03MAY2021:00:00:00,UFU GUTIERREZ,165,145,210,77,23,310,273,37,305,5,46,68,54,62,42,22,16,0,0,37,143,93,273
20210503,03MAY2021:00:00:00,UFU MUÑIZ,301,327,327,277,24,628,456,172,502,126,3,14,150,161,145,82,59,14,0,94,250,111,456
20210503,03MAY2021:00:00:00,UFU PENNA,84,82,131,24,11,166,142,24,160,6,0,2,35,35,50,22,12,10,0,30,70,42,142
20210503,03MAY2021:00:00:00,UFU PIROVANO,167,150,232,70,15,317,289,28,311,6,0,1,69,91,61,44,43,8,0,66,114,109,289
20210503,03MAY2021:00:00:00,UFU PIÑERO,175,159,224,87,23,334,316,18,316,18,2,4,76,103,70,38,26,15,0,82,150,83,316
20210503,03MAY2021:00:00:00,UFU RAMOS MEJIA,204,162,278,63,25,366,318,48,354,12,8,27,74,96,60,48,28,25,0,80,109,127,318
20210503,03MAY2021:00:00:00,UFU RIVADAVIA,177,157,232,74,28,334,306,28,312,22,0,7,79,110,62,47,18,11,0,74,107,124,306
20210503,03MAY2021:00:00:00,UFU SANTOJANNI,221,200,247,153,21,421,403,18,415,6,8,14,99,105,71,66,41,17,0,119,181,103,403
20210503,03MAY2021:00:00:00,UFU TORNU,146,139,202,68,15,285,253,32,255,30,8,22,44,71,61,39,27,13,0,41,119,79,253
20210503,03MAY2021:00:00:00,UFU VELEZ SARSFIELD,168,164,228,83,21,332,322,10,332,0,0,15,70,71,72,65,16,23,0,78,142,102,322
20210503,03MAY2021:00:00:00,UFU ZUBIZARRETA,180,176,200,142,14,356,344,12,356,0,0,13,94,75,59,58,34,23,0,50,199,95,344
20210504,04MAY2021:00:00:00,UFU ALVAREZ,170,182,290,53,9,352,324,28,326,26,16,25,73,98,61,53,19,7,0,77,143,104,324
20210504,04MAY2021:00:00:00,UFU ARGERICH,68,78,78,46,22,146,122,24,122,24,0,7,35,31,35,23,11,4,0,35,39,47,122
20210504,04MAY2021:00:00:00,UFU BORDA-MOYANO,23,25,24,24,0,48,48,0,48,0,0,0,7,15,11,7,8,0,0,7,27,13,48
20210504,04MAY2021:00:00:00,UFU DURAND,130,135,238,24,3,265,257,8,257,8,2,9,69,82,52,31,16,4,0,62,125,70,257
20210504,04MAY2021:00:00:00,UFU ELIZALDE,77,69,55,74,17,146,110,36,138,8,63,51,5,16,8,3,0,0,0,6,60,44,110
20210504,04MAY2021:00:00:00,UFU FERNANDEZ,129,74,143,44,16,203,149,54,189,14,0,6,64,43,36,30,15,9,0,26,10,113,149
20210504,04MAY2021:00:00:00,UFU FERRER,80,71,71,69,11,151,149,2,149,2,0,2,21,56,47,18,5,2,0,37,65,47,149
20210504,04MAY2021:00:00:00,UFU GRIERSON,116,127,91,101,51,243,243,0,243,0,0,19,58,46,43,53,15,9,0,73,91,79,243
20210504,04MAY2021:00:00:00,UFU GUTIERREZ,142,103,142,60,43,245,227,18,245,0,48,42,37,45,45,18,10,0,0,27,118,82,227
20210504,04MAY2021:00:00:00,UFU MUÑIZ,224,261,240,174,71,485,335,150,365,120,0,20,129,123,94,72,35,12,0,59,190,85,335
20210504,04MAY2021:00:00:00,UFU PENNA,83,62,96,40,9,145,123,22,135,10,0,7,27,31,27,36,13,4,0,20,72,30,123
20210504,04MAY2021:00:00:00,UFU PIROVANO,161,127,186,56,46,288,246,42,280,8,0,7,66,78,46,49,26,16,0,58,86,102,246
20210504,04MAY2021:00:00:00,UFU PIÑERO,164,159,202,85,36,323,311,12,311,12,0,24,74,105,64,28,25,3,0,56,160,89,311
20210504,04MAY2021:00:00:00,UFU RAMOS MEJIA,160,166,208,77,41,326,278,48,320,6,8,13,82,85,70,35,23,10,0,54,109,115,278
20210504,04MAY2021:00:00:00,UFU RIVADAVIA,173,134,168,91,48,307,269,38,279,28,0,5,80,72,45,62,28,15,0,61,91,115,269
20210504,04MAY2021:00:00:00,UFU SANTOJANNI,203,179,151,170,61,382,364,18,372,10,0,25,78,82,75,64,33,25,0,121,164,79,364
20210504,04MAY2021:00:00:00,UFU TORNU,133,134,164,64,39,267,249,18,251,16,8,14,63,63,47,20,32,20,0,53,112,79,249
20210504,04MAY2021:00:00:00,UFU VELEZ SARSFIELD,173,158,201,69,61,331,327,4,329,2,0,14,52,112,53,57,28,15,0,54,172,101,327
20210504,04MAY2021:00:00:00,UFU ZUBIZARRETA,101,139,138,90,12,240,240,0,240,0,0,11,64,72,47,30,12,4,0,55,124,61,240
20210505,05MAY2021:00:00:00,UFU ALVAREZ,205,181,285,75,26,386,304,82,304,82,16,34,103,72,73,54,24,10,0,57,156,91,304
20210424,24APR2021:00:00:00,UFU ZUBIZARRETA,162,130,155,125,12,292,288,4,292,0,0,19,73,58,60,49,21,12,0,54,137,97,288
20210425,25APR2021:00:00:00,UFU ALVAREZ,192,131,257,57,9,323,313,10,313,10,16,34,48,97,51,39,26,12,0,65,168,80,313
20210425,25APR2021:00:00:00,UFU ARGERICH,22,26,32,16,0,48,46,2,48,0,0,0,2,9,9,15,11,2,0,16,14,16,46
20210425,25APR2021:00:00:00,UFU BORDA-MOYANO,34,22,28,28,0,56,56,0,56,0,0,0,14,14,14,8,2,4,0,13,18,25,56
20210425,25APR2021:00:00:00,UFU DURAND,125,131,215,36,5,256,244,12,250,6,4,16,62,60,36,44,27,7,0,54,122,68,244
20210425,25APR2021:00:00:00,UFU ELIZALDE,48,50,41,52,5,98,82,16,96,2,39,43,2,7,5,2,0,0,0,8,45,28,82
20210425,25APR2021:00:00:00,UFU FERNANDEZ,75,74,111,36,2,149,113,36,145,4,0,3,35,38,28,26,14,5,0,34,6,73,113
20210425,25APR2021:00:00:00,UFU FERRER,69,90,90,67,2,159,149,10,149,10,0,0,20,45,35,33,20,6,0,52,53,44,149
20210425,25APR2021:00:00:00,UFU GRIERSON,150,103,124,72,57,253,245,8,247,6,0,11,68,58,54,33,26,3,0,74,88,83,245
20210425,25APR2021:00:00:00,UFU GUTIERREZ,156,83,190,47,2,239,221,18,231,8,36,43,49,49,38,17,7,0,0,41,106,72,221
20210425,25APR2021:00:00:00,UFU MUÑIZ,192,188,161,200,19,380,262,118,332,48,0,4,91,116,54,67,27,21,0,53,136,73,262
20210425,25APR2021:00:00:00,UFU PENNA,35,29,48,14,2,64,60,4,64,0,0,5,13,19,8,14,3,2,0,9,35,15,60
20210425,25APR2021:00:00:00,UFU PIROVANO,95,125,196,24,0,220,206,14,218,2,4,8,29,76,56,29,11,7,0,51,69,86,206
20210425,25APR2021:00:00:00,UFU PIÑERO,102,93,110,68,17,195,191,4,193,2,0,13,46,38,66,23,9,0,0,35,100,54,191
20210425,25APR2021:00:00:00,UFU RAMOS MEJIA,123,122,194,35,16,245,215,30,229,16,2,13,50,58,53,40,17,12,0,74,49,92,215
20210425,25APR2021:00:00:00,UFU RIVADAVIA,103,92,142,37,16,195,173,22,175,20,0,4,64,48,38,27,7,7,0,28,62,80,173
20210425,25APR2021:00:00:00,UFU SANTOJANNI,248,192,251,181,8,440,422,18,428,12,5,31,79,108,103,46,46,22,0,133,180,109,422
20210425,25APR2021:00:00:00,UFU TORNU,120,72,124,55,13,192,172,20,184,8,8,15,28,44,49,22,15,11,0,34,86,52,172
20210425,25APR2021:00:00:00,UFU VELEZ SARSFIELD,136,103,177,60,2,239,237,2,239,0,0,10,67,48,51,45,14,4,0,42,127,68,237
20210425,25APR2021:00:00:00,UFU ZUBIZARRETA,71,79,71,62,17,150,136,14,150,0,0,11,16,30,55,13,20,5,0,30,66,40,136
20210426,26APR2021:00:00:00,UFU ALVAREZ,287,302,410,165,14,589,443,146,443,146,17,18,144,162,122,99,20,7,0,87,224,132,443
20210426,26APR2021:00:00:00,UFU ARGERICH,129,105,129,97,8,234,210,24,224,10,10,7,37,64,46,40,23,7,0,66,51,90,210
20210426,26APR2021:00:00:00,UFU BORDA-MOYANO,45,48,52,36,5,93,83,10,83,10,0,4,18,20,20,18,6,7,0,7,43,33,83
20210426,26APR2021:00:00:00,UFU DURAND,221,225,372,58,16,446,436,10,440,6,17,23,118,84,88,59,31,26,0,85,239,112,436
20210426,26APR2021:00:00:00,UFU ELIZALDE,102,65,75,90,2,167,143,24,155,12,60,60,20,10,12,3,2,0,0,13,83,47,143
20210426,26APR2021:00:00:00,UFU FERNANDEZ,148,151,194,76,29,299,249,50,255,44,0,12,67,95,44,50,25,6,0,49,15,185,249
20210426,26APR2021:00:00:00,UFU FERRER,98,85,92,87,4,183,161,22,165,18,0,3,51,53,36,18,13,9,0,50,79,32,161
20210426,26APR2021:00:00:00,UFU GRIERSON,124,154,111,114,53,278,272,6,272,6,0,14,43,85,61,53,18,4,0,84,91,97,272
20210426,26APR2021:00:00:00,UFU GUTIERREZ,187,130,226,66,25,317,297,20,315,2,45,66,46,90,37,21,7,5,0,41,164,92,297
20210426,26APR2021:00:00:00,UFU MUÑIZ,307,372,260,393,26,679,465,214,535,144,0,11,168,175,130,140,41,14,0,71,293,101,465
20210426,26APR2021:00:00:00,UFU PENNA,61,50,92,18,1,111,87,24,109,2,0,0,13,30,13,21,20,14,0,24,44,19,87
20210426,26APR2021:00:00:00,UFU PIROVANO,161,176,254,54,29,337,285,52,331,6,0,7,83,96,48,58,26,19,0,61,113,111,285
20210426,26APR2021:00:00:00,UFU PIÑERO,168,151,216,98,5,319,305,14,311,8,0,12,71,81,72,56,21,6,0,56,172,74,305
20210426,26APR2021:00:00:00,UFU RAMOS MEJIA,213,209,295,109,18,422,370,52,404,18,18,28,85,98,79,52,46,16,0,72,143,155,370
20210426,26APR2021:00:00:00,UFU RIVADAVIA,210,126,212,93,31,336,298,38,302,34,2,7,91,91,53,54,27,11,0,81,95,117,298
20210426,26APR2021:00:00:00,UFU SANTOJANNI,218,207,242,167,16,425,413,12,419,6,6,31,92,75,93,65,48,15,0,121,201,91,413
20210426,26APR2021:00:00:00,UFU TORNU,158,163,245,61,15,321,291,30,303,18,10,21,63,83,74,51,13,6,0,50,158,83,291
20210426,26APR2021:00:00:00,UFU VELEZ SARSFIELD,196,161,245,104,8,357,305,52,355,2,0,3,88,101,76,38,45,6,0,55,154,96,305
20210426,26APR2021:00:00:00,UFU ZUBIZARRETA,169,151,181,120,19,320,318,2,320,0,0,17,58,80,67,65,26,7,0,54,183,81,318
20210427,27APR2021:00:00:00,UFU ALVAREZ,220,209,336,86,7,429,413,16,413,16,6,19,82,144,85,54,17,22,0,76,228,109,413
20210427,27APR2021:00:00:00,UFU ARGERICH,98,101,127,64,8,199,179,20,183,16,5,7,33,48,50,24,13,19,0,48,53,77,179
20210427,27APR2021:00:00:00,UFU BORDA-MOYANO,55,53,53,45,10,108,106,2,106,2,0,11,13,35,34,6,9,0,0,23,51,32,106
20210427,27APR2021:00:00:00,UFU DURAND,200,147,278,69,0,347,337,10,337,10,7,10,68,98,63,63,23,15,0,91,154,92,337
20210427,27APR2021:00:00:00,UFU ELIZALDE,125,95,106,110,4,220,166,54,212,8,89,74,8,24,19,2,4,0,0,21,80,65,166
20210427,27APR2021:00:00:00,UFU FERNANDEZ,100,117,165,37,15,217,199,18,213,4,0,7,52,60,37,25,16,20,0,28,20,151,199
20210427,27APR2021:00:00:00,UFU FERRER,108,93,103,96,2,201,199,2,199,2,0,2,44,54,70,25,3,3,0,36,114,49,199
20210427,27APR2021:00:00:00,UFU GRIERSON,112,145,127,124,6,257,255,2,255,2,0,17,63,73,53,32,13,6,0,67,100,86,255
20210427,27APR2021:00:00:00,UFU GUTIERREZ,201,144,237,90,18,345,323,22,345,0,71,37,42,103,52,22,13,5,0,41,180,102,323
20210427,27APR2021:00:00:00,UFU MUÑIZ,245,342,259,309,19,587,395,192,425,162,0,16,135,167,103,103,36,27,0,61,220,114,395
20210427,27APR2021:00:00:00,UFU PENNA,60,72,103,27,2,132,116,16,126,6,1,10,24,30,31,20,13,3,0,24,61,31,116
20210427,27APR2021:00:00:00,UFU PIROVANO,151,143,220,54,20,294,260,34,292,2,0,6,76,76,55,47,16,18,0,47,104,109,260
20210427,27APR2021:00:00:00,UFU PIÑERO,174,128,221,66,15,302,290,12,292,10,2,22,77,71,51,44,19,16,0,52,150,86,290
20210427,27APR2021:00:00:00,UFU RAMOS MEJIA,214,171,281,73,31,385,331,54,381,4,9,13,89,101,84,52,34,3,0,80,118,132,331
20210427,27APR2021:00:00:00,UFU RIVADAVIA,188,107,207,67,21,295,275,20,279,16,0,3,83,87,60,34,24,4,0,61,95,113,275
20210427,27APR2021:00:00:00,UFU SANTOJANNI,225,226,252,183,16,451,437,14,445,6,1,29,110,90,100,65,33,23,0,133,203,101,437
20210427,27APR2021:00:00:00,UFU TORNU,173,171,227,94,23,344,296,48,298,46,14,30,68,89,74,34,22,13,0,45,148,101,296
20210427,27APR2021:00:00:00,UFU VELEZ SARSFIELD,183,99,193,77,12,282,276,6,280,2,0,21,88,56,28,56,30,3,0,42,148,86,276
20210427,27APR2021:00:00:00,UFU ZUBIZARRETA,137,157,184,103,7,294,294,0,294,0,0,9,62,80,53,47,30,13,0,30,175,89,294
20210428,28APR2021:00:00:00,UFU ALVAREZ,245,214,338,105,16,459,369,90,369,90,0,52,95,113,81,70,31,17,0,62,192,115,369
20210428,28APR2021:00:00:00,UFU ARGERICH,107,123,139,82,9,230,198,32,202,28,10,18,32,75,48,24,11,12,0,46,61,87,198
20210428,28APR2021:00:00:00,UFU BORDA-MOYANO,53,56,66,38,5,109,95,14,95,14,0,3,19,17,28,20,17,5,0,16,50,29,95
20210428,28APR2021:00:00:00,UFU DURAND,182,164,297,43,6,346,340,6,340,6,2,12,94,82,57,47,41,11,0,72,160,108,340
20210428,28APR2021:00:00:00,UFU ELIZALDE,83,92,91,84,0,175,137,38,167,8,61,70,6,17,12,5,4,0,0,5,79,53,137
20210428,28APR2021:00:00:00,UFU FERNANDEZ,111,108,164,43,12,219,199,20,211,8,0,4,51,66,51,30,12,5,0,51,17,129,199
20210428,28APR2021:00:00:00,UFU FERRER,113,86,96,93,10,199,185,14,185,14,0,7,63,65,28,25,8,3,0,34,94,57,185
20210428,28APR2021:00:00:00,UFU GRIERSON,113,136,93,90,66,249,249,0,249,0,0,8,69,67,63,32,9,1,0,49,112,87,249
20210428,28APR2021:00:00:00,UFU GUTIERREZ,175,110,192,80,13,285,261,24,283,2,53,48,44,76,27,32,0,5,0,34,143,84,261
20210428,28APR2021:00:00:00,UFU MUÑIZ,273,380,265,361,27,653,453,200,515,138,10,12,183,168,124,79,62,15,0,74,239,140,453
20210428,28APR2021:00:00:00,UFU PENNA,84,73,113,37,7,157,149,8,157,0,0,7,32,44,22,28,20,4,0,21,87,41,149
20210428,28APR2021:00:00:00,UFU PIROVANO,166,147,221,68,24,313,285,28,299,14,0,13,90,99,46,41,17,7,0,61,109,115,285
20210428,28APR2021:00:00:00,UFU PIÑERO,195,195,258,115,17,390,382,8,384,6,0,19,78,129,99,39,21,5,0,63,208,111,382
20210428,28APR2021:00:00:00,UFU RAMOS MEJIA,160,138,197,79,22,298,226,72,294,4,9,4,51,96,55,40,19,24,0,42,97,87,226
20210428,28APR2021:00:00:00,UFU RIVADAVIA,216,150,256,74,36,366,216,150,242,124,0,12,107,79,46,75,32,15,0,44,85,85,216
20210428,28APR2021:00:00:00,UFU SANTOJANNI,256,214,264,195,11,470,458,12,464,6,3,30,83,115,123,66,37,13,0,148,197,113,458
20210428,28APR2021:00:00:00,UFU TORNU,143,142,206,55,24,285,261,24,279,6,14,36,62,69,44,35,18,7,0,28,130,103,261
20210428,28APR2021:00:00:00,UFU VELEZ SARSFIELD,157,150,222,72,13,307,303,4,307,0,0,10,64,72,64,54,30,13,0,57,159,87,303
20210428,28APR2021:00:00:00,UFU ZUBIZARRETA,116,93,125,66,18,209,209,0,209,0,0,28,70,37,30,18,21,5,0,33,113,63,209
20210429,29APR2021:00:00:00,UFU ALVAREZ,238,239,364,104,9,477,459,18,461,16,25,17,117,111,76,78,37,16,0,92,226,141,459
20210429,29APR2021:00:00:00,UFU ARGERICH,103,107,130,78,2,210,184,26,184,26,10,5,51,64,38,29,10,3,0,43,53,86,184
20210429,29APR2021:00:00:00,UFU BORDA-MOYANO,44,34,52,24,2,78,64,14,64,14,0,2,15,24,16,6,9,6,0,11,32,21,64
20210429,29APR2021:00:00:00,UFU DURAND,182,169,288,54,9,351,337,14,345,6,6,26,87,78,70,41,29,14,0,87,144,106,337
20210429,29APR2021:00:00:00,UFU ELIZALDE,72,42,44,68,2,114,78,36,104,10,55,41,4,6,5,0,3,0,0,7,48,23,78
20210429,29APR2021:00:00:00,UFU FERNANDEZ,134,84,157,40,21,218,180,38,198,20,0,6,42,62,51,24,23,10,0,36,14,130,180
20210429,29APR2021:00:00:00,UFU FERRER,123,98,122,93,6,221,207,14,207,14,2,3,62,54,58,37,2,3,0,36,115,56,207
20210429,29APR2021:00:00:00,UFU GRIERSON,147,131,130,83,65,278,270,8,272,6,6,0,63,72,68,55,11,3,0,55,113,102,270
20210429,29APR2021:00:00:00,UFU GUTIERREZ,173,85,181,58,19,258,246,12,256,2,38,33,54,76,30,21,6,0,0,41,135,70,246
20210429,29APR2021:00:00:00,UFU MUÑIZ,330,346,240,403,33,676,494,182,524,152,3,14,182,170,140,100,52,15,0,72,282,140,494
20210429,29APR2021:00:00:00,UFU PENNA,104,65,141,22,6,169,123,46,163,6,0,5,37,32,29,29,28,9,0,17,70,36,123
20210429,29APR2021:00:00:00,UFU PIROVANO,182,146,251,46,31,328,292,36,324,4,0,10,65,104,75,35,23,16,0,44,119,129,292
20210429,29APR2021:00:00:00,UFU PIÑERO,206,116,208,98,16,322,310,12,310,12,0,10,121,78,69,36,8,0,0,56,160,88,310
20210429,29APR2021:00:00:00,UFU RAMOS MEJIA,166,142,230,60,18,308,242,66,288,20,8,22,51,96,66,44,16,5,0,50,96,96,242
20210429,29APR2021:00:00:00,UFU RIVADAVIA,161,135,187,66,43,296,278,18,284,12,0,5,77,73,52,43,28,18,0,45,114,117,278
20210429,29APR2021:00:00:00,UFU SANTOJANNI,254,191,221,215,9,445,437,8,443,2,9,22,95,104,102,56,47,10,0,107,214,116,437
20210429,29APR2021:00:00:00,UFU TORNU,169,144,221,67,25,313,271,42,277,36,13,29,51,89,68,39,20,4,0,48,134,89,271
20210429,29APR2021:00:00:00,UFU VELEZ SARSFIELD,174,168,218,107,17,342,308,34,338,4,0,8,72,73,92,52,23,22,0,52,175,81,308
20210429,29APR2021:00:00:00,UFU ZUBIZARRETA,150,84,139,89,6,234,231,3,234,0,0,14,33,64,44,40,18,21,0,36,131,64,231
20210430,30APR2021:00:00:00,UFU ALVAREZ,323,280,451,120,32,603,534,69,537,66,14,31,171,154,90,91,38,14,0,94,318,122,534
20210430,30APR2021:00:00:00,UFU ARGERICH,198,129,183,132,12,327,307,20,307,20,6,12,72,85,90,30,18,14,0,86,144,76,307
20210430,30APR2021:00:00:00,UFU BORDA-MOYANO,41,51,66,23,3,92,80,12,80,12,0,1,9,15,31,22,12,2,0,16,36,28,80
20210430,30APR2021:00:00:00,UFU DURAND,235,194,359,62,8,429,421,8,421,8,1,13,114,102,74,69,30,26,0,102,237,81,421
20210430,30APR2021:00:00:00,UFU ELIZALDE,59,57,47,64,5,116,89,27,108,8,38,46,2,16,10,4,0,0,0,10,52,27,89
20210430,30APR2021:00:00:00,UFU FERNANDEZ,225,176,306,65,30,401,299,102,385,16,0,27,119,91,84,54,18,8,0,84,16,199,299
20210430,30APR2021:00:00:00,UFU FERRER,150,125,125,124,26,275,264,11,269,6,0,0,58,83,74,36,16,8,0,50,166,48,264
20210430,30APR2021:00:00:00,UFU GRIERSON,218,191,196,150,63,409,387,22,405,4,0,14,102,90,61,97,27,18,0,149,147,91,387
20210430,30APR2021:00:00:00,UFU GUTIERREZ,243,152,294,87,14,395,369,26,393,2,78,50,61,92,57,29,25,3,0,67,220,82,369
20210430,30APR2021:00:00:00,UFU MUÑIZ,381,439,331,440,49,820,605,215,656,164,0,26,205,231,205,88,37,28,0,122,379,104,605
20210430,30APR2021:00:00:00,UFU PENNA,92,88,153,20,7,180,162,18,174,6,0,6,38,38,36,34,18,10,0,53,79,30,162
20210430,30APR2021:00:00:00,UFU PIROVANO,345,327,555,73,44,672,618,54,654,18,0,7,140,222,129,76,67,31,0,136,329,153,618
20210430,30APR2021:00:00:00,UFU PIÑERO,173,180,249,86,18,353,341,12,341,12,0,19,79,75,105,34,25,16,0,79,196,66,341
20210430,30APR2021:00:00:00,UFU RAMOS MEJIA,286,234,390,96,34,520,454,66,498,22,11,21,95,104,108,98,45,38,0,188,141,123,454
20210430,30APR2021:00:00:00,UFU RIVADAVIA,302,126,328,70,30,428,395,33,416,12,0,2,116,104,86,61,42,17,0,104,161,122,395
20210430,30APR2021:00:00:00,UFU SANTOJANNI,280,262,310,205,27,542,512,30,534,8,20,16,152,129,86,87,44,8,0,141,284,87,512
20210430,30APR2021:00:00:00,UFU TORNU,243,174,312,89,16,417,393,24,393,24,24,26,81,110,112,34,13,17,0,77,221,95,393
20210430,30APR2021:00:00:00,UFU VELEZ SARSFIELD,301,209,332,149,29,510,473,37,506,4,2,1,104,125,101,87,58,32,0,105,271,97,473
20210430,30APR2021:00:00:00,UFU ZUBIZARRETA,184,162,201,131,14,346,342,4,346,0,0,2,88,99,71,42,31,13,0,41,213,88,342
20210501,01MAY2021:00:00:00,UFU ALVAREZ,147,148,229,47,19,295,275,20,275,20,17,29,68,65,65,19,21,11,0,62,107,106,275
20210501,01MAY2021:00:00:00,UFU ARGERICH,6,8,7,7,0,14,14,0,14,0,0,0,2,5,2,3,0,2,0,3,5,6,14
20210501,01MAY2021:00:00:00,UFU BORDA-MOYANO,25,18,25,16,2,43,37,6,37,6,0,5,10,7,6,11,2,2,0,9,17,11,37
20210501,01MAY2021:00:00:00,UFU DURAND,112,96,176,31,1,208,208,0,208,0,9,8,38,43,53,21,20,16,0,52,101,55,208
20210501,01MAY2021:00:00:00,UFU ELIZALDE,47,49,57,32,7,96,78,18,92,4,36,42,3,14,1,0,0,0,0,13,37,28,78
20210501,01MAY2021:00:00:00,UFU FERNANDEZ,105,65,147,21,2,170,152,18,158,12,0,8,29,40,21,37,28,7,0,35,10,107,152
20210501,01MAY2021:00:00:00,UFU FERRER,92,53,92,46,7,145,141,4,141,4,0,0,41,39,30,16,18,1,0,31,69,41,141
20210501,01MAY2021:00:00:00,UFU GRIERSON,125,128,136,108,9,253,245,8,245,8,0,14,72,49,59,36,22,1,0,74,87,84,245
20210501,01MAY2021:00:00:00,UFU GUTIERREZ,135,141,206,49,21,276,262,14,272,4,45,46,46,77,26,25,8,3,0,37,136,87,262
20210501,01MAY2021:00:00:00,UFU MUÑIZ,212,227,163,265,11,439,249,190,335,104,5,12,105,130,87,52,37,11,0,48,129,72,249
20210501,01MAY2021:00:00:00,UFU PENNA,33,30,46,17,0,63,59,4,63,0,0,2,13,8,15,11,12,2,0,10,25,24,59
20210501,01MAY2021:00:00:00,UFU PIROVANO,90,88,137,27,14,178,158,20,174,4,0,4,47,53,33,13,19,9,0,39,52,67,158
20210501,01MAY2021:00:00:00,UFU PIÑERO,109,96,111,83,11,205,195,10,195,10,0,2,59,68,28,11,24,13,0,41,98,54,195
20210408,08APR2021:00:00:00,UFU ELIZALDE,112,87,52,119,28,199,163,36,185,14,69,88,20,11,4,6,1,0,0,20,87,56,163
20210408,08APR2021:00:00:00,UFU FERNANDEZ,328,310,414,80,145,639,344,295,627,12,3,9,204,240,99,41,36,7,0,5,12,327,344
20210408,08APR2021:00:00:00,UFU FERRER,113,162,93,97,85,275,269,6,269,6,0,4,99,82,41,29,20,0,0,66,99,104,269
20210408,08APR2021:00:00:00,UFU GRIERSON,179,134,101,127,85,313,303,10,303,10,0,27,92,68,70,48,8,0,0,73,124,106,303
20210408,08APR2021:00:00:00,UFU GUTIERREZ,79,53,77,36,19,132,116,16,130,2,54,31,9,18,13,4,3,0,0,13,55,46,116
20210408,08APR2021:00:00:00,UFU MUÑIZ,378,333,234,323,155,712,495,217,530,182,1,11,221,217,160,78,18,6,0,98,285,112,495
20210408,08APR2021:00:00:00,UFU PENNA,97,70,114,18,35,167,155,12,163,4,2,4,44,47,28,25,14,3,0,32,89,34,155
20210408,08APR2021:00:00:00,UFU PIROVANO,300,262,324,68,170,562,492,70,556,6,0,9,184,143,100,67,35,24,0,82,257,146,492
20210408,08APR2021:00:00:00,UFU PIÑERO,212,168,209,97,74,380,376,4,376,4,0,16,108,102,70,51,26,7,0,72,209,95,376
20210408,08APR2021:00:00:00,UFU RAMOS MEJIA,209,164,222,45,106,373,339,34,363,10,9,13,110,101,68,42,21,9,0,102,97,139,339
20210408,08APR2021:00:00:00,UFU RIVADAVIA,250,192,275,84,83,442,418,24,432,10,0,20,175,99,55,52,30,11,0,91,156,170,418
20210408,08APR2021:00:00:00,UFU SANTOJANNI,222,182,162,148,94,404,392,12,398,6,5,19,101,119,46,75,23,16,0,71,167,154,392
20210408,08APR2021:00:00:00,UFU TORNU,211,179,261,101,28,390,372,18,376,14,12,26,126,80,83,37,20,6,0,59,189,124,372
20210408,08APR2021:00:00:00,UFU VELEZ SARSFIELD,165,175,195,50,95,340,310,30,328,12,0,12,110,81,59,56,9,13,0,63,113,134,310
20210408,08APR2021:00:00:00,UFU ZUBIZARRETA,165,128,151,127,15,293,281,12,293,0,0,19,100,67,39,49,19,0,0,6,138,137,281
20210409,09APR2021:00:00:00,UFU ALVAREZ,324,261,348,169,68,585,507,78,507,78,27,44,187,138,93,57,24,15,0,82,266,159,507
20210409,09APR2021:00:00:00,UFU ARGERICH,192,106,147,101,50,298,276,22,276,22,14,32,93,56,62,15,17,9,0,41,156,77,276
20210409,09APR2021:00:00:00,UFU BORDA-MOYANO,64,65,52,72,5,129,117,12,117,12,0,9,27,36,25,22,8,2,0,14,59,44,117
20210409,09APR2021:00:00:00,UFU DURAND,285,228,396,104,13,513,499,14,501,12,4,29,161,127,96,50,42,4,0,95,197,207,499
20210409,09APR2021:00:00:00,UFU ELIZALDE,123,72,69,116,11,196,137,59,182,14,72,87,8,14,8,5,2,0,0,16,67,54,137
20210409,09APR2021:00:00:00,UFU FERNANDEZ,287,238,329,92,105,526,355,171,504,22,1,19,180,129,92,72,24,9,0,5,14,336,355
20210409,09APR2021:00:00:00,UFU FERRER,110,140,80,113,58,251,236,15,239,12,1,2,102,64,42,22,16,2,0,63,79,94,236
20210409,09APR2021:00:00:00,UFU GRIERSON,159,131,111,110,69,290,272,18,280,10,0,18,94,62,67,31,15,3,0,53,115,104,272
20210409,09APR2021:00:00:00,UFU GUTIERREZ,100,77,115,47,15,177,151,26,159,18,41,56,27,24,6,14,8,1,0,26,74,51,151
20210409,09APR2021:00:00:00,UFU MUÑIZ,346,360,221,302,183,706,496,210,522,184,2,27,186,204,132,101,37,17,0,89,278,129,496
20210409,09APR2021:00:00:00,UFU PENNA,97,77,118,38,18,174,148,26,162,12,0,7,40,45,38,22,15,7,0,37,65,46,148
20210409,09APR2021:00:00:00,UFU PIROVANO,332,270,394,105,103,602,546,56,596,6,0,21,218,163,81,52,45,22,0,63,342,139,546
20210409,09APR2021:00:00:00,UFU PIÑERO,172,134,190,80,36,306,302,4,302,4,0,16,73,101,59,46,10,1,0,35,184,82,302
20210409,09APR2021:00:00:00,UFU RAMOS MEJIA,215,188,276,71,56,403,347,56,369,34,15,24,84,108,60,71,32,9,0,79,126,141,347
20210409,09APR2021:00:00:00,UFU RIVADAVIA,217,205,272,64,86,422,396,26,400,22,0,12,159,109,60,47,22,13,0,87,139,165,396
20210409,09APR2021:00:00:00,UFU SANTOJANNI,201,189,161,149,80,390,354,36,378,12,3,19,105,95,81,56,26,5,0,69,144,141,354
20210409,09APR2021:00:00:00,UFU TORNU,222,151,245,37,91,373,335,38,337,36,5,29,109,88,57,53,17,15,0,61,154,120,335
20210409,09APR2021:00:00:00,UFU VELEZ SARSFIELD,165,165,206,74,50,330,310,20,326,4,0,11,96,85,61,44,17,16,0,95,104,111,310
20210409,09APR2021:00:00:00,UFU ZUBIZARRETA,204,192,224,141,31,396,368,28,396,0,0,33,120,91,76,49,19,8,0,6,229,133,368
20210410,10APR2021:00:00:00,UFU ALVAREZ,204,187,275,88,28,391,375,16,377,14,6,16,117,82,77,43,34,16,0,79,165,131,375
20210410,10APR2021:00:00:00,UFU BORDA-MOYANO,68,57,78,47,0,125,117,8,117,8,0,8,27,18,30,25,12,5,0,18,54,45,117
20210410,10APR2021:00:00:00,UFU DURAND,146,168,238,63,13,314,310,4,310,4,4,22,66,93,55,45,19,10,0,90,104,116,310
20210410,10APR2021:00:00:00,UFU ELIZALDE,86,81,44,113,10,167,113,54,157,10,59,84,6,7,8,3,0,0,0,12,61,40,113
20210410,10APR2021:00:00:00,UFU FERNANDEZ,595,434,644,153,233,1030,223,807,1006,24,3,29,387,292,163,95,49,12,0,12,15,196,223
20210410,10APR2021:00:00:00,UFU FERRER,71,106,81,93,3,177,169,8,169,8,0,3,44,48,51,22,7,2,0,47,54,68,169
20210410,10APR2021:00:00:00,UFU GRIERSON,120,110,112,111,7,230,220,10,220,10,0,8,74,52,53,23,16,4,0,61,76,83,220
20210410,10APR2021:00:00:00,UFU GUTIERREZ,68,47,75,36,4,115,103,12,111,4,30,47,10,7,17,2,0,2,0,7,63,33,103
20210410,10APR2021:00:00:00,UFU MUÑIZ,230,229,165,252,42,459,357,102,371,88,0,7,149,131,75,53,31,13,0,77,192,88,357
20210410,10APR2021:00:00:00,UFU PENNA,80,29,65,30,14,109,105,4,109,0,0,7,22,30,30,10,5,5,0,12,56,37,105
20210410,10APR2021:00:00:00,UFU PIROVANO,207,197,331,45,28,404,382,22,398,6,0,12,116,122,71,39,40,4,0,66,196,116,382
20210410,10APR2021:00:00:00,UFU PIÑERO,154,127,164,108,10,282,273,9,276,6,1,14,85,61,56,38,18,9,0,57,141,72,273
20210410,10APR2021:00:00:00,UFU RAMOS MEJIA,201,143,235,75,34,344,288,56,290,54,8,29,95,74,59,43,28,8,0,64,123,101,288
20210410,10APR2021:00:00:00,UFU RIVADAVIA,155,86,173,48,20,241,241,0,241,0,0,4,64,72,51,18,22,10,0,42,102,95,241
20210410,10APR2021:00:00:00,UFU SANTOJANNI,177,171,159,169,20,348,330,18,342,6,0,17,117,93,62,42,11,6,0,61,129,140,330
20210410,10APR2021:00:00:00,UFU TORNU,133,102,138,71,26,235,225,10,227,8,0,20,62,55,46,33,12,7,0,65,69,90,225
20210410,10APR2021:00:00:00,UFU VELEZ SARSFIELD,204,155,246,93,20,359,343,16,353,6,0,13,122,94,63,50,15,2,0,68,189,86,343
20210410,10APR2021:00:00:00,UFU ZUBIZARRETA,145,189,185,130,19,334,312,22,334,0,0,16,104,83,65,33,28,5,0,5,153,154,312
20210411,11APR2021:00:00:00,UFU ALVAREZ,170,163,274,50,9,333,305,28,307,26,11,24,75,93,63,39,18,10,0,78,114,113,305
20210411,11APR2021:00:00:00,UFU ARGERICH,78,88,79,74,13,166,164,2,166,0,3,3,46,50,23,22,6,13,0,47,70,47,164
20210411,11APR2021:00:00:00,UFU BORDA-MOYANO,36,28,35,27,2,64,62,2,62,2,0,6,16,9,20,9,3,1,0,12,24,26,62
20210411,11APR2021:00:00:00,UFU DURAND,169,161,286,37,7,330,320,10,320,10,1,10,71,95,78,45,20,10,0,110,101,109,320
20210411,11APR2021:00:00:00,UFU ELIZALDE,72,57,44,79,6,129,91,38,115,14,46,46,13,8,12,4,0,0,0,12,42,37,91
20210411,11APR2021:00:00:00,UFU FERNANDEZ,159,156,242,49,24,315,165,150,295,20,0,0,80,87,57,50,27,14,0,6,5,153,165
20210411,11APR2021:00:00:00,UFU FERRER,96,97,99,89,5,193,179,14,179,14,4,7,56,32,39,34,21,0,0,49,60,70,179
20210411,11APR2021:00:00:00,UFU GRIERSON,137,128,129,116,20,265,247,18,247,18,0,19,76,56,55,43,10,6,0,62,92,93,247
20210411,11APR2021:00:00:00,UFU GUTIERREZ,56,29,64,12,9,85,73,12,83,2,29,45,0,6,2,3,0,0,0,7,41,25,73
20210411,11APR2021:00:00:00,UFU MUÑIZ,229,235,203,240,21,464,326,138,408,56,0,8,121,103,97,72,38,25,0,71,167,88,326
20210411,11APR2021:00:00:00,UFU PENNA,42,45,54,31,2,87,75,12,81,6,0,7,10,21,17,15,14,3,0,11,42,22,75
20210411,11APR2021:00:00:00,UFU PIROVANO,199,178,312,52,13,377,355,22,369,8,2,7,98,100,85,50,27,8,0,64,202,88,355
20210411,11APR2021:00:00:00,UFU PIÑERO,146,96,126,93,23,242,240,2,240,2,0,14,51,72,55,22,17,11,0,41,132,62,240
20210411,11APR2021:00:00:00,UFU RAMOS MEJIA,172,160,239,59,34,332,296,36,300,32,4,15,56,91,60,68,31,7,0,77,90,129,296
20210411,11APR2021:00:00:00,UFU RIVADAVIA,137,108,179,49,17,245,245,0,245,0,0,2,78,55,58,25,18,9,0,83,72,87,245
20210411,11APR2021:00:00:00,UFU SANTOJANNI,157,139,159,121,16,296,266,30,280,16,2,13,65,77,74,34,21,10,0,51,99,116,266
20210411,11APR2021:00:00:00,UFU TORNU,132,120,130,89,33,252,230,22,234,18,10,14,42,84,47,33,20,2,0,50,104,76,230
20210411,11APR2021:00:00:00,UFU VELEZ SARSFIELD,140,144,198,73,13,284,280,4,284,0,0,11,65,55,45,74,21,13,0,79,122,79,280
20210411,11APR2021:00:00:00,UFU ZUBIZARRETA,148,107,162,67,26,255,233,22,255,0,0,29,63,63,40,37,23,0,0,44,112,77,233
20210412,12APR2021:00:00:00,UFU ALVAREZ,263,246,340,144,25,509,387,122,399,110,15,35,128,126,72,76,42,15,0,75,191,121,387
20210412,12APR2021:00:00:00,UFU ARGERICH,197,163,163,189,8,360,340,20,340,20,13,20,92,72,77,59,23,4,0,89,140,109,340
20210412,12APR2021:00:00:00,UFU BORDA-MOYANO,62,59,63,54,4,121,119,2,119,2,0,4,22,31,29,18,9,8,0,21,50,48,119
20210412,12APR2021:00:00:00,UFU DURAND,250,219,363,73,33,469,457,12,459,10,5,14,121,140,91,55,28,15,0,134,174,149,457
20210412,12APR2021:00:00:00,UFU ELIZALDE,89,82,65,100,7,172,127,45,162,10,48,87,6,11,17,1,2,0,0,16,71,40,127
20210412,12APR2021:00:00:00,UFU FERNANDEZ,182,130,227,69,16,312,296,16,306,6,0,3,76,89,58,43,27,16,0,69,84,143,296
20210412,12APR2021:00:00:00,UFU FERRER,151,92,96,130,17,243,233,10,233,10,0,0,73,67,50,38,12,3,0,56,79,98,233
20210412,12APR2021:00:00:00,UFU GRIERSON,153,142,132,135,28,295,289,6,289,6,0,18,99,42,72,48,16,0,0,58,121,110,289
20210412,12APR2021:00:00:00,UFU GUTIERREZ,146,93,164,67,8,239,213,26,237,2,59,57,50,28,19,20,6,0,0,29,112,72,213
20210412,12APR2021:00:00:00,UFU MUÑIZ,386,396,295,441,46,782,576,206,618,164,2,18,218,207,160,122,44,11,0,101,303,169,576
20210412,12APR2021:00:00:00,UFU PENNA,100,52,120,21,11,152,128,24,146,6,0,6,20,32,26,36,18,14,0,21,72,34,128
20210412,12APR2021:00:00:00,UFU PIROVANO,338,265,462,102,39,603,561,42,593,10,0,14,141,155,94,106,55,38,0,78,332,143,561
20210412,12APR2021:00:00:00,UFU PIÑERO,207,165,220,116,36,372,364,8,366,6,0,22,104,100,58,59,14,15,0,50,214,97,364
20210412,12APR2021:00:00:00,UFU RAMOS MEJIA,239,211,321,104,25,450,412,38,434,16,11,17,105,105,90,66,41,15,0,88,134,190,412
20210412,12APR2021:00:00:00,UFU RIVADAVIA,212,133,230,78,37,345,327,18,333,12,0,19,104,80,55,50,29,8,0,80,101,143,327
20210412,12APR2021:00:00:00,UFU SANTOJANNI,244,201,207,222,16,445,423,22,439,6,9,25,113,99,96,52,39,12,0,93,154,176,423
20210412,12APR2021:00:00:00,UFU TORNU,191,188,272,75,32,379,325,54,327,52,6,23,88,98,91,46,19,8,0,78,107,139,325
20210412,12APR2021:00:00:00,UFU VELEZ SARSFIELD,219,161,261,109,10,380,356,24,376,4,0,15,88,91,90,59,17,20,0,69,179,108,356
20210412,12APR2021:00:00:00,UFU ZUBIZARRETA,177,146,167,137,19,323,319,4,323,0,0,31,78,67,64,54,20,9,0,26,169,124,319
20210413,13APR2021:00:00:00,UFU ALVAREZ,317,315,479,130,23,632,574,58,596,36,19,31,168,180,104,72,42,16,0,94,317,163,574
20210413,13APR2021:00:00:00,UFU ARGERICH,145,128,138,119,16,273,232,41,234,39,7,8,75,62,66,35,9,11,0,50,111,71,232
20210413,13APR2021:00:00:00,UFU BORDA-MOYANO,81,98,99,71,9,179,177,2,177,2,0,6,29,45,60,14,18,7,0,31,76,69,177
20210413,13APR2021:00:00:00,UFU DURAND,257,243,410,81,9,500,482,18,482,18,6,38,128,107,80,99,19,23,0,109,213,160,482
20210413,13APR2021:00:00:00,UFU ELIZALDE,109,103,73,138,1,212,180,32,206,6,75,90,8,23,8,8,0,0,0,17,96,67,180
20210413,13APR2021:00:00:00,UFU FERNANDEZ,158,137,215,68,12,295,241,54,279,16,0,1,74,79,64,41,24,12,0,50,68,123,241
20210413,13APR2021:00:00:00,UFU FERRER,99,121,135,83,2,220,212,8,212,8,0,2,61,53,55,25,19,5,0,67,54,91,212
20210413,13APR2021:00:00:00,UFU GRIERSON,157,137,135,122,37,294,266,28,278,16,2,30,68,66,54,39,27,8,0,53,108,105,266
20210413,13APR2021:00:00:00,UFU GUTIERREZ,147,114,178,77,6,261,219,42,257,4,66,71,33,46,26,14,5,0,0,27,117,75,219
20210413,13APR2021:00:00:00,UFU MUÑIZ,372,374,258,445,43,746,564,182,612,134,0,15,179,215,199,92,37,9,0,90,341,133,564
20210413,13APR2021:00:00:00,UFU PENNA,102,67,133,32,4,169,147,22,157,12,0,3,51,26,30,21,27,11,0,33,71,42,147
20210413,13APR2021:00:00:00,UFU PIROVANO,212,222,338,85,11,434,372,62,428,6,0,14,81,126,88,48,52,25,0,63,204,97,372
20210413,13APR2021:00:00:00,UFU PIÑERO,191,171,213,126,23,362,352,10,358,4,0,8,95,95,79,50,25,10,0,63,196,90,352
20210413,13APR2021:00:00:00,UFU RAMOS MEJIA,259,196,311,107,37,455,397,58,417,38,10,27,116,115,85,52,47,3,0,87,153,157,397
20210413,13APR2021:00:00:00,UFU RIVADAVIA,297,230,381,103,43,527,503,24,511,16,0,12,181,154,70,61,32,17,0,130,155,211,503
20210413,13APR2021:00:00:00,UFU SANTOJANNI,246,216,225,226,11,462,434,28,456,6,10,31,106,108,88,71,36,12,0,93,161,180,434
20210413,13APR2021:00:00:00,UFU TORNU,195,195,279,91,20,390,352,38,352,38,13,34,85,118,75,29,25,11,0,73,132,147,352
20210413,13APR2021:00:00:00,UFU VELEZ SARSFIELD,233,173,296,94,16,406,386,20,406,0,0,13,136,71,81,55,34,16,0,78,181,127,386
20210413,13APR2021:00:00:00,UFU ZUBIZARRETA,193,148,215,114,12,341,321,20,341,0,0,11,77,88,75,45,32,13,0,26,197,98,321
20210414,14APR2021:00:00:00,UFU ALVAREZ,281,247,403,96,29,528,482,46,482,46,25,36,119,145,87,89,17,10,0,88,260,134,482
20210414,14APR2021:00:00:00,UFU ARGERICH,219,192,189,198,24,411,369,42,373,38,10,18,123,90,76,64,16,14,0,76,180,110,369
20210414,14APR2021:00:00:00,UFU BORDA-MOYANO,121,68,106,81,2,189,185,4,185,4,0,7,28,28,40,46,28,12,0,23,84,78,185
20210414,14APR2021:00:00:00,UFU DURAND,287,183,398,62,10,470,456,14,456,14,9,32,115,115,104,54,27,14,0,94,202,159,456
20210414,14APR2021:00:00:00,UFU ELIZALDE,112,82,58,129,7,194,154,40,186,8,77,70,10,19,8,8,2,0,0,6,81,67,154
20210414,14APR2021:00:00:00,UFU FERNANDEZ,207,179,284,72,30,386,342,44,368,18,0,10,110,105,81,49,23,8,0,61,52,229,342
20210414,14APR2021:00:00:00,UFU FERRER,125,145,109,132,29,270,260,10,262,8,0,4,69,86,64,32,14,1,0,42,140,78,260
20210414,14APR2021:00:00:00,UFU GRIERSON,137,131,129,107,33,269,260,9,261,8,1,12,59,81,56,51,4,5,0,53,102,105,260
20210414,14APR2021:00:00:00,UFU GUTIERREZ,157,112,164,86,19,269,255,14,267,2,45,60,47,49,22,38,8,0,0,27,144,82,255
20210414,14APR2021:00:00:00,UFU MUÑIZ,365,405,288,450,32,770,546,224,590,180,2,14,206,216,177,101,36,18,0,89,325,132,546
20210414,14APR2021:00:00:00,UFU PENNA,90,66,101,43,12,156,144,12,154,2,0,0,38,49,24,22,13,10,0,24,77,42,144
20210414,14APR2021:00:00:00,UFU PIROVANO,292,208,336,95,69,500,454,46,486,14,0,19,134,132,106,64,32,13,0,57,275,118,454
20210414,14APR2021:00:00:00,UFU PIÑERO,169,161,210,99,21,330,316,14,318,12,0,13,76,75,66,72,18,10,0,62,165,89,316
20210414,14APR2021:00:00:00,UFU RAMOS MEJIA,272,248,380,107,33,520,462,58,496,24,10,28,153,123,100,44,43,19,0,81,157,223,462
20210414,14APR2021:00:00:00,UFU RIVADAVIA,247,165,257,116,39,412,388,24,400,12,0,18,113,97,92,58,26,8,0,93,144,150,388
20210414,14APR2021:00:00:00,UFU SANTOJANNI,247,226,242,203,28,473,429,44,451,22,8,49,101,119,108,50,35,3,0,77,184,168,429
20210414,14APR2021:00:00:00,UFU TORNU,188,156,222,100,22,344,306,38,310,34,4,28,67,90,72,66,11,6,0,95,85,126,306
20210414,14APR2021:00:00:00,UFU VELEZ SARSFIELD,191,177,252,96,20,368,350,18,368,0,0,11,80,107,95,43,22,10,0,57,188,105,350
20210414,14APR2021:00:00:00,UFU ZUBIZARRETA,128,153,160,111,10,281,267,14,281,0,0,18,49,75,56,49,27,7,0,29,158,80,267
20210415,15APR2021:00:00:00,UFU ALVAREZ,266,232,381,110,8,499,472,27,475,24,16,28,136,132,81,60,40,6,0,77,261,134,472
20210415,15APR2021:00:00:00,UFU ARGERICH,144,118,106,141,16,263,238,25,241,22,11,17,80,58,44,22,22,9,0,46,113,78,238
20210415,15APR2021:00:00:00,UFU BORDA-MOYANO,128,63,119,71,1,191,181,10,181,10,1,6,36,35,47,25,25,16,0,24,84,73,181
20210415,15APR2021:00:00:00,UFU DURAND,263,207,374,84,13,471,452,19,461,10,10,15,108,155,90,55,28,10,0,103,207,141,452
20210415,15APR2021:00:00:00,UFU ELIZALDE,101,64,36,124,6,166,121,45,166,0,78,62,2,7,9,3,5,0,0,8,74,39,121
20210415,15APR2021:00:00:00,UFU FERNANDEZ,254,222,349,110,18,477,266,211,457,20,1,12,135,129,80,66,35,19,0,59,66,141,266
20210415,15APR2021:00:00:00,UFU FERRER,116,155,147,122,3,272,267,5,268,4,1,14,60,91,45,38,22,1,0,50,141,76,267
20210415,15APR2021:00:00:00,UFU GRIERSON,151,175,160,116,51,327,306,21,307,20,6,18,86,88,62,49,17,1,0,64,131,111,306
20210415,15APR2021:00:00:00,UFU GUTIERREZ,195,98,220,63,11,294,269,25,292,2,42,30,72,68,43,26,13,0,0,47,144,76,269
20210415,15APR2021:00:00:00,UFU MUÑIZ,401,398,317,442,41,800,537,263,558,242,1,10,222,197,170,121,66,13,0,81,319,137,537
20210415,15APR2021:00:00:00,UFU PENNA,96,77,138,33,3,174,143,31,168,6,1,3,33,32,33,35,27,10,0,29,63,51,143
20210415,15APR2021:00:00:00,UFU PIROVANO,266,221,361,83,44,488,457,31,484,4,1,12,103,158,86,78,29,21,0,61,264,126,457
20210415,15APR2021:00:00:00,UFU PIÑERO,217,191,256,124,29,409,378,31,401,8,4,26,89,110,91,53,25,11,0,75,206,95,378
20210415,15APR2021:00:00:00,UFU RAMOS MEJIA,229,182,293,80,39,412,375,37,410,2,12,23,114,86,69,64,34,10,0,92,125,158,375
20210415,15APR2021:00:00:00,UFU RIVADAVIA,244,191,314,81,41,436,423,13,428,8,1,5,143,119,70,55,30,13,0,81,156,184,423
20210415,15APR2021:00:00:00,UFU SANTOJANNI,213,200,225,177,12,414,389,25,404,10,7,12,90,126,84,65,16,14,0,91,144,154,389
20210415,15APR2021:00:00:00,UFU TORNU,247,191,311,103,25,439,406,33,413,26,23,24,97,129,58,68,30,10,0,77,190,139,406
20210415,15APR2021:00:00:00,UFU VELEZ SARSFIELD,206,206,290,119,4,413,362,51,407,6,3,9,115,75,91,73,31,16,0,42,205,115,362
20210415,15APR2021:00:00:00,UFU ZUBIZARRETA,146,94,119,104,18,241,222,19,241,0,1,2,52,46,68,31,26,15,0,2,111,109,222
20210416,16APR2021:00:00:00,UFU ALVAREZ,288,230,385,107,26,518,460,58,466,52,25,43,121,121,93,58,51,6,0,98,219,143,460
20210416,16APR2021:00:00:00,UFU ARGERICH,157,120,124,148,5,277,253,24,257,20,9,13,70,57,64,30,24,10,0,42,139,70,253
20210416,16APR2021:00:00:00,UFU BORDA-MOYANO,58,69,68,57,2,127,111,16,111,16,0,17,21,26,28,28,5,2,0,17,54,40,111
20210416,16APR2021:00:00:00,UFU DURAND,223,187,338,69,3,410,400,10,404,6,15,15,122,99,75,45,28,11,0,83,177,140,400
20210416,16APR2021:00:00:00,UFU ELIZALDE,59,55,48,63,3,114,96,18,112,2,31,41,11,13,9,3,4,2,0,11,51,34,96
20210416,16APR2021:00:00:00,UFU FERNANDEZ,155,131,203,68,15,286,244,42,270,16,0,7,73,88,48,33,23,14,0,39,101,104,244
20210416,16APR2021:00:00:00,UFU FERRER,162,119,129,152,0,281,279,2,279,2,0,3,87,68,62,38,22,1,0,59,141,79,279
20210416,16APR2021:00:00:00,UFU GRIERSON,149,129,162,95,21,278,274,4,274,4,0,14,86,61,66,34,14,3,0,72,95,106,274
20210416,16APR2021:00:00:00,UFU GUTIERREZ,151,96,189,58,0,247,217,30,245,2,50,42,64,50,31,4,6,0,0,36,110,69,217
20210416,16APR2021:00:00:00,UFU MUÑIZ,351,413,255,465,44,764,514,250,592,172,2,10,212,206,157,94,75,8,0,76,300,137,514
20210416,16APR2021:00:00:00,UFU PENNA,98,58,118,35,3,156,140,16,150,6,0,3,33,41,27,30,15,7,0,40,60,40,140
20210416,16APR2021:00:00:00,UFU PIROVANO,234,207,332,88,21,441,391,50,435,6,0,12,115,137,63,61,35,18,0,82,202,101,391
20210416,16APR2021:00:00:00,UFU PIÑERO,216,154,259,99,12,370,358,12,360,10,2,23,109,66,95,43,16,16,0,49,214,92,358
20210416,16APR2021:00:00:00,UFU RAMOS MEJIA,216,207,318,86,19,423,371,52,397,26,11,23,105,119,67,57,32,9,0,96,114,160,371
20210416,16APR2021:00:00:00,UFU RIVADAVIA,207,143,250,67,33,350,266,84,278,72,0,1,124,103,65,37,11,9,0,65,84,111,266
20210416,16APR2021:00:00:00,UFU SANTOJANNI,197,174,189,176,6,371,339,32,359,12,12,17,83,103,80,40,28,8,0,64,140,135,339
20210416,16APR2021:00:00:00,UFU TORNU,196,202,264,115,19,398,364,34,364,34,1,15,71,121,70,74,28,18,0,56,190,117,364
20210416,16APR2021:00:00:00,UFU VELEZ SARSFIELD,226,151,270,102,5,377,335,42,371,6,0,13,87,106,77,48,30,16,0,55,174,106,335
20210416,16APR2021:00:00:00,UFU ZUBIZARRETA,181,142,162,147,14,323,317,6,323,0,0,16,91,75,69,45,24,3,0,40,190,87,317
20210417,17APR2021:00:00:00,UFU ALVAREZ,231,172,339,39,25,403,391,12,391,12,6,29,98,119,62,51,24,14,0,96,178,117,391
20210417,17APR2021:00:00:00,UFU BORDA-MOYANO,40,48,48,36,4,88,84,4,84,4,0,3,18,14,26,11,8,8,0,13,33,38,84
20210417,17APR2021:00:00:00,UFU DURAND,184,134,275,39,4,318,308,10,310,8,3,24,77,79,50,45,32,8,0,80,143,84,308
20210417,17APR2021:00:00:00,UFU ELIZALDE,63,51,41,69,4,114,96,18,104,10,43,42,1,14,11,1,2,0,0,17,45,34,96
20210417,17APR2021:00:00:00,UFU FERNANDEZ,146,121,199,56,12,267,207,60,249,18,0,9,66,70,38,40,30,14,0,57,67,83,207
20210417,17APR2021:00:00:00,UFU FERRER,129,98,109,113,5,227,223,4,223,4,0,6,52,70,36,41,17,5,0,45,117,61,223
20210417,17APR2021:00:00:00,UFU GRIERSON,116,119,116,85,34,235,227,8,229,6,0,6,52,70,58,26,17,6,0,48,92,87,227
20210417,17APR2021:00:00:00,UFU GUTIERREZ,112,112,175,43,6,224,206,18,210,14,34,51,43,54,28,13,0,1,0,33,103,67,206
20210417,17APR2021:00:00:00,UFU MUÑIZ,241,258,201,284,14,499,345,154,397,102,0,12,102,112,121,81,45,26,0,76,175,94,345
20210417,17APR2021:00:00:00,UFU PENNA,55,66,92,29,0,121,105,16,117,4,2,2,33,27,25,17,11,4,0,25,46,34,105
20210417,17APR2021:00:00:00,UFU PIROVANO,192,137,256,51,22,329,301,28,329,0,2,5,73,82,72,53,28,14,0,49,153,97,301
20210417,17APR2021:00:00:00,UFU PIÑERO,148,128,167,100,9,276,270,6,270,6,4,11,84,78,54,14,22,9,0,59,126,83,270
20210417,17APR2021:00:00:00,UFU RAMOS MEJIA,150,149,219,50,30,299,257,42,271,28,5,27,62,81,49,41,24,10,0,71,83,103,257
20210417,17APR2021:00:00:00,UFU RIVADAVIA,249,215,361,86,17,464,389,75,389,75,0,4,156,133,59,61,32,19,0,81,174,132,389
20210417,17APR2021:00:00:00,UFU SANTOJANNI,168,162,167,154,9,330,320,10,324,6,2,20,64,83,76,47,30,8,0,70,125,125,320
20210417,17APR2021:00:00:00,UFU TORNU,159,147,178,88,40,306,278,28,280,26,14,9,65,74,60,53,21,10,0,55,128,95,278
20210417,17APR2021:00:00:00,UFU VELEZ SARSFIELD,235,191,328,93,5,426,418,8,426,0,0,29,93,102,103,65,18,16,0,65,218,135,418
20210417,17APR2021:00:00:00,UFU ZUBIZARRETA,178,139,165,141,11,317,295,22,317,0,0,14,75,93,45,60,20,10,0,38,167,90,295
20210418,18APR2021:00:00:00,UFU ALVAREZ,223,170,311,62,20,393,363,30,373,20,2,34,65,108,82,57,34,11,0,88,171,104,363
20210418,18APR2021:00:00:00,UFU ARGERICH,52,45,47,50,0,97,97,0,97,0,3,5,22,22,15,16,8,6,0,28,38,31,97
20210418,18APR2021:00:00:00,UFU BORDA-MOYANO,54,21,43,32,0,75,75,0,75,0,0,0,26,12,16,14,7,0,0,10,35,30,75
20210418,18APR2021:00:00:00,UFU DURAND,151,185,275,55,6,336,322,14,326,10,8,7,74,103,66,42,22,14,0,80,148,94,322
20210418,18APR2021:00:00:00,UFU ELIZALDE,80,75,58,93,4,155,101,54,145,10,85,43,5,11,8,1,2,0,0,10,53,38,101
20210518,18MAY2021:00:00:00,UFU PENNA,206,173,311,51,17,379,349,30,375,4,22,29,118,83,59,48,13,7,0,59,187,103,349
20210518,18MAY2021:00:00:00,UFU PIROVANO,243,162,292,85,28,405,341,64,401,4,0,17,72,94,91,77,38,16,0,91,112,137,341
20210518,18MAY2021:00:00:00,UFU PIÑERO,179,201,224,119,37,380,370,10,374,6,6,18,85,114,70,44,41,2,0,73,181,115,370
20210518,18MAY2021:00:00:00,UFU RAMOS MEJIA,235,190,298,97,30,425,381,44,415,10,14,20,99,118,91,42,28,13,0,75,152,152,381
20210518,18MAY2021:00:00:00,UFU RIVADAVIA,224,125,219,96,34,349,319,30,333,16,0,5,108,72,55,60,41,8,0,75,111,130,319
20210518,18MAY2021:00:00:00,UFU SANTOJANNI,196,205,213,182,6,401,371,30,401,0,14,20,69,90,84,58,39,27,0,73,187,110,371
20210518,18MAY2021:00:00:00,UFU TORNU,137,133,185,74,11,270,252,18,262,8,15,31,56,62,48,44,6,8,0,28,137,84,252
20210518,18MAY2021:00:00:00,UFU VELEZ SARSFIELD,176,166,223,98,21,342,330,12,340,2,0,8,59,100,89,50,26,10,0,66,153,111,330
20210518,18MAY2021:00:00:00,UFU ZUBIZARRETA,194,167,200,147,14,361,361,0,361,0,0,4,107,84,72,49,23,22,0,74,186,101,361
20210519,19MAY2021:00:00:00,UFU ALVAREZ,249,214,315,138,10,463,427,36,441,22,18,30,98,99,121,58,29,10,0,108,195,124,427
20210519,19MAY2021:00:00:00,UFU ARGERICH,109,81,98,84,8,190,160,30,164,26,9,5,52,54,32,31,5,2,0,40,51,69,160
20210519,19MAY2021:00:00:00,UFU BORDA-MOYANO,65,75,55,82,3,140,126,14,126,14,2,0,30,33,42,20,7,6,0,14,73,39,126
20210519,19MAY2021:00:00:00,UFU DURAND,165,137,262,36,4,302,296,6,296,6,3,12,88,72,52,40,29,6,0,63,149,84,296
20210519,19MAY2021:00:00:00,UFU ELIZALDE,90,76,77,85,4,166,148,18,160,6,71,42,28,12,5,8,0,0,0,13,79,56,148
20210519,19MAY2021:00:00:00,UFU FERNANDEZ,125,117,171,51,20,242,188,54,228,14,0,4,54,85,40,33,21,5,0,50,40,98,188
20210519,19MAY2021:00:00:00,UFU FERRER,157,141,151,130,17,298,290,8,290,8,0,0,96,72,63,43,20,4,0,51,151,88,290
20210519,19MAY2021:00:00:00,UFU GRIERSON,168,183,115,184,52,351,341,10,341,10,0,11,107,84,81,36,21,11,0,75,137,129,341
20210519,19MAY2021:00:00:00,UFU GUTIERREZ,195,148,253,69,21,343,301,42,335,8,64,57,62,101,35,19,3,2,0,42,153,105,301
20210519,19MAY2021:00:00:00,UFU MUÑIZ,304,334,254,355,29,638,426,212,532,106,0,15,147,184,131,107,41,13,0,84,240,102,426
20210519,19MAY2021:00:00:00,UFU PENNA,104,55,139,20,0,159,135,24,153,6,0,11,40,40,25,23,16,4,0,32,60,43,135
20210519,19MAY2021:00:00:00,UFU PIROVANO,201,142,257,65,21,343,309,34,333,10,0,10,83,115,65,43,18,9,0,92,101,116,309
20210519,19MAY2021:00:00:00,UFU PIÑERO,206,171,258,107,12,377,359,18,363,14,0,19,104,88,85,54,20,7,0,74,187,98,359
20210519,19MAY2021:00:00:00,UFU RAMOS MEJIA,273,240,383,105,25,513,391,122,455,58,22,27,113,136,88,72,42,13,0,74,166,150,391
20210519,19MAY2021:00:00:00,UFU RIVADAVIA,195,173,261,80,27,368,279,89,291,77,0,3,98,83,72,63,33,16,0,57,105,112,279
20210519,19MAY2021:00:00:00,UFU SANTOJANNI,196,184,172,183,25,380,360,20,374,6,3,14,83,94,71,65,39,11,0,47,172,141,360
20210519,19MAY2021:00:00:00,UFU TORNU,161,152,233,58,22,313,269,44,283,30,23,17,72,73,78,29,14,7,0,41,143,82,269
20210519,19MAY2021:00:00:00,UFU VELEZ SARSFIELD,150,205,220,121,14,355,341,14,353,2,2,15,80,90,80,55,28,5,0,60,174,107,341
20210519,19MAY2021:00:00:00,UFU ZUBIZARRETA,203,201,235,156,13,404,404,0,404,0,0,15,95,94,82,67,33,18,0,62,224,118,404
20210520,20MAY2021:00:00:00,UFU ALVAREZ,212,238,318,123,9,450,434,16,438,12,29,35,98,121,82,39,35,11,0,85,222,127,434
20210520,20MAY2021:00:00:00,UFU ARGERICH,124,100,99,117,8,224,188,36,196,28,7,15,35,66,51,22,22,6,0,58,45,85,188
20210520,20MAY2021:00:00:00,UFU BORDA-MOYANO,54,48,60,38,4,102,88,14,88,14,0,2,16,27,19,18,16,4,0,6,62,20,88
20210520,20MAY2021:00:00:00,UFU DURAND,204,126,253,59,18,330,318,12,324,6,2,14,64,130,49,30,30,11,0,62,168,88,318
20210520,20MAY2021:00:00:00,UFU ELIZALDE,88,86,67,99,8,174,146,28,168,6,92,50,8,15,9,0,0,0,0,18,70,58,146
20210520,20MAY2021:00:00:00,UFU FERNANDEZ,158,98,182,57,17,256,226,30,248,8,0,4,56,87,49,36,9,15,0,39,75,112,226
20210520,20MAY2021:00:00:00,UFU FERRER,113,102,98,111,6,215,211,4,213,2,0,0,54,60,52,25,14,10,0,38,113,60,211
20210520,20MAY2021:00:00:00,UFU GRIERSON,147,169,158,126,32,316,300,16,304,12,2,21,60,93,70,47,11,12,0,68,123,109,300
20210520,20MAY2021:00:00:00,UFU GUTIERREZ,249,139,299,76,13,388,346,42,374,14,55,52,88,97,40,37,16,3,0,57,173,116,346
20210520,20MAY2021:00:00:00,UFU MUÑIZ,259,409,218,415,35,668,500,168,520,148,2,26,144,208,138,103,36,11,0,89,283,128,500
20210520,20MAY2021:00:00:00,UFU PENNA,94,102,176,16,4,196,164,32,192,4,0,5,64,36,36,21,17,17,0,36,79,49,164
20210520,20MAY2021:00:00:00,UFU PIROVANO,258,193,334,72,45,451,395,56,443,8,0,7,93,162,65,64,46,14,0,99,123,173,395
20210520,20MAY2021:00:00:00,UFU PIÑERO,180,151,213,103,15,331,317,14,317,14,5,25,88,77,76,27,24,9,0,59,172,84,317
20210520,20MAY2021:00:00:00,UFU RAMOS MEJIA,211,231,302,105,35,442,302,140,376,66,12,24,101,115,80,67,34,9,0,57,121,123,302
20210520,20MAY2021:00:00:00,UFU RIVADAVIA,167,165,230,77,25,332,268,64,274,58,0,2,91,105,60,25,39,10,0,57,97,111,268
20210520,20MAY2021:00:00:00,UFU SANTOJANNI,248,178,237,177,12,426,414,12,422,4,6,40,99,119,87,37,23,15,0,70,240,104,414
20210520,20MAY2021:00:00:00,UFU TORNU,146,121,212,40,15,267,249,18,257,10,8,33,38,66,51,44,18,9,0,45,126,77,249
20210520,20MAY2021:00:00:00,UFU VELEZ SARSFIELD,231,170,284,101,16,401,359,42,401,0,2,12,123,95,71,58,20,20,0,51,199,109,359
20210520,20MAY2021:00:00:00,UFU ZUBIZARRETA,182,170,166,183,3,352,348,4,352,0,0,21,73,92,82,55,27,2,0,53,194,101,348
20210521,21MAY2021:00:00:00,UFU ALVAREZ,191,147,237,91,10,338,325,13,327,11,8,16,106,88,62,31,21,6,0,53,177,95,325
20210521,21MAY2021:00:00:00,UFU ARGERICH,102,65,81,81,5,167,130,37,130,37,4,8,36,49,27,22,11,10,0,36,39,50,130
20210521,21MAY2021:00:00:00,UFU BORDA-MOYANO,74,61,54,77,4,135,123,12,123,12,0,7,21,48,32,19,8,0,0,5,82,36,123
20210521,21MAY2021:00:00:00,UFU DURAND,179,149,231,66,31,328,312,16,318,10,9,16,74,98,69,40,15,7,0,63,157,92,312
20210521,21MAY2021:00:00:00,UFU ELIZALDE,72,39,46,64,1,111,91,20,107,4,55,25,12,13,5,1,0,0,0,7,51,33,91
20210521,21MAY2021:00:00:00,UFU FERNANDEZ,139,115,178,60,16,254,192,62,242,12,0,3,63,72,61,27,19,9,0,48,64,80,192
20210521,21MAY2021:00:00:00,UFU FERRER,146,108,139,98,17,254,252,2,252,2,0,5,77,71,55,35,4,7,0,54,124,74,252
20210521,21MAY2021:00:00:00,UFU GRIERSON,134,133,118,121,28,267,251,16,259,8,0,1,87,70,51,36,13,9,0,55,100,95,251
20210521,21MAY2021:00:00:00,UFU GUTIERREZ,155,119,196,54,24,274,262,12,274,0,41,16,82,72,42,19,2,0,0,45,138,79,262
20210521,21MAY2021:00:00:00,UFU MUÑIZ,199,264,134,296,33,463,299,164,367,96,0,12,117,111,108,71,34,10,0,57,164,78,299
20210521,21MAY2021:00:00:00,UFU PENNA,69,60,116,10,3,129,107,22,125,4,0,5,37,29,25,24,8,1,0,17,62,28,107
20210521,21MAY2021:00:00:00,UFU PIROVANO,176,126,227,53,22,302,272,30,296,6,0,12,63,83,59,56,22,7,0,68,96,108,272
20210521,21MAY2021:00:00:00,UFU PIÑERO,176,165,175,156,10,341,329,12,331,10,0,9,111,83,77,45,12,4,0,63,171,94,329
20210521,21MAY2021:00:00:00,UFU RAMOS MEJIA,149,147,215,60,21,296,216,80,258,38,6,14,60,84,61,48,21,2,0,46,78,92,216
20210521,21MAY2021:00:00:00,UFU RIVADAVIA,152,110,189,57,16,262,216,46,250,12,0,7,61,94,43,31,13,13,0,64,60,83,216
20210521,21MAY2021:00:00:00,UFU SANTOJANNI,151,158,149,146,14,309,299,10,303,6,3,16,78,78,72,33,20,9,0,67,148,84,299
20210521,21MAY2021:00:00:00,UFU TORNU,122,93,160,43,12,215,195,20,195,20,6,16,53,51,37,28,13,11,0,36,96,62,195
20210521,21MAY2021:00:00:00,UFU VELEZ SARSFIELD,169,133,216,66,20,302,298,4,300,2,0,9,66,84,69,42,19,13,0,55,154,89,298
20210521,21MAY2021:00:00:00,UFU ZUBIZARRETA,156,155,188,103,20,311,311,0,311,0,0,12,71,93,64,29,30,12,0,45,190,76,311
20210522,22MAY2021:00:00:00,UFU ALVAREZ,144,118,201,50,11,262,250,12,254,8,11,9,69,57,72,27,5,12,0,62,112,76,250
20210522,22MAY2021:00:00:00,UFU ARGERICH,27,27,33,21,0,54,52,2,54,0,0,0,9,17,5,12,10,1,0,25,6,21,52
20210522,22MAY2021:00:00:00,UFU BORDA-MOYANO,53,16,63,6,0,69,55,14,55,14,1,3,18,19,17,6,3,2,0,2,33,20,55
20210522,22MAY2021:00:00:00,UFU DURAND,129,84,175,32,6,213,205,8,205,8,2,9,36,60,53,31,19,3,0,57,87,61,205
20210522,22MAY2021:00:00:00,UFU ELIZALDE,49,45,60,34,0,94,80,14,90,4,32,41,4,5,11,1,0,0,0,9,43,28,80
20210522,22MAY2021:00:00:00,UFU FERNANDEZ,185,162,268,58,21,347,135,212,335,12,0,5,94,106,84,16,30,12,0,33,41,61,135
20210522,22MAY2021:00:00:00,UFU FERRER,30,35,50,12,3,65,57,8,57,8,0,0,21,20,12,5,7,0,0,8,33,16,57
20210522,22MAY2021:00:00:00,UFU GRIERSON,122,98,91,72,57,220,208,12,208,12,1,4,50,56,56,37,10,6,0,41,93,74,208
20210522,22MAY2021:00:00:00,UFU GUTIERREZ,124,100,167,38,19,224,204,20,222,2,44,34,55,55,16,17,1,2,0,32,103,68,204
20210522,22MAY2021:00:00:00,UFU MUÑIZ,158,164,148,147,27,322,244,78,282,40,0,12,68,86,66,67,19,4,0,49,128,67,244
20210522,22MAY2021:00:00:00,UFU PENNA,64,30,76,15,3,94,80,14,92,2,0,0,20,26,8,29,9,2,0,20,33,27,80
20210522,22MAY2021:00:00:00,UFU PIROVANO,163,108,230,33,8,271,229,42,265,6,0,4,67,77,54,34,19,16,0,69,57,103,229
20210522,22MAY2021:00:00:00,UFU PIÑERO,87,81,104,59,5,168,160,8,160,8,2,11,39,40,37,29,4,6,0,41,68,49,160
20210522,22MAY2021:00:00:00,UFU RAMOS MEJIA,173,142,251,44,20,315,191,124,243,72,7,16,85,86,55,51,7,8,0,23,89,79,191
20210522,22MAY2021:00:00:00,UFU RIVADAVIA,104,75,147,22,10,179,167,12,167,12,0,10,49,41,19,34,19,7,0,40,52,75,167
20210522,22MAY2021:00:00:00,UFU SANTOJANNI,120,144,151,104,9,264,256,8,258,6,0,8,73,52,58,47,15,11,0,62,126,68,256
20210522,22MAY2021:00:00:00,UFU TORNU,49,61,85,13,12,110,94,16,94,16,0,2,31,37,23,9,5,3,0,17,46,31,94
20210522,22MAY2021:00:00:00,UFU VELEZ SARSFIELD,142,142,207,63,14,284,280,4,282,2,0,4,62,70,82,40,15,11,0,48,148,84,280
20210522,22MAY2021:00:00:00,UFU ZUBIZARRETA,124,101,154,61,10,225,221,4,225,0,0,3,60,51,38,38,24,11,0,36,119,66,221
20210523,23MAY2021:00:00:00,UFU ALVAREZ,130,107,196,30,11,237,212,25,216,21,1,15,72,58,30,39,19,3,0,55,90,67,212
20210523,23MAY2021:00:00:00,UFU ARGERICH,49,68,72,45,0,117,115,2,117,0,0,5,26,35,18,17,11,5,0,42,25,47,115
20210523,23MAY2021:00:00:00,UFU BORDA-MOYANO,30,21,37,14,0,51,43,8,43,8,0,4,9,19,5,8,6,0,0,7,22,14,43
20210523,23MAY2021:00:00:00,UFU DURAND,151,114,211,52,2,265,257,8,259,6,6,7,62,77,52,42,18,1,0,72,111,74,257
20210523,23MAY2021:00:00:00,UFU ELIZALDE,38,39,38,37,2,77,53,24,75,2,25,25,5,8,7,7,0,0,0,5,33,15,53
20210523,23MAY2021:00:00:00,UFU FERNANDEZ,76,53,103,24,2,129,119,10,125,4,0,3,18,43,31,11,20,3,0,35,18,66,119
20210523,23MAY2021:00:00:00,UFU FERRER,32,18,33,13,4,50,44,6,44,6,0,0,21,5,20,4,0,0,0,13,20,11,44
20210523,23MAY2021:00:00:00,UFU GRIERSON,110,116,99,56,71,226,216,10,222,4,0,11,55,54,61,25,13,7,0,66,73,77,216
20210523,23MAY2021:00:00:00,UFU GUTIERREZ,88,65,128,16,9,153,137,16,149,4,20,26,31,43,10,11,12,0,0,23,65,48,137
20210523,23MAY2021:00:00:00,UFU MUÑIZ,145,167,121,172,19,312,266,46,286,26,0,9,63,96,53,49,26,16,0,53,136,77,266
20210523,23MAY2021:00:00:00,UFU PENNA,37,47,69,13,2,84,76,8,78,6,0,0,18,30,15,12,9,0,0,21,31,24,76
20210523,23MAY2021:00:00:00,UFU PIROVANO,140,114,223,22,9,254,236,18,242,12,1,17,37,70,63,37,11,18,0,70,69,97,236
20210523,23MAY2021:00:00:00,UFU PIÑERO,139,116,156,81,18,255,239,16,243,12,0,22,63,51,62,30,19,8,0,46,119,73,239
20210523,23MAY2021:00:00:00,UFU RAMOS MEJIA,178,136,221,56,37,314,268,46,278,36,5,17,79,72,53,58,21,9,0,64,86,118,268
20210523,23MAY2021:00:00:00,UFU RIVADAVIA,78,77,126,18,11,155,147,8,147,8,0,2,41,47,35,18,5,7,0,33,50,64,147
20210523,23MAY2021:00:00:00,UFU SANTOJANNI,178,142,148,160,12,320,312,8,314,6,0,22,69,65,74,37,35,18,0,82,130,99,312
20210523,23MAY2021:00:00:00,UFU TORNU,61,89,133,6,11,150,142,8,142,8,0,0,48,34,35,12,10,11,0,38,60,44,142
20210523,23MAY2021:00:00:00,UFU VELEZ SARSFIELD,120,98,162,50,6,218,206,12,212,6,3,5,49,56,42,32,13,18,0,49,93,64,206
20210523,23MAY2021:00:00:00,UFU ZUBIZARRETA,124,105,164,62,3,229,229,0,229,0,0,20,39,46,50,48,16,10,0,49,107,73,229
20210524,24MAY2021:00:00:00,UFU ALVAREZ,169,193,272,65,25,362,341,21,341,21,6,21,63,92,60,68,38,14,0,98,127,116,341
20210524,24MAY2021:00:00:00,UFU ARGERICH,60,56,76,39,1,116,114,2,116,0,2,2,32,33,22,16,7,2,0,37,28,48,114
20210524,24MAY2021:00:00:00,UFU BORDA-MOYANO,27,42,43,25,1,69,63,6,63,6,0,3,8,24,11,15,8,0,0,7,32,24,63
20210524,24MAY2021:00:00:00,UFU DURAND,164,146,292,15,3,310,298,12,298,12,3,11,84,77,61,52,14,8,0,83,133,82,298
20210524,24MAY2021:00:00:00,UFU ELIZALDE,94,54,60,85,3,148,132,16,144,4,53,39,16,21,14,3,2,0,0,14,73,45,132
20210524,24MAY2021:00:00:00,UFU FERNANDEZ,75,78,121,24,8,153,133,20,145,8,0,0,34,46,36,21,8,8,0,36,43,54,133
20210524,24MAY2021:00:00:00,UFU FERRER,83,70,109,41,3,153,143,10,143,10,0,5,32,49,28,18,21,0,0,40,57,46,143
20210524,24MAY2021:00:00:00,UFU GRIERSON,142,176,165,137,16,318,308,10,308,10,0,7,71,91,70,57,14,8,0,81,110,117,308
20210524,24MAY2021:00:00:00,UFU GUTIERREZ,148,90,189,39,10,238,228,10,234,4,24,39,57,56,32,18,7,5,0,37,119,70,228
20210524,24MAY2021:00:00:00,UFU MUÑIZ,206,195,174,192,35,401,311,90,355,46,0,3,98,98,85,80,26,11,0,72,147,92,311
20210524,24MAY2021:00:00:00,UFU PENNA,86,51,92,40,5,137,125,12,131,6,0,2,26,49,33,12,11,4,0,31,52,42,125
20210524,24MAY2021:00:00:00,UFU PIROVANO,149,140,234,42,13,289,267,22,289,0,0,4,50,85,81,32,27,10,0,80,84,103,267
20210524,24MAY2021:00:00:00,UFU PIÑERO,138,105,159,79,5,243,231,12,237,6,0,10,62,58,54,36,18,5,0,53,111,61,231
20210524,24MAY2021:00:00:00,UFU RAMOS MEJIA,164,168,232,62,38,332,246,86,310,22,11,19,73,78,51,60,29,11,0,63,79,104,246
20210524,24MAY2021:00:00:00,UFU RIVADAVIA,128,109,194,30,13,237,223,14,227,10,0,0,62,58,48,35,26,8,0,54,72,97,223
20210524,24MAY2021:00:00:00,UFU SANTOJANNI,222,217,277,144,18,439,413,26,423,16,14,15,98,98,85,82,38,9,0,86,214,113,413
20210524,24MAY2021:00:00:00,UFU TORNU,116,83,123,63,13,199,187,12,187,12,3,8,48,45,41,31,23,0,0,40,89,58,187
20210524,24MAY2021:00:00:00,UFU VELEZ SARSFIELD,155,112,202,56,9,267,261,6,261,6,0,1,85,57,65,35,21,3,0,63,122,76,261
20210524,24MAY2021:00:00:00,UFU ZUBIZARRETA,145,161,210,89,7,306,298,8,306,0,0,12,70,72,69,54,14,15,0,60,155,83,298
20210525,25MAY2021:00:00:00,UFU ALVAREZ,164,122,245,32,9,286,266,20,266,20,10,9,79,67,51,46,13,11,0,68,117,81,266
20210525,25MAY2021:00:00:00,UFU ARGERICH,50,34,53,29,2,84,82,2,84,0,2,4,16,22,17,9,8,6,0,29,19,34,82
20210525,25MAY2021:00:00:00,UFU BORDA-MOYANO,26,17,22,21,0,43,35,8,35,8,0,2,13,10,6,2,8,2,0,6,19,10,35
20210525,25MAY2021:00:00:00,UFU DURAND,129,157,267,17,2,286,274,12,276,10,2,9,60,94,53,32,22,14,0,76,125,72,274
20210525,25MAY2021:00:00:00,UFU ELIZALDE,69,73,61,71,10,142,102,40,140,2,57,53,3,15,10,4,0,0,0,7,55,40,102
20210525,25MAY2021:00:00:00,UFU FERNANDEZ,70,61,104,18,9,131,119,12,121,10,0,3,22,46,27,12,16,5,0,31,45,43,119
20210525,25MAY2021:00:00:00,UFU FERRER,73,65,73,63,2,138,138,0,138,0,0,2,25,56,32,6,15,2,0,33,65,40,138
20210525,25MAY2021:00:00:00,UFU GRIERSON,94,104,117,59,22,198,170,28,194,4,0,6,47,39,55,30,11,10,0,56,53,61,170
20210525,25MAY2021:00:00:00,UFU GUTIERREZ,146,101,195,44,8,247,229,18,239,8,40,29,56,69,27,18,8,0,0,39,116,73,229
20210525,25MAY2021:00:00:00,UFU MUÑIZ,197,194,183,186,22,391,277,114,305,86,2,4,88,106,84,66,28,13,0,56,139,82,277
20210525,25MAY2021:00:00:00,UFU PENNA,43,44,56,27,4,87,75,12,83,4,0,0,14,23,17,21,11,1,0,21,32,22,75
20210525,25MAY2021:00:00:00,UFU PIROVANO,176,139,262,32,21,315,285,30,313,2,0,9,62,115,60,41,23,5,0,99,65,121,285
20210525,25MAY2021:00:00:00,UFU PIÑERO,108,85,134,49,10,193,185,8,185,8,0,4,32,48,52,41,15,1,0,47,86,52,185
20210525,25MAY2021:00:00:00,UFU RAMOS MEJIA,129,144,209,45,19,273,187,86,251,22,4,12,53,100,43,37,13,11,0,42,65,80,187
20210525,25MAY2021:00:00:00,UFU RIVADAVIA,115,110,172,40,13,225,215,10,219,6,0,11,58,58,45,25,22,6,0,57,72,85,215
20210525,25MAY2021:00:00:00,UFU SANTOJANNI,209,145,196,143,15,354,332,22,340,14,4,9,76,93,73,59,31,9,0,87,152,93,332
20210525,25MAY2021:00:00:00,UFU TORNU,71,98,114,44,11,169,163,6,163,6,3,14,41,43,31,30,4,3,0,39,57,67,163
20210525,25MAY2021:00:00:00,UFU VELEZ SARSFIELD,145,152,236,48,13,297,285,12,291,6,0,5,59,55,83,65,23,7,0,67,125,93,285
20210525,25MAY2021:00:00:00,UFU ZUBIZARRETA,74,128,156,46,0,202,202,0,202,0,0,11,49,43,50,27,21,1,0,43,98,61,202
20210526,26MAY2021:00:00:00,UFU ALVAREZ,209,223,359,60,13,432,402,30,402,30,19,33,95,103,78,59,29,16,0,111,172,119,402
20210526,26MAY2021:00:00:00,UFU ARGERICH,105,66,100,66,5,171,155,16,155,16,6,5,37,44,21,34,16,8,0,41,44,70,155
20210526,26MAY2021:00:00:00,UFU BORDA-MOYANO,25,33,27,31,0,58,48,10,48,10,0,8,10,19,7,9,5,0,0,6,27,15,48
20210526,26MAY2021:00:00:00,UFU DURAND,156,141,257,26,14,297,281,16,283,14,2,15,63,54,56,67,30,10,0,60,141,80,281
20210526,26MAY2021:00:00:00,UFU ELIZALDE,90,93,45,133,5,183,162,21,172,11,51,42,9,32,27,15,7,0,0,23,82,57,162
20210526,26MAY2021:00:00:00,UFU FERNANDEZ,115,79,152,30,12,194,164,30,180,14,0,2,52,53,47,26,10,4,0,34,64,66,164
20210526,26MAY2021:00:00:00,UFU FERRER,145,93,146,89,3,238,228,10,228,10,0,0,52,72,38,56,15,5,0,62,98,68,228
20210526,26MAY2021:00:00:00,UFU GRIERSON,132,133,153,105,7,265,255,10,257,8,0,11,67,55,57,39,26,10,0,84,70,101,255
20210526,26MAY2021:00:00:00,UFU GUTIERREZ,192,120,223,64,25,312,296,16,312,0,44,34,60,81,53,28,12,0,0,42,161,93,296
20210526,26MAY2021:00:00:00,UFU MUÑIZ,226,295,224,253,44,521,393,128,447,74,2,6,113,159,118,76,39,8,0,88,202,103,393
20210526,26MAY2021:00:00:00,UFU PENNA,76,93,130,24,15,169,115,54,157,12,0,2,42,42,28,36,18,1,0,32,51,32,115
20210526,26MAY2021:00:00:00,UFU PIROVANO,143,128,211,38,22,271,257,14,265,6,0,7,57,77,51,46,24,9,0,76,84,97,257
20210526,26MAY2021:00:00:00,UFU PIÑERO,150,145,204,74,17,295,273,22,289,6,0,9,79,80,40,53,26,8,0,59,137,76,273
20210526,26MAY2021:00:00:00,UFU RAMOS MEJIA,163,171,234,76,24,334,238,96,278,56,9,14,74,97,58,47,20,15,0,54,72,112,238
20210526,26MAY2021:00:00:00,UFU RIVADAVIA,196,146,256,58,28,342,228,114,252,90,0,3,114,88,45,63,18,11,0,64,76,87,228
20210526,26MAY2021:00:00:00,UFU SANTOJANNI,173,203,195,171,10,376,358,18,372,4,8,17,68,92,93,51,35,12,0,67,193,98,358
20210526,26MAY2021:00:00:00,UFU TORNU,128,122,184,53,13,250,232,18,234,16,7,13,51,56,56,46,12,9,0,51,102,76,232
20210526,26MAY2021:00:00:00,UFU VELEZ SARSFIELD,160,154,222,81,11,314,300,14,312,2,6,11,75,62,67,54,20,19,0,61,146,93,300
20210526,26MAY2021:00:00:00,UFU ZUBIZARRETA,115,79,129,59,6,194,184,10,194,0,0,5,45,37,44,39,13,11,0,26,103,55,184
20210527,27MAY2021:00:00:00,UFU ALVAREZ,205,173,280,96,2,378,366,12,366,12,9,13,125,103,53,33,30,12,0,71,187,108,366
20210527,27MAY2021:00:00:00,UFU ARGERICH,94,82,104,62,10,176,142,34,150,26,6,4,31,47,35,32,15,6,0,39,37,65,142
20210527,27MAY2021:00:00:00,UFU BORDA-MOYANO,88,34,94,28,0,122,116,6,116,6,0,6,19,23,19,22,11,22,0,17,52,47,116
20210527,27MAY2021:00:00:00,UFU DURAND,151,151,260,25,17,302,282,20,292,10,0,15,55,101,65,40,15,11,0,81,118,82,282
20210527,27MAY2021:00:00:00,UFU ELIZALDE,58,68,38,88,0,126,118,8,122,4,32,37,8,18,18,12,1,0,0,5,72,41,118
20210527,27MAY2021:00:00:00,UFU FERNANDEZ,173,110,201,56,26,283,175,108,271,12,0,7,81,70,48,41,32,4,0,37,68,70,175
20210527,27MAY2021:00:00:00,UFU FERRER,97,72,90,69,10,169,159,10,161,8,0,2,41,44,41,35,3,3,0,39,74,46,159
20210527,27MAY2021:00:00:00,UFU GRIERSON,95,136,124,94,13,231,211,20,211,20,0,11,57,80,40,27,11,5,0,55,78,77,211
20210527,27MAY2021:00:00:00,UFU GUTIERREZ,184,134,250,44,24,318,286,32,310,8,47,30,63,79,59,21,16,3,0,57,135,89,286
20210527,27MAY2021:00:00:00,UFU MUÑIZ,242,248,176,283,31,490,376,114,394,96,0,5,114,138,107,96,16,14,0,58,220,98,376
20210527,27MAY2021:00:00:00,UFU PENNA,90,107,162,33,2,197,151,46,189,8,0,8,43,40,52,40,13,1,0,24,80,47,151
20210527,27MAY2021:00:00:00,UFU PIROVANO,180,185,271,70,24,365,319,46,359,6,0,6,68,93,65,77,42,14,0,93,98,128,319
20210527,27MAY2021:00:00:00,UFU PIÑERO,123,146,175,75,19,269,263,6,265,4,0,6,55,54,74,41,34,5,0,55,124,83,263
20210527,27MAY2021:00:00:00,UFU RAMOS MEJIA,154,150,226,55,23,304,217,87,293,11,3,7,58,106,54,47,23,6,0,40,88,89,217
20210527,27MAY2021:00:00:00,UFU RIVADAVIA,133,108,168,54,19,241,187,54,197,44,0,4,58,57,59,33,27,3,0,45,49,93,187
20210527,27MAY2021:00:00:00,UFU SANTOJANNI,187,180,216,137,14,367,355,12,367,0,2,23,58,82,93,58,40,11,0,63,191,101,355
20210527,27MAY2021:00:00:00,UFU TORNU,128,121,183,43,23,249,223,26,223,26,23,7,57,65,65,26,4,2,0,63,93,66,223
20210527,27MAY2021:00:00:00,UFU VELEZ SARSFIELD,157,149,214,68,24,306,294,12,304,2,0,6,83,69,53,56,29,10,0,41,161,92,294
20210527,27MAY2021:00:00:00,UFU ZUBIZARRETA,151,159,196,103,11,310,306,4,310,0,0,5,75,65,81,44,16,24,0,52,163,91,306
20210528,28MAY2021:00:00:00,UFU ALVAREZ,202,183,317,52,16,385,355,30,357,28,11,22,96,87,61,66,26,16,0,78,167,110,355
20210528,28MAY2021:00:00:00,UFU ARGERICH,75,75,89,58,3,150,136,14,136,14,2,0,30,37,29,24,21,7,0,37,48,51,136
20210528,28MAY2021:00:00:00,UFU BORDA-MOYANO,47,63,67,40,3,110,84,26,84,26,0,6,19,30,20,23,10,2,0,4,52,28,84
20210528,28MAY2021:00:00:00,UFU DURAND,194,136,261,39,30,330,322,8,322,8,0,11,67,104,76,36,28,8,0,69,163,90,322
20210528,28MAY2021:00:00:00,UFU ELIZALDE,66,67,71,58,4,133,118,15,124,9,37,48,2,18,12,10,4,2,0,8,62,48,118
20210528,28MAY2021:00:00:00,UFU FERNANDEZ,133,86,156,43,20,219,189,30,205,14,0,5,42,52,52,40,21,7,0,39,74,76,189
20210528,28MAY2021:00:00:00,UFU FERRER,138,104,139,88,15,242,230,12,230,12,0,4,74,71,35,20,25,13,0,44,118,68,230
20210528,28MAY2021:00:00:00,UFU GRIERSON,120,150,147,113,10,270,244,26,258,12,0,16,57,76,59,39,19,4,0,58,93,93,244
20210528,28MAY2021:00:00:00,UFU GUTIERREZ,177,128,228,57,20,305,277,28,301,4,35,39,74,51,60,29,14,3,0,39,164,73,277
20210528,28MAY2021:00:00:00,UFU MUÑIZ,226,247,204,251,18,473,340,133,386,87,0,7,104,110,111,87,43,11,0,53,196,91,340
20210528,28MAY2021:00:00:00,UFU PENNA,94,71,136,21,8,165,125,40,159,6,0,1,37,53,21,34,18,1,0,26,60,39,125
20210528,28MAY2021:00:00:00,UFU PIROVANO,166,122,223,44,21,288,264,24,288,0,0,2,56,71,64,42,37,16,0,56,100,108,264
20210505,05MAY2021:00:00:00,UFU ARGERICH,99,91,106,76,8,190,138,52,140,50,5,6,53,44,48,23,7,4,0,38,45,54,138
20210505,05MAY2021:00:00:00,UFU BORDA-MOYANO,60,54,80,31,3,114,100,14,100,14,2,8,33,34,14,13,10,0,0,10,51,39,100
20210505,05MAY2021:00:00:00,UFU DURAND,134,126,204,46,10,260,252,8,252,8,5,3,59,81,45,28,30,9,0,59,124,69,252
20210505,05MAY2021:00:00:00,UFU ELIZALDE,74,57,61,63,7,131,105,26,123,8,53,45,12,10,9,0,2,0,0,8,50,47,105
20210505,05MAY2021:00:00:00,UFU FERNANDEZ,93,97,144,30,16,190,176,14,176,14,0,6,45,57,32,25,13,12,0,45,16,115,176
20210505,05MAY2021:00:00:00,UFU FERRER,112,67,96,74,9,179,175,4,175,4,0,2,54,51,27,28,11,6,0,22,95,58,175
20210505,05MAY2021:00:00:00,UFU GRIERSON,97,112,116,47,46,209,189,20,191,18,0,4,61,49,40,35,11,9,0,51,67,70,189
20210505,05MAY2021:00:00:00,UFU GUTIERREZ,111,116,125,71,31,227,199,28,225,2,64,33,52,36,26,7,9,0,0,25,114,59,199
20210505,05MAY2021:00:00:00,UFU MUÑIZ,280,276,263,261,32,556,366,190,430,126,3,21,112,175,95,97,44,9,0,55,228,83,366
20210505,05MAY2021:00:00:00,UFU PENNA,77,65,126,16,0,142,114,28,140,2,0,0,45,20,33,30,10,4,0,21,61,32,114
20210505,05MAY2021:00:00:00,UFU PIROVANO,157,129,217,59,10,286,250,36,282,4,0,13,68,82,56,35,20,12,0,68,83,99,250
20210505,05MAY2021:00:00:00,UFU PIÑERO,166,122,191,82,15,288,280,8,282,6,0,11,80,68,69,25,17,18,0,39,167,70,280
20210505,05MAY2021:00:00:00,UFU RAMOS MEJIA,159,159,230,66,22,318,218,100,298,20,4,13,71,78,57,48,29,18,0,63,78,77,218
20210505,05MAY2021:00:00:00,UFU RIVADAVIA,145,109,176,65,13,254,154,100,164,90,0,8,65,69,52,35,18,7,0,34,64,53,154
20210505,05MAY2021:00:00:00,UFU SANTOJANNI,159,176,183,140,12,335,329,6,331,4,4,29,71,60,82,49,28,12,0,91,178,60,329
20210505,05MAY2021:00:00:00,UFU TORNU,145,133,171,93,14,278,246,32,264,14,15,17,51,70,44,49,20,12,0,51,125,70,246
20210505,05MAY2021:00:00:00,UFU VELEZ SARSFIELD,104,119,147,59,17,223,195,28,221,2,0,3,32,70,63,29,18,8,0,43,72,80,195
20210505,05MAY2021:00:00:00,UFU ZUBIZARRETA,150,120,145,112,13,270,270,0,270,0,0,11,75,67,54,22,17,24,0,45,147,78,270
20210506,06MAY2021:00:00:00,UFU ALVAREZ,197,131,230,93,5,328,316,12,320,8,15,15,67,74,51,67,30,9,0,51,172,93,316
20210506,06MAY2021:00:00:00,UFU ARGERICH,83,84,125,37,5,167,139,28,143,24,4,9,19,54,44,21,13,3,0,35,49,55,139
20210506,06MAY2021:00:00:00,UFU BORDA-MOYANO,32,40,49,23,0,72,64,8,64,8,0,10,8,15,13,22,4,0,0,7,34,23,64
20210506,06MAY2021:00:00:00,UFU DURAND,119,112,194,34,3,231,223,8,229,2,0,2,46,70,45,33,29,6,0,57,106,60,223
20210506,06MAY2021:00:00:00,UFU ELIZALDE,57,52,40,69,0,109,101,8,109,0,39,37,7,13,8,5,0,0,0,3,63,35,101
20210506,06MAY2021:00:00:00,UFU FERNANDEZ,118,73,139,37,15,191,149,42,177,14,0,2,38,55,38,35,20,3,0,28,57,64,149
20210506,06MAY2021:00:00:00,UFU FERRER,88,57,78,59,8,145,139,6,139,6,0,0,24,50,42,17,9,3,0,29,69,41,139
20210506,06MAY2021:00:00:00,UFU GRIERSON,110,115,90,113,22,225,219,6,219,6,0,7,59,49,45,41,15,9,0,54,89,75,219
20210506,06MAY2021:00:00:00,UFU GUTIERREZ,134,111,194,38,13,245,225,20,243,2,41,34,39,54,36,17,20,4,0,24,134,65,225
20210506,06MAY2021:00:00:00,UFU MUÑIZ,246,294,199,313,28,540,384,156,402,138,0,2,125,159,123,80,37,14,0,83,203,98,384
20210506,06MAY2021:00:00:00,UFU PENNA,87,63,115,28,7,150,124,26,142,8,0,1,30,45,19,27,21,7,0,21,69,34,124
20210506,06MAY2021:00:00:00,UFU PIROVANO,164,153,244,58,15,317,267,50,317,0,0,13,92,77,68,28,26,13,0,60,92,115,267
20210506,06MAY2021:00:00:00,UFU PIÑERO,143,151,203,79,12,294,281,13,283,11,2,16,57,96,58,44,12,9,0,49,147,79,281
20210506,06MAY2021:00:00:00,UFU RAMOS MEJIA,186,187,242,95,36,373,309,64,373,0,7,7,80,78,76,73,32,20,0,69,94,145,309
20210506,06MAY2021:00:00:00,UFU RIVADAVIA,148,98,169,57,20,246,204,42,208,38,0,7,85,81,28,21,21,3,0,35,78,89,204
20210506,06MAY2021:00:00:00,UFU SANTOJANNI,157,159,174,133,9,316,304,12,314,2,5,14,55,88,65,53,30,6,0,83,151,70,304
20210506,06MAY2021:00:00:00,UFU TORNU,104,105,163,44,2,209,205,4,205,4,3,11,48,56,54,22,11,4,0,33,99,65,205
20210506,06MAY2021:00:00:00,UFU VELEZ SARSFIELD,141,132,180,80,13,273,261,12,273,0,0,14,65,71,61,40,14,8,0,46,133,82,261
20210506,06MAY2021:00:00:00,UFU ZUBIZARRETA,112,110,110,74,38,222,220,2,222,0,0,10,52,45,51,37,17,10,0,24,131,65,220
20210507,07MAY2021:00:00:00,UFU ALVAREZ,157,163,232,77,11,320,256,64,264,56,17,23,80,67,58,30,27,18,0,39,113,104,256
20210507,07MAY2021:00:00:00,UFU ARGERICH,109,75,105,65,14,184,162,22,164,20,0,14,44,35,43,11,31,6,0,45,50,67,162
20210507,07MAY2021:00:00:00,UFU BORDA-MOYANO,46,41,46,40,1,87,77,10,77,10,4,2,14,20,22,11,10,4,0,10,39,28,77
20210507,07MAY2021:00:00:00,UFU DURAND,133,127,205,50,5,260,248,12,250,10,0,15,61,58,51,33,27,15,0,49,137,62,248
20210507,07MAY2021:00:00:00,UFU ELIZALDE,48,44,43,49,0,92,82,10,90,2,32,36,5,9,6,0,4,0,0,9,39,34,82
20210507,07MAY2021:00:00:00,UFU FERNANDEZ,96,80,138,25,13,176,164,12,166,10,0,7,43,48,27,29,14,8,0,28,74,62,164
20210507,07MAY2021:00:00:00,UFU FERRER,95,79,83,80,11,174,170,4,172,2,0,0,59,40,28,31,13,3,0,36,83,51,170
20210507,07MAY2021:00:00:00,UFU GRIERSON,138,108,115,117,14,246,216,30,240,6,0,4,78,60,61,18,11,14,0,60,83,73,216
20210507,07MAY2021:00:00:00,UFU GUTIERREZ,138,98,197,27,12,236,215,21,235,1,31,42,44,45,27,35,9,3,0,40,103,71,215
20210507,07MAY2021:00:00:00,UFU MUÑIZ,279,265,233,298,13,544,352,192,438,106,0,10,123,130,132,94,34,21,0,55,204,92,352
20210507,07MAY2021:00:00:00,UFU PENNA,78,55,117,14,2,133,113,20,129,4,0,0,36,37,14,22,18,6,0,24,59,30,113
20210507,07MAY2021:00:00:00,UFU PIROVANO,157,134,233,39,19,291,261,30,287,4,0,8,58,96,41,51,16,21,0,53,94,113,261
20210507,07MAY2021:00:00:00,UFU PIÑERO,138,133,201,56,14,271,259,12,259,12,0,10,55,70,70,45,15,6,0,43,147,69,259
20210507,07MAY2021:00:00:00,UFU RAMOS MEJIA,176,187,260,80,23,363,305,58,355,8,4,13,69,86,84,50,46,11,0,51,118,136,305
20210507,07MAY2021:00:00:00,UFU RIVADAVIA,109,89,135,48,15,198,180,18,190,8,0,10,55,51,48,11,19,4,0,41,63,73,180
20210507,07MAY2021:00:00:00,UFU SANTOJANNI,189,171,234,113,13,360,352,8,358,2,5,30,91,92,58,57,25,2,0,124,142,86,352
20210507,07MAY2021:00:00:00,UFU TORNU,155,131,206,61,19,286,264,22,268,18,6,12,43,59,74,42,28,22,0,34,145,85,264
20210507,07MAY2021:00:00:00,UFU VELEZ SARSFIELD,138,129,174,84,9,267,267,0,267,0,0,7,58,68,48,48,20,18,0,53,129,85,267
20210507,07MAY2021:00:00:00,UFU ZUBIZARRETA,142,133,142,111,22,275,269,6,275,0,0,16,61,61,65,34,31,7,0,40,158,71,269
20210508,08MAY2021:00:00:00,UFU ALVAREZ,173,112,204,71,10,285,261,24,263,22,2,7,65,81,64,37,16,13,0,62,115,84,261
20210508,08MAY2021:00:00:00,UFU ARGERICH,28,25,29,22,2,53,51,2,53,0,0,3,12,9,14,7,6,2,0,18,11,22,51
20210508,08MAY2021:00:00:00,UFU BORDA-MOYANO,17,12,15,14,0,29,29,0,29,0,2,1,9,9,2,3,2,1,0,9,9,11,29
20210508,08MAY2021:00:00:00,UFU DURAND,127,113,221,19,0,240,228,12,228,12,0,4,36,77,65,38,13,7,0,42,121,65,228
20210508,08MAY2021:00:00:00,UFU ELIZALDE,45,57,53,47,2,102,78,24,98,4,40,44,5,4,7,1,1,0,0,7,42,29,78
20210508,08MAY2021:00:00:00,UFU FERNANDEZ,149,136,208,52,25,285,123,162,283,2,0,6,69,74,48,54,23,11,0,36,33,54,123
20210508,08MAY2021:00:00:00,UFU FERRER,73,77,108,40,2,150,148,2,148,2,0,2,47,40,26,18,17,0,0,31,75,42,148
20210508,08MAY2021:00:00:00,UFU GRIERSON,106,96,85,111,6,202,188,14,188,14,0,10,45,57,42,24,22,2,0,44,79,65,188
20210508,08MAY2021:00:00:00,UFU GUTIERREZ,115,119,146,68,20,234,220,14,228,6,53,26,45,39,50,13,6,2,0,27,121,72,220
20210508,08MAY2021:00:00:00,UFU MUÑIZ,202,202,138,237,29,404,264,140,346,58,0,13,109,93,87,53,29,20,0,59,145,60,264
20210508,08MAY2021:00:00:00,UFU PENNA,43,44,67,18,2,87,63,24,81,6,0,4,24,21,15,12,7,4,0,7,36,20,63
20210508,08MAY2021:00:00:00,UFU PIROVANO,91,101,144,32,16,192,172,20,192,0,0,6,40,59,34,22,25,6,0,31,60,81,172
20210508,08MAY2021:00:00:00,UFU PIÑERO,95,123,144,64,10,218,214,4,214,4,0,4,83,51,34,26,7,13,0,40,113,59,214
20210508,08MAY2021:00:00:00,UFU RAMOS MEJIA,126,105,170,36,25,231,203,28,223,8,6,11,55,66,36,36,15,6,0,57,71,75,203
20210508,08MAY2021:00:00:00,UFU RIVADAVIA,95,59,113,30,11,154,148,6,148,6,0,2,38,46,28,21,8,11,0,33,55,60,148
20210508,08MAY2021:00:00:00,UFU SANTOJANNI,146,148,167,117,10,294,262,32,284,10,0,9,86,85,45,36,25,8,0,91,111,60,262
20210508,08MAY2021:00:00:00,UFU TORNU,79,84,88,41,34,163,151,12,151,12,6,1,34,37,41,27,15,2,0,25,78,48,151
20210508,08MAY2021:00:00:00,UFU VELEZ SARSFIELD,116,80,129,58,9,196,190,6,196,0,0,4,43,47,38,39,22,3,0,20,103,67,190
20210508,08MAY2021:00:00:00,UFU ZUBIZARRETA,125,101,129,80,17,226,216,10,226,0,0,6,33,81,37,34,27,8,0,24,138,54,216
20210509,09MAY2021:00:00:00,UFU ALVAREZ,140,132,214,49,9,272,258,14,258,14,11,33,36,65,52,36,30,9,0,45,135,78,258
20210509,09MAY2021:00:00:00,UFU ARGERICH,26,33,37,17,5,59,51,8,59,0,0,0,5,13,18,6,7,10,0,11,16,23,51
20210509,09MAY2021:00:00:00,UFU BORDA-MOYANO,38,16,28,26,0,54,54,0,54,0,0,0,11,19,16,2,4,2,0,10,23,21,54
20210509,09MAY2021:00:00:00,UFU DURAND,177,113,266,16,8,290,290,0,290,0,15,11,46,97,60,28,24,9,0,63,144,83,290
20210509,09MAY2021:00:00:00,UFU ELIZALDE,64,54,43,71,4,118,90,28,114,4,50,36,4,17,9,2,0,0,0,8,48,34,90
20210509,09MAY2021:00:00:00,UFU FERNANDEZ,125,92,172,33,12,217,137,80,207,10,2,11,51,53,34,37,24,5,0,34,49,54,137
20210509,09MAY2021:00:00:00,UFU FERRER,54,79,83,50,0,133,131,2,131,2,0,3,21,38,36,19,13,3,0,37,54,40,131
20210509,09MAY2021:00:00:00,UFU GRIERSON,91,90,93,48,40,181,167,14,171,10,4,15,38,28,44,24,23,5,0,50,57,59,167
20210509,09MAY2021:00:00:00,UFU GUTIERREZ,80,84,133,23,8,164,160,4,162,2,24,29,22,39,28,14,8,0,0,22,88,48,160
20210509,09MAY2021:00:00:00,UFU MUÑIZ,182,161,120,209,14,343,277,66,293,50,0,19,58,91,92,48,32,3,0,41,153,83,277
20210509,09MAY2021:00:00:00,UFU PENNA,39,24,61,2,0,63,59,4,61,2,0,0,15,11,13,10,12,2,0,11,29,19,59
20210509,09MAY2021:00:00:00,UFU PIROVANO,82,79,128,22,11,161,153,8,159,2,0,7,30,54,43,19,4,4,0,48,45,60,153
20210509,09MAY2021:00:00:00,UFU PIÑERO,83,75,113,39,6,158,152,6,154,4,0,7,22,37,34,47,10,1,0,34,73,44,152
20210509,09MAY2021:00:00:00,UFU RAMOS MEJIA,111,118,168,37,24,229,185,44,213,16,5,19,52,50,46,29,18,10,0,62,54,69,185
20210509,09MAY2021:00:00:00,UFU RIVADAVIA,89,66,114,34,7,155,147,8,151,4,0,10,43,46,22,15,11,8,0,42,40,62,147
20210509,09MAY2021:00:00:00,UFU SANTOJANNI,191,155,206,128,12,346,332,14,338,8,0,18,74,77,85,55,26,11,0,99,148,85,332
20210509,09MAY2021:00:00:00,UFU TORNU,54,59,80,28,5,113,107,6,107,6,3,2,23,37,10,24,12,2,0,21,52,34,107
20210509,09MAY2021:00:00:00,UFU VELEZ SARSFIELD,73,78,113,36,2,151,149,2,149,2,0,5,21,36,40,39,9,1,0,33,69,47,149
20210509,09MAY2021:00:00:00,UFU ZUBIZARRETA,89,76,109,48,8,165,163,2,165,0,0,8,45,27,27,39,14,5,0,29,89,45,163
20210510,10MAY2021:00:00:00,UFU ALVAREZ,311,245,378,156,22,556,406,150,406,150,23,39,141,160,89,76,20,8,0,78,207,120,406
20210510,10MAY2021:00:00:00,UFU ARGERICH,87,102,94,84,11,189,159,30,161,28,4,2,23,66,42,18,27,7,0,42,52,64,159
20210510,10MAY2021:00:00:00,UFU BORDA-MOYANO,29,41,43,25,2,70,66,4,66,4,0,2,9,16,19,10,12,2,0,14,23,29,66
20210510,10MAY2021:00:00:00,UFU DURAND,155,135,234,49,7,290,284,6,284,6,0,3,49,85,56,62,27,8,0,64,147,73,284
20210510,10MAY2021:00:00:00,UFU ELIZALDE,115,68,65,113,5,183,155,28,181,2,76,66,9,19,11,2,0,0,0,6,85,64,155
20210510,10MAY2021:00:00:00,UFU FERNANDEZ,99,96,133,39,23,195,169,26,189,6,0,5,40,52,39,27,26,6,0,44,56,69,169
20210510,10MAY2021:00:00:00,UFU FERRER,156,116,143,114,15,272,260,12,260,12,0,3,70,85,53,37,24,0,0,46,136,78,260
20210510,10MAY2021:00:00:00,UFU GRIERSON,165,117,110,152,20,282,276,6,276,6,0,12,77,62,77,43,9,2,0,81,99,95,276
20210510,10MAY2021:00:00:00,UFU GUTIERREZ,148,148,218,56,22,296,282,14,296,0,53,46,56,71,42,11,13,4,0,36,157,88,282
20210510,10MAY2021:00:00:00,UFU MUÑIZ,303,369,265,385,22,672,478,194,534,138,0,17,187,179,141,78,50,20,0,108,241,129,478
20210510,10MAY2021:00:00:00,UFU PENNA,82,76,126,21,11,158,148,10,154,4,0,4,38,61,16,13,21,5,0,31,70,47,148
20210510,10MAY2021:00:00:00,UFU PIROVANO,167,152,244,53,22,319,307,12,317,2,0,8,83,79,70,45,23,11,0,66,110,131,307
20210510,10MAY2021:00:00:00,UFU PIÑERO,185,144,223,88,18,329,317,12,319,10,0,13,87,106,59,37,18,9,0,49,180,88,317
20210510,10MAY2021:00:00:00,UFU RAMOS MEJIA,185,205,280,90,20,390,318,72,372,18,16,35,68,81,84,67,32,7,0,73,110,134,318
20210510,10MAY2021:00:00:00,UFU RIVADAVIA,162,128,197,68,25,290,262,28,276,14,0,11,65,85,54,40,27,8,0,69,86,106,262
20210510,10MAY2021:00:00:00,UFU SANTOJANNI,200,189,220,141,28,389,367,22,387,2,7,17,73,63,122,41,48,18,0,111,163,93,367
20210510,10MAY2021:00:00:00,UFU TORNU,151,143,189,80,25,294,260,34,284,10,6,20,50,62,68,47,35,6,0,48,123,85,260
20210510,10MAY2021:00:00:00,UFU VELEZ SARSFIELD,149,137,191,85,10,286,282,4,284,2,0,12,62,61,69,47,18,17,0,70,97,115,282
20210510,10MAY2021:00:00:00,UFU ZUBIZARRETA,183,186,208,128,33,369,369,0,369,0,0,18,94,87,75,39,48,8,0,64,195,110,369
20210511,11MAY2021:00:00:00,UFU ALVAREZ,158,183,256,81,4,341,323,18,329,12,18,16,94,71,54,47,24,17,0,82,151,90,323
20210511,11MAY2021:00:00:00,UFU ARGERICH,106,72,102,71,5,178,144,34,148,30,7,16,36,33,38,26,14,8,0,43,35,66,144
20210511,11MAY2021:00:00:00,UFU BORDA-MOYANO,26,27,16,32,5,53,53,0,53,0,1,3,13,12,12,6,5,1,0,12,26,15,53
20210511,11MAY2021:00:00:00,UFU DURAND,109,115,208,16,0,224,214,10,214,10,4,11,57,58,40,35,9,10,0,66,84,64,214
20210511,11MAY2021:00:00:00,UFU ELIZALDE,85,67,52,98,2,152,116,36,142,10,66,47,10,17,2,8,2,0,0,8,65,43,116
20210511,11MAY2021:00:00:00,UFU FERNANDEZ,135,151,218,48,20,286,156,130,276,10,0,2,78,88,53,29,27,9,0,38,50,68,156
20210511,11MAY2021:00:00:00,UFU FERRER,109,84,102,85,6,193,181,12,181,12,0,4,49,58,46,27,6,3,0,43,81,57,181
20210511,11MAY2021:00:00:00,UFU GRIERSON,120,117,125,86,26,237,229,8,231,6,0,20,67,60,36,30,19,5,0,56,87,86,229
20210511,11MAY2021:00:00:00,UFU GUTIERREZ,134,120,188,57,9,254,236,18,254,0,37,41,47,58,37,22,9,3,0,28,143,64,236
20210511,11MAY2021:00:00:00,UFU MUÑIZ,212,312,199,295,30,524,382,142,400,124,2,11,130,142,112,73,42,12,0,65,199,118,382
20210511,11MAY2021:00:00:00,UFU PENNA,61,60,95,21,5,121,105,16,117,4,0,2,26,34,36,9,10,4,0,16,62,27,105
20210511,11MAY2021:00:00:00,UFU PIROVANO,155,141,228,52,16,296,244,52,290,6,0,12,61,68,57,45,24,29,0,74,77,93,244
20210511,11MAY2021:00:00:00,UFU PIÑERO,116,106,164,40,18,222,220,2,220,2,6,6,43,75,29,44,14,5,0,64,87,68,220
20210511,11MAY2021:00:00:00,UFU RAMOS MEJIA,148,145,236,36,21,293,239,54,293,0,9,17,45,77,75,43,19,8,0,64,76,98,239
20210511,11MAY2021:00:00:00,UFU RIVADAVIA,138,115,176,60,17,253,239,14,243,10,0,6,77,60,46,34,17,13,0,50,92,95,239
20210511,11MAY2021:00:00:00,UFU SANTOJANNI,160,141,155,128,18,301,279,22,295,6,0,21,62,75,72,48,16,7,0,63,141,75,279
20210511,11MAY2021:00:00:00,UFU TORNU,131,135,190,65,11,266,230,36,238,28,13,23,64,60,48,29,7,22,0,39,109,77,230
20210511,11MAY2021:00:00:00,UFU VELEZ SARSFIELD,156,109,165,83,17,265,263,2,265,0,0,23,64,61,61,38,15,3,0,63,123,77,263
20210511,11MAY2021:00:00:00,UFU ZUBIZARRETA,98,106,104,80,20,204,204,0,204,0,0,6,31,54,56,31,15,11,0,28,109,67,204
20210512,12MAY2021:00:00:00,UFU ALVAREZ,236,178,289,103,22,414,360,54,366,48,14,29,106,108,87,38,19,13,0,62,191,107,360
20210512,12MAY2021:00:00:00,UFU ARGERICH,98,88,108,74,4,186,166,20,170,16,2,12,41,36,41,30,12,12,0,50,49,66,166
20210512,12MAY2021:00:00:00,UFU BORDA-MOYANO,32,40,47,23,2,72,50,22,50,22,0,0,15,13,24,8,8,4,0,5,28,17,50
20210512,12MAY2021:00:00:00,UFU DURAND,147,116,213,41,9,263,257,6,259,4,8,24,38,86,46,37,17,7,0,54,137,66,257
20210512,12MAY2021:00:00:00,UFU ELIZALDE,64,46,41,67,2,110,92,18,100,10,27,51,6,19,4,1,2,0,0,8,50,34,92
20210512,12MAY2021:00:00:00,UFU FERNANDEZ,141,87,185,32,11,228,162,66,214,14,0,5,51,80,43,36,9,4,0,34,63,65,162
20210512,12MAY2021:00:00:00,UFU FERRER,67,78,72,71,2,145,141,4,141,4,0,3,24,54,11,46,7,0,0,31,71,39,141
20210512,12MAY2021:00:00:00,UFU GRIERSON,89,141,91,124,15,230,220,10,222,8,0,4,43,78,51,29,21,4,0,59,76,85,220
20210512,12MAY2021:00:00:00,UFU GUTIERREZ,125,109,140,73,21,234,220,14,232,2,49,32,63,39,39,10,2,0,0,33,113,74,220
20210512,12MAY2021:00:00:00,UFU MUÑIZ,238,297,195,304,36,535,341,194,425,110,2,9,139,141,104,78,45,17,0,76,167,98,341
20210512,12MAY2021:00:00:00,UFU PENNA,80,89,137,25,7,169,149,20,161,8,0,7,46,55,24,19,10,8,0,30,76,43,149
20210512,12MAY2021:00:00:00,UFU PIROVANO,164,117,206,58,17,281,237,44,277,4,0,11,57,91,54,42,13,13,0,52,90,94,237
20210512,12MAY2021:00:00:00,UFU PIÑERO,142,104,164,59,23,246,236,10,242,4,0,10,71,70,57,21,10,7,0,45,117,69,236
20210512,12MAY2021:00:00:00,UFU RAMOS MEJIA,201,164,271,71,23,365,281,84,327,38,18,10,65,90,94,44,40,4,0,68,97,116,281
20210512,12MAY2021:00:00:00,UFU RIVADAVIA,156,123,212,43,24,279,181,98,191,88,0,2,82,84,43,35,23,10,0,40,69,72,181
20210512,12MAY2021:00:00:00,UFU SANTOJANNI,168,190,173,163,22,358,344,14,356,2,10,22,65,103,68,50,24,16,0,62,182,100,344
20210512,12MAY2021:00:00:00,UFU TORNU,108,132,167,58,15,240,206,34,212,28,11,21,46,80,38,23,17,4,0,38,95,73,206
20210512,12MAY2021:00:00:00,UFU VELEZ SARSFIELD,131,101,169,59,4,232,224,8,230,2,0,8,51,61,55,25,20,12,0,48,102,74,224
20210512,12MAY2021:00:00:00,UFU ZUBIZARRETA,119,95,116,78,20,214,214,0,214,0,0,6,43,60,46,30,17,12,0,35,100,79,214
20210513,13MAY2021:00:00:00,UFU ALVAREZ,185,150,267,62,6,335,325,10,325,10,15,29,84,82,48,25,45,7,0,56,173,96,325
20210513,13MAY2021:00:00:00,UFU ARGERICH,115,70,94,84,7,185,163,22,169,16,2,10,34,46,40,27,18,8,0,45,39,79,163
20210513,13MAY2021:00:00:00,UFU BORDA-MOYANO,68,32,68,32,0,100,92,8,92,8,0,1,19,34,18,24,2,2,0,13,53,26,92
20210513,13MAY2021:00:00:00,UFU DURAND,161,124,216,48,21,285,269,16,271,14,10,12,59,74,64,41,15,10,0,73,120,75,269
20210513,13MAY2021:00:00:00,UFU ELIZALDE,61,43,32,72,0,104,88,16,98,6,56,27,5,11,4,1,0,0,0,13,44,31,88
20210513,13MAY2021:00:00:00,UFU FERNANDEZ,146,74,150,37,33,220,176,44,200,20,1,13,48,51,41,37,17,12,0,38,64,74,176
20210513,13MAY2021:00:00:00,UFU FERRER,94,75,85,80,4,169,167,2,167,2,0,0,43,53,37,19,13,4,0,37,89,41,167
20210513,13MAY2021:00:00:00,UFU GRIERSON,128,156,123,134,27,284,280,4,280,4,1,4,81,65,76,31,17,9,0,73,102,105,280
20210513,13MAY2021:00:00:00,UFU GUTIERREZ,135,112,191,28,28,247,237,10,243,4,40,32,53,59,34,24,3,2,0,42,114,80,237
20210513,13MAY2021:00:00:00,UFU MUÑIZ,208,254,193,248,21,462,318,144,342,120,0,12,86,147,90,67,52,8,0,52,201,65,318
20210513,13MAY2021:00:00:00,UFU PENNA,96,75,128,32,11,171,133,38,159,12,0,1,48,46,31,26,13,6,0,24,68,41,133
20210513,13MAY2021:00:00:00,UFU PIROVANO,186,130,230,46,40,316,268,48,314,2,0,9,69,71,64,43,38,22,0,72,88,108,268
20210513,13MAY2021:00:00:00,UFU PIÑERO,165,120,184,84,17,285,271,14,279,6,0,22,69,53,40,65,24,12,0,45,156,69,271
20210513,13MAY2021:00:00:00,UFU RAMOS MEJIA,174,161,242,64,29,335,273,62,321,14,9,17,94,86,57,42,17,13,0,66,98,107,273
20210513,13MAY2021:00:00:00,UFU RIVADAVIA,157,130,194,64,29,287,223,64,233,54,0,5,89,64,57,43,25,4,0,46,90,86,223
20210513,13MAY2021:00:00:00,UFU SANTOJANNI,148,125,154,103,16,273,257,16,271,2,0,13,59,57,48,47,45,4,0,57,143,57,257
20210513,13MAY2021:00:00:00,UFU TORNU,113,120,166,46,21,233,215,18,219,14,12,12,42,51,56,34,17,9,0,28,124,63,215
20210513,13MAY2021:00:00:00,UFU VELEZ SARSFIELD,171,162,221,81,31,333,277,56,333,0,0,4,65,80,63,55,40,26,0,44,151,82,277
20210513,13MAY2021:00:00:00,UFU ZUBIZARRETA,156,90,123,102,21,246,246,0,246,0,0,19,44,47,57,48,25,6,0,28,138,80,246
20210514,14MAY2021:00:00:00,UFU ALVAREZ,185,176,291,64,6,361,293,68,295,66,16,30,90,81,63,40,33,8,0,68,131,94,293
20210514,14MAY2021:00:00:00,UFU ARGERICH,119,74,100,85,8,193,175,18,175,18,8,7,42,45,41,28,16,6,0,37,2,136,175
20210514,14MAY2021:00:00:00,UFU BORDA-MOYANO,37,39,39,37,0,76,52,24,52,24,0,0,12,27,12,10,7,8,0,0,31,21,52
20210514,14MAY2021:00:00:00,UFU DURAND,189,92,219,54,8,281,273,8,273,8,0,13,68,88,51,31,26,4,0,58,136,79,273
20210514,14MAY2021:00:00:00,UFU ELIZALDE,66,51,48,66,3,117,103,14,113,4,39,40,9,15,7,7,0,0,0,8,54,41,103
20210514,14MAY2021:00:00:00,UFU FERNANDEZ,112,96,147,35,26,208,194,14,202,6,0,9,46,53,30,45,21,4,0,33,81,80,194
20210514,14MAY2021:00:00:00,UFU FERRER,86,108,98,90,6,194,187,7,187,7,0,0,48,71,38,24,11,2,0,43,88,56,187
20210514,14MAY2021:00:00:00,UFU GRIERSON,148,145,146,115,32,293,265,28,283,10,1,16,54,84,66,44,25,3,0,78,91,96,265
20210514,14MAY2021:00:00:00,UFU GUTIERREZ,185,123,228,53,27,308,294,14,306,2,37,17,66,72,46,40,30,0,0,50,151,92,294
20210514,14MAY2021:00:00:00,UFU MUÑIZ,252,252,207,271,26,504,330,174,404,100,2,7,139,120,78,93,49,16,0,53,187,90,330
20210514,14MAY2021:00:00:00,UFU PENNA,94,47,124,16,1,141,125,16,137,4,0,4,29,40,42,14,10,2,0,32,56,37,125
20210514,14MAY2021:00:00:00,UFU PIROVANO,185,134,232,62,25,319,293,26,309,10,0,4,71,111,53,41,25,14,0,85,92,116,293
20210514,14MAY2021:00:00:00,UFU PIÑERO,162,124,205,74,7,286,260,26,282,4,0,20,67,68,51,51,23,6,0,63,121,73,260
20210514,14MAY2021:00:00:00,UFU RAMOS MEJIA,169,151,225,67,28,320,286,34,304,16,10,30,60,73,75,48,16,8,0,53,111,119,286
20210514,14MAY2021:00:00:00,UFU RIVADAVIA,193,114,217,72,18,307,283,24,289,18,0,8,72,96,57,48,18,8,0,67,96,118,283
20210514,14MAY2021:00:00:00,UFU SANTOJANNI,181,157,167,163,8,338,326,12,336,2,3,23,59,94,52,46,34,27,0,68,162,96,326
20210514,14MAY2021:00:00:00,UFU TORNU,174,113,192,76,19,287,273,14,277,10,17,10,64,62,56,46,20,12,0,32,123,116,273
20210514,14MAY2021:00:00:00,UFU VELEZ SARSFIELD,144,160,192,90,22,304,300,4,302,2,0,6,91,65,60,45,28,9,0,71,133,96,300
20210514,14MAY2021:00:00:00,UFU ZUBIZARRETA,201,150,208,110,33,351,351,0,351,0,0,12,55,92,74,59,36,23,0,45,209,97,351
20210515,15MAY2021:00:00:00,UFU ALVAREZ,194,153,263,67,17,347,315,32,317,30,13,16,107,71,55,48,9,28,0,89,120,106,315
20210515,15MAY2021:00:00:00,UFU ARGERICH,28,19,33,13,1,47,47,0,47,0,3,1,9,17,4,5,4,4,0,14,14,19,47
20210515,15MAY2021:00:00:00,UFU BORDA-MOYANO,22,19,18,23,0,41,35,6,35,6,0,5,9,10,12,3,0,2,0,6,15,14,35
20210515,15MAY2021:00:00:00,UFU DURAND,109,66,145,24,6,175,173,2,173,2,0,8,48,50,30,18,17,4,0,38,86,49,173
20210515,15MAY2021:00:00:00,UFU ELIZALDE,53,48,21,69,11,101,75,26,87,14,57,21,6,10,3,4,0,0,0,6,41,28,75
20210515,15MAY2021:00:00:00,UFU FERNANDEZ,76,91,140,20,7,167,135,32,161,6,0,9,39,50,34,15,10,10,0,38,45,52,135
20210515,15MAY2021:00:00:00,UFU FERRER,80,77,59,88,10,157,155,2,155,2,0,0,41,54,34,19,5,4,0,50,54,51,155
20210515,15MAY2021:00:00:00,UFU GRIERSON,104,124,104,74,50,228,216,12,216,12,0,17,54,48,57,31,19,2,0,52,82,82,216
20210515,15MAY2021:00:00:00,UFU GUTIERREZ,121,104,158,52,15,225,217,8,221,4,37,33,47,40,40,19,9,0,0,44,96,75,217
20210515,15MAY2021:00:00:00,UFU MUÑIZ,214,176,176,190,24,390,252,138,318,72,0,10,95,102,88,62,29,4,0,45,139,68,252
20210515,15MAY2021:00:00:00,UFU PENNA,62,33,89,6,0,95,81,14,91,4,0,1,24,19,25,19,5,2,0,20,35,26,81
20210515,15MAY2021:00:00:00,UFU PIROVANO,135,112,182,53,12,247,209,38,241,6,0,4,55,70,60,32,17,9,0,50,71,88,209
20210515,15MAY2021:00:00:00,UFU PIÑERO,131,71,114,73,15,202,202,0,202,0,0,8,53,58,40,33,6,4,0,46,94,61,202
20210515,15MAY2021:00:00:00,UFU RAMOS MEJIA,186,197,261,92,30,383,227,156,301,82,8,17,85,91,84,61,35,2,0,30,104,93,227
20210515,15MAY2021:00:00:00,UFU RIVADAVIA,137,79,147,41,28,216,210,6,210,6,0,1,84,51,27,23,14,16,0,53,67,89,210
20210515,15MAY2021:00:00:00,UFU SANTOJANNI,210,167,192,163,22,377,359,18,375,2,0,12,74,80,87,75,26,23,0,83,171,105,359
20210515,15MAY2021:00:00:00,UFU TORNU,94,88,109,54,19,182,158,24,158,24,10,20,33,28,31,38,12,10,0,31,84,43,158
20210515,15MAY2021:00:00:00,UFU VELEZ SARSFIELD,154,143,212,74,11,297,287,10,289,8,2,4,69,65,82,55,9,11,0,47,152,88,287
20210515,15MAY2021:00:00:00,UFU ZUBIZARRETA,89,75,113,46,5,164,160,4,164,0,0,5,47,30,37,19,10,16,0,26,87,47,160
20210516,16MAY2021:00:00:00,UFU ALVAREZ,172,131,238,48,17,303,287,16,287,16,9,13,63,78,52,41,29,18,0,75,122,90,287
20210516,16MAY2021:00:00:00,UFU ARGERICH,37,50,50,37,0,87,87,0,87,0,0,2,11,19,19,16,9,11,0,27,20,40,87
20210516,16MAY2021:00:00:00,UFU BORDA-MOYANO,25,22,18,29,0,47,45,2,45,2,0,2,6,12,17,5,3,2,0,7,21,17,45
20210516,16MAY2021:00:00:00,UFU DURAND,88,93,143,29,9,181,171,10,171,10,2,4,42,46,35,18,26,8,0,51,71,48,171
20210516,16MAY2021:00:00:00,UFU ELIZALDE,85,51,47,86,3,136,122,14,132,4,35,53,9,25,14,0,0,0,0,21,59,42,122
20210516,16MAY2021:00:00:00,UFU FERNANDEZ,59,79,108,23,7,138,112,26,122,16,0,8,31,44,29,8,13,5,0,30,40,42,112
20210516,16MAY2021:00:00:00,UFU FERRER,50,44,50,37,7,94,94,0,94,0,0,0,11,34,18,15,11,5,0,30,38,26,94
20210516,16MAY2021:00:00:00,UFU GRIERSON,114,138,103,90,59,252,240,12,252,0,0,7,36,89,64,36,16,4,0,64,78,98,240
20210516,16MAY2021:00:00:00,UFU GUTIERREZ,143,99,187,36,19,242,220,22,232,10,40,31,48,60,43,18,2,0,0,43,105,72,220
20210516,16MAY2021:00:00:00,UFU MUÑIZ,190,175,154,173,38,365,265,100,289,76,0,6,76,88,81,71,32,11,0,45,150,70,265
20210516,16MAY2021:00:00:00,UFU PENNA,40,39,60,14,5,79,75,4,75,4,0,3,12,16,5,25,15,3,0,16,32,27,75
20210516,16MAY2021:00:00:00,UFU PIROVANO,108,65,145,23,5,173,153,20,171,2,3,6,42,44,46,16,8,8,0,43,46,64,153
20210516,16MAY2021:00:00:00,UFU PIÑERO,97,126,135,73,15,223,217,6,221,2,0,5,56,57,42,32,21,10,0,37,119,59,217
20210516,16MAY2021:00:00:00,UFU RAMOS MEJIA,147,155,221,52,29,302,256,46,270,32,2,9,60,82,59,49,25,16,0,78,82,96,256
20210516,16MAY2021:00:00:00,UFU RIVADAVIA,120,71,150,35,6,191,179,12,181,10,0,2,49,54,34,32,11,9,0,65,35,75,179
20210516,16MAY2021:00:00:00,UFU SANTOJANNI,228,145,185,160,28,373,343,30,361,12,9,6,78,108,72,36,36,28,0,66,181,95,343
20210516,16MAY2021:00:00:00,UFU TORNU,121,112,131,87,15,233,221,12,221,12,5,26,48,43,48,24,18,21,0,42,105,74,221
20210516,16MAY2021:00:00:00,UFU VELEZ SARSFIELD,125,94,143,64,12,219,213,6,215,4,0,6,44,56,50,34,19,10,0,40,111,62,213
20210516,16MAY2021:00:00:00,UFU ZUBIZARRETA,77,75,94,48,10,152,146,6,152,0,0,5,26,37,35,22,18,9,0,23,76,47,146
20210517,17MAY2021:00:00:00,UFU ALVAREZ,220,217,289,134,14,437,336,101,338,99,24,28,107,103,104,48,18,5,0,72,154,110,336
20210517,17MAY2021:00:00:00,UFU ARGERICH,104,103,121,84,2,207,189,18,191,16,4,5,44,47,46,41,15,5,0,52,55,80,189
20210517,17MAY2021:00:00:00,UFU BORDA-MOYANO,49,60,78,27,4,109,105,4,105,4,0,5,18,17,24,31,8,6,0,18,44,43,105
20210517,17MAY2021:00:00:00,UFU DURAND,163,142,260,32,13,305,299,6,299,6,2,6,75,100,65,36,16,5,0,69,153,77,299
20210517,17MAY2021:00:00:00,UFU ELIZALDE,152,107,103,152,4,259,219,40,249,10,103,70,23,23,22,15,3,0,0,11,115,93,219
20210517,17MAY2021:00:00:00,UFU FERNANDEZ,96,90,137,34,15,186,174,12,176,10,1,8,38,56,41,20,9,13,0,33,67,74,174
20210517,17MAY2021:00:00:00,UFU FERRER,115,151,121,140,5,266,258,8,260,6,0,4,85,45,65,53,9,5,0,62,118,78,258
20210517,17MAY2021:00:00:00,UFU GRIERSON,182,141,156,124,43,323,311,12,313,10,0,18,82,94,72,36,18,3,0,77,112,122,311
20210517,17MAY2021:00:00:00,UFU GUTIERREZ,184,157,269,54,18,341,327,14,341,0,67,65,80,81,19,17,12,0,0,65,160,102,327
20210517,17MAY2021:00:00:00,UFU MUÑIZ,241,307,242,266,40,548,424,124,458,90,3,8,139,125,124,84,44,21,0,76,243,105,424
20210517,17MAY2021:00:00:00,UFU PENNA,113,108,182,29,10,221,193,28,219,2,6,11,57,68,34,23,16,6,0,51,85,57,193
20210517,17MAY2021:00:00:00,UFU PIROVANO,222,197,293,98,28,419,389,30,411,8,0,10,89,100,100,85,24,11,0,107,128,154,389
20210517,17MAY2021:00:00:00,UFU PIÑERO,202,193,273,107,15,395,359,36,379,16,0,10,125,108,77,51,12,12,0,67,197,95,359
20210517,17MAY2021:00:00:00,UFU RAMOS MEJIA,240,206,302,116,28,446,378,68,430,16,9,22,85,119,74,92,38,7,0,56,150,172,378
20210517,17MAY2021:00:00:00,UFU RIVADAVIA,228,148,277,62,37,376,350,26,356,20,0,15,92,85,87,55,32,10,0,69,137,142,350
20210517,17MAY2021:00:00:00,UFU SANTOJANNI,257,192,255,190,4,449,433,16,439,10,7,38,91,118,82,67,31,15,0,92,216,125,433
20210517,17MAY2021:00:00:00,UFU TORNU,189,171,261,89,10,360,322,38,322,38,10,44,62,96,73,26,38,11,0,64,146,112,322
20210517,17MAY2021:00:00:00,UFU VELEZ SARSFIELD,187,173,220,128,12,360,338,22,356,4,0,16,71,85,76,48,35,29,0,76,158,104,338
20210517,17MAY2021:00:00:00,UFU ZUBIZARRETA,146,109,154,82,19,255,231,24,255,0,0,9,55,56,61,36,27,11,0,34,127,70,231
20210518,18MAY2021:00:00:00,UFU ALVAREZ,263,225,346,126,16,488,472,16,472,16,19,16,137,121,93,53,35,14,0,98,239,135,472
20210518,18MAY2021:00:00:00,UFU ARGERICH,100,88,108,76,4,188,168,20,174,14,8,2,50,52,34,17,15,10,0,50,47,70,168
20210518,18MAY2021:00:00:00,UFU BORDA-MOYANO,60,49,43,66,0,109,95,14,95,14,2,14,11,28,30,10,9,5,0,11,57,27,95
20210518,18MAY2021:00:00:00,UFU DURAND,176,161,281,56,0,337,315,22,321,16,1,15,72,118,68,31,27,5,0,77,151,87,315
20210518,18MAY2021:00:00:00,UFU ELIZALDE,89,85,69,97,8,174,128,46,162,12,70,70,5,10,13,6,0,0,0,12,64,52,128
20210518,18MAY2021:00:00:00,UFU FERNANDEZ,154,127,200,56,25,281,198,83,250,31,0,13,48,91,49,33,23,24,0,50,70,78,198
20210518,18MAY2021:00:00:00,UFU FERRER,105,71,77,96,3,176,174,2,174,2,0,0,35,57,39,30,14,1,0,51,66,57,174
20210518,18MAY2021:00:00:00,UFU GRIERSON,179,183,165,144,53,362,328,34,342,20,0,15,112,99,52,58,21,5,0,71,133,123,328
20210518,18MAY2021:00:00:00,UFU GUTIERREZ,192,136,216,88,24,328,310,18,326,2,64,26,68,86,50,26,8,0,0,39,168,103,310
20210518,18MAY2021:00:00:00,UFU MUÑIZ,259,332,238,331,22,591,449,142,475,116,0,15,149,167,125,96,31,8,0,102,218,123,449
20210607,07JUN2021:00:00:00,UFU SANTOJANNI,178,143,116,181,24,321,313,8,319,2,11,10,63,91,71,53,18,4,0,54,176,83,313
20210607,07JUN2021:00:00:00,UFU TORNU,141,128,205,48,16,269,243,26,245,24,23,3,55,59,66,35,16,12,0,48,120,74,243
20210607,07JUN2021:00:00:00,UFU VELEZ SARSFIELD,152,132,172,99,13,284,274,10,278,6,0,1,79,80,55,41,20,8,0,55,136,83,274
20210607,07JUN2021:00:00:00,UFU ZUBIZARRETA,133,124,137,108,12,257,253,4,257,0,0,10,47,65,68,37,26,4,0,39,141,73,253
20210608,08JUN2021:00:00:00,UFU ALVAREZ,223,152,261,80,34,375,347,28,349,26,21,36,96,84,56,55,22,5,0,63,181,103,347
20210608,08JUN2021:00:00:00,UFU ARGERICH,83,76,93,56,10,159,137,22,153,6,3,5,36,40,36,22,10,7,0,33,44,60,137
20210608,08JUN2021:00:00:00,UFU BORDA-MOYANO,35,30,34,28,3,65,57,8,57,8,0,5,11,18,13,6,6,6,0,5,37,15,57
20210608,08JUN2021:00:00:00,UFU DURAND,180,125,248,39,18,305,293,12,295,10,10,13,56,100,42,55,23,6,0,51,162,80,293
20210608,08JUN2021:00:00:00,UFU ELIZALDE,106,66,72,97,3,172,152,20,166,6,57,58,17,29,8,1,0,2,0,9,92,51,152
20210608,08JUN2021:00:00:00,UFU FERNANDEZ,145,124,208,47,14,269,147,122,261,8,0,11,62,71,39,36,35,15,0,20,20,107,147
20210608,08JUN2021:00:00:00,UFU FERRER,117,95,112,94,6,212,208,4,208,4,0,4,50,70,46,28,12,2,0,36,115,57,208
20210608,08JUN2021:00:00:00,UFU GRIERSON,101,125,108,112,6,226,220,6,220,6,0,6,68,62,42,34,8,6,0,27,112,81,220
20210608,08JUN2021:00:00:00,UFU GUTIERREZ,177,108,199,73,13,285,273,12,283,2,65,34,83,57,18,25,3,0,0,22,163,88,273
20210608,08JUN2021:00:00:00,UFU MUÑIZ,195,186,145,204,32,381,313,68,337,44,2,2,87,111,89,50,31,9,0,39,184,90,313
20210608,08JUN2021:00:00:00,UFU PENNA,56,66,103,14,5,122,104,18,122,0,0,0,35,13,28,25,10,11,0,15,57,32,104
20210608,08JUN2021:00:00:00,UFU PIROVANO,166,119,236,31,18,285,245,40,279,6,0,9,53,75,59,39,18,32,0,76,75,94,245
20210608,08JUN2021:00:00:00,UFU PIÑERO,168,127,196,84,15,295,271,24,281,14,0,8,74,79,65,41,16,12,0,43,147,79,271
20210608,08JUN2021:00:00:00,UFU RAMOS MEJIA,158,169,218,75,34,327,281,46,313,14,5,40,48,72,76,57,17,12,0,54,121,106,281
20210608,08JUN2021:00:00:00,UFU RIVADAVIA,135,81,151,52,13,216,202,14,206,10,0,5,31,59,42,48,18,13,0,45,78,78,202
20210608,08JUN2021:00:00:00,UFU SANTOJANNI,153,149,154,144,4,302,284,18,298,4,2,3,67,84,62,44,33,7,0,33,164,87,284
20210608,08JUN2021:00:00:00,UFU TORNU,159,157,231,61,24,316,292,24,302,14,17,33,55,63,73,54,14,7,0,28,181,81,292
20210608,08JUN2021:00:00:00,UFU VELEZ SARSFIELD,138,136,192,74,8,274,270,4,272,2,0,2,78,45,69,53,19,8,0,52,134,84,270
20210608,08JUN2021:00:00:00,UFU ZUBIZARRETA,90,66,82,67,7,156,152,4,156,0,0,6,40,32,33,27,13,5,0,12,94,46,152
20210609,09JUN2021:00:00:00,UFU ALVAREZ,222,154,286,63,27,376,366,10,368,8,18,9,86,105,76,37,25,20,0,50,211,105,366
20210609,09JUN2021:00:00:00,UFU ARGERICH,74,83,105,47,5,157,133,24,145,12,9,6,37,42,32,18,5,8,0,28,57,48,133
20210609,09JUN2021:00:00:00,UFU BORDA-MOYANO,98,24,81,37,4,122,110,12,110,12,0,4,11,28,15,30,21,13,0,6,62,42,110
20210609,09JUN2021:00:00:00,UFU DURAND,179,113,218,44,30,292,282,10,282,10,5,12,47,82,73,49,18,6,0,42,175,65,282
20210609,09JUN2021:00:00:00,UFU ELIZALDE,66,79,46,99,0,145,131,14,137,8,58,32,12,16,13,12,1,1,0,9,78,44,131
20210609,09JUN2021:00:00:00,UFU FERNANDEZ,127,90,147,50,20,217,185,32,205,12,0,5,44,64,31,48,23,2,0,42,19,124,185
20210609,09JUN2021:00:00:00,UFU FERRER,108,64,86,76,10,172,162,10,166,6,0,5,47,35,36,24,23,2,0,25,97,40,162
20210609,09JUN2021:00:00:00,UFU GRIERSON,100,112,87,115,10,212,208,4,208,4,0,15,64,69,32,26,4,2,0,31,114,62,208
20210609,09JUN2021:00:00:00,UFU GUTIERREZ,159,127,190,89,7,286,252,34,286,0,72,51,48,45,29,26,15,0,0,25,155,72,252
20210609,09JUN2021:00:00:00,UFU MUÑIZ,168,182,133,198,19,350,254,96,302,48,0,5,78,90,108,41,18,10,0,29,160,65,254
20210609,09JUN2021:00:00:00,UFU PENNA,74,36,86,23,1,110,100,10,110,0,0,5,23,31,27,15,7,2,0,17,57,26,100
20210609,09JUN2021:00:00:00,UFU PIROVANO,140,113,176,52,25,253,215,38,247,6,0,1,58,66,59,47,10,12,0,43,87,85,215
20210609,09JUN2021:00:00:00,UFU PIÑERO,127,122,143,72,34,249,225,24,247,2,8,14,65,70,36,38,13,5,0,25,140,58,225
20210609,09JUN2021:00:00:00,UFU RAMOS MEJIA,154,145,220,60,19,299,253,46,279,20,13,11,93,63,58,42,9,10,0,39,121,93,253
20210609,09JUN2021:00:00:00,UFU RIVADAVIA,132,96,145,57,26,228,142,86,160,68,0,5,66,64,45,23,23,2,0,14,68,59,142
20210609,09JUN2021:00:00:00,UFU SANTOJANNI,160,170,156,163,11,330,312,18,326,4,10,20,60,79,81,39,20,21,0,44,185,83,312
20210609,09JUN2021:00:00:00,UFU TORNU,138,125,208,42,13,263,231,32,237,26,12,21,62,74,41,30,14,9,0,38,130,61,231
20210609,09JUN2021:00:00:00,UFU VELEZ SARSFIELD,126,154,141,116,23,280,270,10,274,6,0,9,82,67,65,34,20,3,0,40,159,71,270
20210609,09JUN2021:00:00:00,UFU ZUBIZARRETA,22,26,29,16,3,48,48,0,48,0,0,3,15,13,9,4,2,2,0,13,17,18,48
20210610,10JUN2021:00:00:00,UFU ALVAREZ,227,142,283,70,16,369,357,12,357,12,26,20,115,66,57,30,34,21,0,46,209,102,357
20210610,10JUN2021:00:00:00,UFU ARGERICH,62,61,68,51,4,123,101,22,105,18,11,2,27,25,37,12,9,0,0,27,33,40,101
20210610,10JUN2021:00:00:00,UFU BORDA-MOYANO,77,31,81,27,0,108,94,14,94,14,0,2,12,10,18,30,22,14,0,10,56,28,94
20210610,10JUN2021:00:00:00,UFU DURAND,167,110,224,35,18,277,263,14,273,4,13,14,57,70,42,52,26,3,0,38,158,67,263
20210610,10JUN2021:00:00:00,UFU ELIZALDE,87,69,53,99,4,156,142,14,148,8,72,39,11,14,10,7,3,0,0,11,82,49,142
20210610,10JUN2021:00:00:00,UFU FERNANDEZ,139,108,183,48,16,247,161,86,241,6,0,6,73,69,41,34,15,9,0,21,17,123,161
20210610,10JUN2021:00:00:00,UFU FERRER,136,64,103,87,10,200,190,10,190,10,0,0,64,42,43,26,21,4,0,26,113,51,190
20210610,10JUN2021:00:00:00,UFU GRIERSON,177,142,149,156,14,319,315,4,317,2,0,12,83,78,71,50,23,2,0,35,186,91,315
20210610,10JUN2021:00:00:00,UFU GUTIERREZ,158,132,236,27,27,290,274,16,286,4,43,32,60,75,37,35,8,0,0,29,154,89,274
20210610,10JUN2021:00:00:00,UFU MUÑIZ,171,148,137,162,20,319,221,98,243,76,5,7,72,87,68,51,19,10,0,34,125,62,221
20210610,10JUN2021:00:00:00,UFU PENNA,96,63,123,22,14,159,139,20,147,12,0,9,54,36,34,15,3,8,0,13,88,38,139
20210610,10JUN2021:00:00:00,UFU PIROVANO,154,161,244,60,11,315,253,62,309,6,0,6,67,95,56,36,29,26,0,49,102,102,253
20210610,10JUN2021:00:00:00,UFU PIÑERO,159,105,186,69,9,264,240,24,248,16,2,11,79,62,49,39,17,5,0,33,138,63,240
20210610,10JUN2021:00:00:00,UFU RAMOS MEJIA,191,169,222,108,30,360,290,70,340,20,5,12,90,97,55,50,34,17,0,48,130,112,290
20210610,10JUN2021:00:00:00,UFU RIVADAVIA,122,77,141,37,21,199,159,40,161,38,0,4,53,35,45,34,17,11,0,18,73,65,159
20210610,10JUN2021:00:00:00,UFU SANTOJANNI,177,144,204,102,15,321,313,8,317,4,8,17,78,86,59,38,20,15,0,45,195,73,313
20210610,10JUN2021:00:00:00,UFU TORNU,174,137,229,69,13,311,295,16,297,14,16,18,57,80,67,56,9,8,0,46,163,80,295
20210610,10JUN2021:00:00:00,UFU VELEZ SARSFIELD,151,131,215,56,11,282,254,28,280,2,0,10,89,50,63,43,17,10,0,35,141,78,254
20210610,10JUN2021:00:00:00,UFU ZUBIZARRETA,54,50,72,31,1,104,104,0,104,0,0,9,18,28,21,14,11,3,0,20,45,39,104
20210611,11JUN2021:00:00:00,UFU ALVAREZ,139,110,163,63,23,249,237,12,241,8,9,8,60,77,44,21,23,7,0,33,128,76,237
20210611,11JUN2021:00:00:00,UFU ARGERICH,65,75,99,34,7,140,104,36,116,24,2,11,29,27,30,15,15,11,0,29,35,40,104
20210611,11JUN2021:00:00:00,UFU BORDA-MOYANO,38,33,45,24,2,71,61,10,61,10,0,0,20,14,18,10,7,2,0,3,39,19,61
20210611,11JUN2021:00:00:00,UFU DURAND,148,90,181,42,15,238,232,6,232,6,2,13,43,59,48,33,27,13,0,29,144,59,232
20210611,11JUN2021:00:00:00,UFU ELIZALDE,62,47,35,68,6,109,99,10,103,6,55,22,4,13,12,3,0,0,0,9,53,37,99
20210611,11JUN2021:00:00:00,UFU FERNANDEZ,111,64,132,25,18,175,143,32,165,10,0,4,45,38,34,27,22,5,0,22,14,107,143
20210611,11JUN2021:00:00:00,UFU FERRER,86,72,93,53,12,158,152,6,152,6,0,0,46,41,31,22,18,0,0,13,99,40,152
20210611,11JUN2021:00:00:00,UFU GRIERSON,168,144,136,153,23,312,308,4,310,2,0,12,80,80,55,18,54,13,0,43,176,87,308
20210611,11JUN2021:00:00:00,UFU GUTIERREZ,143,96,159,55,25,239,225,14,237,2,49,24,36,61,38,24,7,0,0,29,131,64,225
20210611,11JUN2021:00:00:00,UFU MUÑIZ,156,188,126,194,24,344,266,78,312,32,4,9,88,89,73,45,18,18,0,30,168,68,266
20210611,11JUN2021:00:00:00,UFU PENNA,63,53,86,25,5,116,98,18,114,2,0,0,26,36,24,22,6,2,0,18,54,25,98
20210611,11JUN2021:00:00:00,UFU PIROVANO,159,103,191,44,27,262,208,54,256,6,0,6,66,70,49,33,25,13,0,38,84,86,208
20210611,11JUN2021:00:00:00,UFU PIÑERO,108,83,127,56,8,191,173,18,187,4,10,4,55,41,32,27,12,10,0,19,109,43,173
20210611,11JUN2021:00:00:00,UFU RAMOS MEJIA,166,158,232,60,32,324,212,112,260,64,8,11,90,99,43,43,18,12,0,26,110,76,212
20210611,11JUN2021:00:00:00,UFU RIVADAVIA,110,99,140,56,13,209,169,40,193,16,0,3,47,47,39,52,14,7,0,21,78,70,169
20210611,11JUN2021:00:00:00,UFU SANTOJANNI,139,126,126,131,8,265,257,8,261,4,8,16,75,59,41,33,26,7,0,43,159,55,257
20210611,11JUN2021:00:00:00,UFU TORNU,105,99,147,49,8,204,176,28,186,18,12,11,34,42,37,33,24,11,0,25,107,39,176
20210611,11JUN2021:00:00:00,UFU VELEZ SARSFIELD,174,115,179,82,28,289,269,20,289,0,0,9,57,100,63,37,15,8,0,32,160,77,269
20210611,11JUN2021:00:00:00,UFU ZUBIZARRETA,92,42,72,54,8,134,134,0,134,0,0,13,32,26,30,17,14,2,0,24,75,35,134
20210612,12JUN2021:00:00:00,UFU ALVAREZ,137,134,215,44,12,271,261,10,261,10,10,10,62,61,50,29,38,11,0,45,140,76,261
20210612,12JUN2021:00:00:00,UFU ARGERICH,14,22,20,12,4,36,34,2,36,0,0,0,13,9,7,5,2,0,0,11,8,14,34
20210612,12JUN2021:00:00:00,UFU BORDA-MOYANO,59,28,57,30,0,87,81,6,81,6,1,2,15,7,15,28,4,15,0,6,47,27,81
20210612,12JUN2021:00:00:00,UFU DURAND,114,77,155,23,13,191,189,2,189,2,5,2,34,66,28,40,8,8,0,48,91,50,189
20210612,12JUN2021:00:00:00,UFU ELIZALDE,65,61,46,69,11,126,102,24,110,16,45,35,12,19,13,0,2,0,0,6,59,37,102
20210612,12JUN2021:00:00:00,UFU FERNANDEZ,65,30,59,20,16,95,87,8,89,6,0,4,16,33,15,16,8,3,0,14,16,57,87
20210612,12JUN2021:00:00:00,UFU FERRER,81,56,74,52,11,137,133,4,133,4,0,0,29,36,47,21,0,4,0,30,64,39,133
20210612,12JUN2021:00:00:00,UFU GRIERSON,127,91,86,81,51,218,212,6,214,4,0,16,59,56,51,26,6,4,0,43,114,55,212
20210612,12JUN2021:00:00:00,UFU GUTIERREZ,144,98,155,61,26,242,228,14,238,4,51,31,41,64,36,11,8,0,0,16,130,81,228
20210612,12JUN2021:00:00:00,UFU MUÑIZ,148,170,111,188,19,318,218,100,280,38,0,4,86,70,65,66,24,3,0,27,138,50,218
20210612,12JUN2021:00:00:00,UFU PENNA,8,34,30,9,3,42,36,6,40,2,0,0,9,21,7,1,2,2,0,6,19,11,36
20210612,12JUN2021:00:00:00,UFU PIROVANO,125,121,173,36,37,246,224,22,236,10,0,13,44,74,57,30,17,11,0,44,87,93,224
20210612,12JUN2021:00:00:00,UFU PIÑERO,83,87,88,60,22,170,164,6,166,4,0,7,61,43,22,17,17,3,0,12,112,39,164
20210612,12JUN2021:00:00:00,UFU RAMOS MEJIA,83,116,142,31,26,199,155,44,175,24,8,3,47,34,48,32,14,13,0,19,82,54,155
20210612,12JUN2021:00:00:00,UFU RIVADAVIA,126,76,147,39,16,202,188,14,190,12,0,1,57,51,26,40,15,12,0,27,111,48,188
20210612,12JUN2021:00:00:00,UFU SANTOJANNI,198,200,182,189,27,398,382,16,394,4,2,33,81,93,82,51,33,23,0,65,214,101,382
20210612,12JUN2021:00:00:00,UFU TORNU,98,82,139,22,19,180,170,10,170,10,6,9,17,46,48,21,26,7,0,26,91,51,170
20210612,12JUN2021:00:00:00,UFU VELEZ SARSFIELD,162,129,184,79,28,291,286,5,289,2,0,6,56,76,57,50,30,16,0,42,165,79,286
20210612,12JUN2021:00:00:00,UFU ZUBIZARRETA,150,128,153,110,15,278,274,4,278,0,0,17,53,68,54,43,30,13,0,34,168,72,274
20210613,13JUN2021:00:00:00,UFU ALVAREZ,147,108,207,33,15,255,233,22,233,22,13,11,42,44,60,53,20,12,0,86,103,44,233
20210613,13JUN2021:00:00:00,UFU ARGERICH,49,30,53,26,0,79,79,0,79,0,0,0,21,12,27,10,7,2,0,14,26,38,79
20210613,13JUN2021:00:00:00,UFU BORDA-MOYANO,22,10,18,14,0,32,32,0,32,0,0,0,4,6,8,10,4,0,0,4,17,11,32
20210613,13JUN2021:00:00:00,UFU DURAND,156,155,262,49,0,311,303,8,305,6,7,19,93,76,64,29,20,3,0,50,193,60,303
20210613,13JUN2021:00:00:00,UFU ELIZALDE,129,76,68,135,2,205,164,41,179,26,79,43,7,43,24,9,0,0,0,17,106,41,164
20210613,13JUN2021:00:00:00,UFU FERNANDEZ,120,106,165,45,16,226,199,27,212,14,0,2,48,53,61,41,12,9,0,45,33,121,199
20210613,13JUN2021:00:00:00,UFU FERRER,66,66,69,60,3,132,128,4,128,4,0,0,16,34,53,18,8,3,0,32,64,32,128
20210613,13JUN2021:00:00:00,UFU GRIERSON,117,108,110,82,33,225,213,12,219,6,4,11,64,50,48,35,13,0,0,44,127,42,213
20210613,13JUN2021:00:00:00,UFU GUTIERREZ,110,71,130,45,6,181,165,16,173,8,44,30,27,27,23,18,12,0,0,20,88,57,165
20210613,13JUN2021:00:00:00,UFU MUÑIZ,166,216,147,231,4,382,317,65,344,38,0,13,89,91,77,57,37,18,0,54,195,68,317
20210613,13JUN2021:00:00:00,UFU PENNA,71,49,72,45,3,120,108,12,118,2,0,2,27,23,24,11,21,12,0,16,68,24,108
20210613,13JUN2021:00:00:00,UFU PIROVANO,199,192,313,66,12,391,361,30,377,14,21,22,66,98,106,35,32,11,0,109,156,96,361
20210613,13JUN2021:00:00:00,UFU PIÑERO,141,93,142,90,2,234,222,12,222,12,0,5,50,43,68,31,34,3,0,36,146,40,222
20210613,13JUN2021:00:00:00,UFU RAMOS MEJIA,168,149,232,56,29,317,262,55,309,8,1,8,66,98,86,33,20,5,0,53,143,64,262
20210613,13JUN2021:00:00:00,UFU RIVADAVIA,143,91,200,32,2,234,222,12,224,10,0,1,47,70,28,44,12,32,0,40,138,44,222
20210613,13JUN2021:00:00:00,UFU SANTOJANNI,160,121,153,118,10,281,265,16,275,6,0,14,73,79,52,41,12,10,0,38,162,65,265
20210613,13JUN2021:00:00:00,UFU TORNU,93,80,153,19,1,173,157,16,157,16,7,13,19,35,52,34,7,6,0,24,84,49,157
20210613,13JUN2021:00:00:00,UFU VELEZ SARSFIELD,188,151,258,81,0,339,337,2,337,2,0,9,66,58,74,66,54,12,0,63,205,69,337
20210613,13JUN2021:00:00:00,UFU ZUBIZARRETA,91,66,105,42,10,157,155,2,157,0,0,7,31,41,34,27,14,3,0,25,89,41,155
20210614,14JUN2021:00:00:00,UFU ALVAREZ,168,134,221,71,10,302,274,28,274,28,18,18,68,56,56,49,22,15,0,50,123,101,274
20210614,14JUN2021:00:00:00,UFU ARGERICH,94,64,107,46,5,158,140,18,148,10,7,8,42,40,28,17,7,9,0,35,49,56,140
20210614,14JUN2021:00:00:00,UFU BORDA-MOYANO,60,36,52,39,5,96,58,38,58,38,0,5,14,23,29,17,4,4,0,8,34,16,58
20210614,14JUN2021:00:00:00,UFU DURAND,233,144,256,92,29,377,363,14,367,10,9,22,85,122,63,46,28,2,0,57,205,101,363
20210614,14JUN2021:00:00:00,UFU ELIZALDE,132,107,61,170,8,239,209,30,215,24,104,70,18,22,10,13,2,0,0,17,128,64,209
20210614,14JUN2021:00:00:00,UFU FERNANDEZ,109,92,146,33,22,201,173,28,185,16,0,4,43,43,41,31,28,11,0,22,21,130,173
20210614,14JUN2021:00:00:00,UFU FERRER,100,97,84,104,9,197,191,6,195,2,0,5,51,57,54,19,9,2,0,20,122,49,191
20210614,14JUN2021:00:00:00,UFU GRIERSON,143,139,120,142,20,282,264,18,266,16,0,19,63,82,61,31,18,8,0,32,155,77,264
20210614,14JUN2021:00:00:00,UFU GUTIERREZ,157,128,171,90,24,285,269,16,281,4,75,44,57,48,30,29,2,0,0,22,154,91,269
20210614,14JUN2021:00:00:00,UFU MUÑIZ,191,232,174,218,31,423,325,98,355,68,5,0,81,129,79,83,34,12,0,33,208,84,325
20220327,27MAR2022:00:00:00,UFU GUTIERREZ,129,69,152,35,11,198,198,0,198,0,107,84,0,2,3,2,0,0,0,2,134,62,198
20210614,14JUN2021:00:00:00,UFU PENNA,50,74,87,32,5,124,96,28,120,4,0,8,27,25,28,28,6,2,0,13,57,26,96
20210617,17JUN2021:00:00:00,UFU ZUBIZARRETA,108,54,91,53,18,162,160,2,160,2,0,14,52,34,24,24,11,3,0,21,98,41,160
20210618,18JUN2021:00:00:00,UFU ALVAREZ,155,136,225,55,11,291,277,14,281,10,32,10,74,54,65,24,24,8,0,23,177,77,277
20210618,18JUN2021:00:00:00,UFU ARGERICH,72,53,75,44,6,125,107,18,107,18,0,5,23,34,37,13,9,4,0,17,42,47,107
20210618,18JUN2021:00:00:00,UFU BORDA-MOYANO,34,26,30,22,8,60,52,8,52,8,0,0,4,22,22,8,4,0,0,3,35,14,52
20210618,18JUN2021:00:00:00,UFU DURAND,130,67,152,17,28,197,189,8,189,8,0,9,42,55,40,31,9,11,0,33,104,52,189
20210618,18JUN2021:00:00:00,UFU ELIZALDE,67,64,38,88,5,131,125,6,131,0,69,39,2,10,4,7,0,0,0,10,80,35,125
20210618,18JUN2021:00:00:00,UFU FERNANDEZ,78,49,79,35,13,127,59,68,125,2,0,4,30,36,30,14,11,2,0,3,35,21,59
20210618,18JUN2021:00:00:00,UFU FERRER,87,63,63,72,15,150,144,6,146,4,0,4,40,42,28,27,9,0,0,22,87,35,144
20210618,18JUN2021:00:00:00,UFU GRIERSON,121,86,97,94,16,207,207,0,207,0,0,11,55,64,38,30,9,0,0,26,122,58,207
20210618,18JUN2021:00:00:00,UFU GUTIERREZ,147,101,181,44,23,248,226,22,244,4,55,19,48,50,41,23,12,0,0,23,137,66,226
20210618,18JUN2021:00:00:00,UFU MUÑIZ,139,203,159,162,21,342,258,84,304,38,0,10,69,102,91,61,9,0,0,32,159,67,258
20210618,18JUN2021:00:00:00,UFU PENNA,69,47,86,18,12,116,94,22,114,2,0,3,31,25,15,20,17,5,0,15,51,28,94
20210618,18JUN2021:00:00:00,UFU PIROVANO,139,101,166,36,38,240,208,32,236,4,0,5,53,78,51,20,23,10,0,48,81,79,208
20210618,18JUN2021:00:00:00,UFU PIÑERO,120,86,135,58,13,206,182,24,200,6,8,18,48,40,40,33,16,3,0,14,114,52,182
20210618,18JUN2021:00:00:00,UFU RAMOS MEJIA,137,139,194,58,24,276,214,62,248,28,14,30,58,52,58,41,12,11,0,18,104,92,214
20210618,18JUN2021:00:00:00,UFU RIVADAVIA,129,108,172,39,26,237,205,32,221,16,2,16,71,61,40,27,12,8,0,30,90,84,205
20210618,18JUN2021:00:00:00,UFU SANTOJANNI,142,65,121,73,13,207,187,20,199,8,2,16,25,61,61,19,17,6,0,23,119,45,187
20210618,18JUN2021:00:00:00,UFU TORNU,150,89,163,62,14,239,227,12,227,12,21,11,42,56,53,34,16,6,0,21,139,66,227
20210618,18JUN2021:00:00:00,UFU VELEZ SARSFIELD,140,78,162,37,19,218,212,6,214,4,0,9,57,53,45,27,14,13,0,27,118,67,212
20210618,18JUN2021:00:00:00,UFU ZUBIZARRETA,95,77,104,56,12,172,172,0,172,0,0,3,34,38,36,28,27,6,0,14,110,48,172
20210619,19JUN2021:00:00:00,UFU ALVAREZ,115,93,159,37,12,208,204,4,204,4,14,6,46,56,38,28,13,7,0,20,129,55,204
20210619,19JUN2021:00:00:00,UFU ARGERICH,23,10,21,9,3,33,33,0,33,0,0,2,3,12,8,6,0,2,0,10,11,12,33
20210619,19JUN2021:00:00:00,UFU BORDA-MOYANO,38,17,32,17,6,55,55,0,55,0,0,3,6,13,20,7,4,2,0,4,33,18,55
20210619,19JUN2021:00:00:00,UFU DURAND,114,64,142,11,25,178,172,6,172,6,0,5,46,48,31,32,12,4,0,26,103,43,172
20210619,19JUN2021:00:00:00,UFU ELIZALDE,58,68,51,75,0,126,110,16,118,8,66,36,6,9,4,3,2,0,0,3,84,23,110
20210619,19JUN2021:00:00:00,UFU FERNANDEZ,66,46,70,23,19,112,86,26,106,6,0,4,19,50,17,8,5,9,0,15,8,63,86
20210619,19JUN2021:00:00:00,UFU FERRER,70,77,68,55,24,147,139,8,139,8,0,0,41,48,38,14,6,0,0,14,84,41,139
20210619,19JUN2021:00:00:00,UFU GRIERSON,78,63,49,56,36,141,141,0,141,0,0,0,31,40,32,24,11,3,0,13,76,52,141
20210619,19JUN2021:00:00:00,UFU GUTIERREZ,103,77,129,33,18,180,166,14,172,8,39,14,18,41,55,8,5,0,0,17,95,52,166
20210619,19JUN2021:00:00:00,UFU MUÑIZ,105,122,60,140,27,227,193,34,199,28,0,8,41,59,49,49,13,8,0,21,127,45,193
20210619,19JUN2021:00:00:00,UFU PENNA,30,27,43,14,0,57,55,2,57,0,0,0,20,13,8,6,10,0,0,14,27,14,55
20210619,19JUN2021:00:00:00,UFU PIROVANO,145,118,193,34,36,263,223,40,249,14,0,7,71,62,70,33,15,5,0,35,90,98,223
20210619,19JUN2021:00:00:00,UFU PIÑERO,63,62,86,31,8,125,125,0,125,0,0,4,20,31,24,26,14,6,0,12,69,44,125
20210619,19JUN2021:00:00:00,UFU RAMOS MEJIA,89,86,134,23,18,175,151,24,165,10,5,9,25,56,35,21,12,12,0,16,85,50,151
20210619,19JUN2021:00:00:00,UFU RIVADAVIA,84,37,89,25,7,121,119,2,119,2,0,3,40,29,16,16,9,8,0,20,45,54,119
20210619,19JUN2021:00:00:00,UFU SANTOJANNI,186,154,166,155,19,340,322,18,330,10,0,15,76,83,70,40,40,16,0,40,199,83,322
20210619,19JUN2021:00:00:00,UFU TORNU,115,108,151,46,26,223,207,16,207,16,19,12,27,64,49,31,13,8,0,15,134,57,207
20210619,19JUN2021:00:00:00,UFU VELEZ SARSFIELD,114,121,171,47,17,235,225,10,227,8,0,4,47,69,71,32,10,2,0,26,126,73,225
20210619,19JUN2021:00:00:00,UFU ZUBIZARRETA,139,105,161,68,15,244,242,2,244,0,0,23,45,64,52,28,24,8,0,36,136,70,242
20210620,20JUN2021:00:00:00,UFU ALVAREZ,71,68,109,24,6,139,135,4,135,4,16,2,24,26,33,17,19,2,0,24,71,40,135
20210620,20JUN2021:00:00:00,UFU BORDA-MOYANO,15,15,17,7,6,30,24,6,24,6,0,2,4,10,2,7,5,0,0,1,14,9,24
20210620,20JUN2021:00:00:00,UFU DURAND,95,66,107,30,24,161,157,4,157,4,5,12,18,56,26,23,18,3,0,27,86,44,157
20210620,20JUN2021:00:00:00,UFU ELIZALDE,25,57,44,33,5,82,68,14,78,4,36,27,11,0,4,4,0,0,0,7,44,17,68
20210620,20JUN2021:00:00:00,UFU FERNANDEZ,63,61,87,26,11,124,100,24,120,4,0,4,48,14,30,20,0,8,0,10,13,77,100
20210620,20JUN2021:00:00:00,UFU FERRER,54,48,37,57,8,102,100,2,100,2,0,0,18,31,28,9,14,2,0,26,47,27,100
20210620,20JUN2021:00:00:00,UFU GRIERSON,51,51,39,34,29,102,98,4,98,4,0,1,27,15,34,16,5,4,0,14,41,42,98
20210620,20JUN2021:00:00:00,UFU GUTIERREZ,103,59,127,27,8,162,154,8,154,8,45,30,23,32,29,1,2,0,0,9,92,53,154
20210620,20JUN2021:00:00:00,UFU MUÑIZ,79,81,81,67,12,160,134,26,138,22,0,4,27,52,51,17,7,2,0,15,82,37,134
20210620,20JUN2021:00:00:00,UFU PENNA,32,19,33,13,5,51,49,2,51,0,0,1,13,20,7,8,2,0,0,12,23,14,49
20210620,20JUN2021:00:00:00,UFU PIROVANO,121,66,139,20,28,187,169,18,185,2,4,1,30,65,49,25,8,5,0,30,71,68,169
20210620,20JUN2021:00:00:00,UFU PIÑERO,38,30,40,24,4,68,68,0,68,0,0,2,15,14,17,6,10,4,0,15,27,26,68
20210620,20JUN2021:00:00:00,UFU RAMOS MEJIA,81,55,98,24,14,136,120,16,126,10,5,0,34,36,26,24,8,3,0,29,52,39,120
20210620,20JUN2021:00:00:00,UFU RIVADAVIA,63,83,99,26,21,146,134,12,140,6,0,4,52,28,23,18,9,12,0,19,54,60,134
20210620,20JUN2021:00:00:00,UFU SANTOJANNI,128,87,106,93,16,215,207,8,209,6,0,6,46,39,38,53,24,9,0,26,119,62,207
20210620,20JUN2021:00:00:00,UFU TORNU,75,57,100,28,4,132,120,12,120,12,3,6,17,34,33,12,16,11,0,10,83,27,120
20210620,20JUN2021:00:00:00,UFU VELEZ SARSFIELD,92,96,134,42,12,188,186,2,188,0,0,12,37,56,36,27,15,5,0,34,95,57,186
20210620,20JUN2021:00:00:00,UFU ZUBIZARRETA,50,40,67,16,7,90,86,4,90,0,0,5,22,9,20,19,7,8,0,18,40,28,86
20210621,21JUN2021:00:00:00,UFU ALVAREZ,133,100,195,33,5,233,215,18,217,16,23,14,36,55,41,33,13,18,0,25,134,56,215
20210621,21JUN2021:00:00:00,UFU ARGERICH,41,31,35,34,3,72,72,0,72,0,0,4,12,19,18,8,7,4,0,15,25,32,72
20210621,21JUN2021:00:00:00,UFU BORDA-MOYANO,21,56,52,23,2,77,33,44,33,44,0,0,5,10,14,42,6,0,0,3,20,10,33
20210621,21JUN2021:00:00:00,UFU DURAND,146,47,145,28,20,193,187,6,189,4,0,4,29,65,48,24,10,13,0,48,89,50,187
20210621,21JUN2021:00:00:00,UFU ELIZALDE,114,98,67,143,2,212,166,46,196,16,108,69,10,13,3,6,1,2,0,15,108,43,166
20210621,21JUN2021:00:00:00,UFU FERNANDEZ,59,38,82,6,9,97,87,10,87,10,0,3,19,11,24,12,20,8,0,17,40,30,87
20210621,21JUN2021:00:00:00,UFU FERRER,82,85,76,74,17,167,157,10,157,10,0,0,50,54,38,17,5,3,0,29,83,45,157
20210621,21JUN2021:00:00:00,UFU GRIERSON,125,95,97,65,58,220,218,2,218,2,0,12,68,53,38,16,18,15,0,36,118,63,218
20210621,21JUN2021:00:00:00,UFU GUTIERREZ,190,99,180,79,30,289,278,11,280,9,67,39,59,69,38,15,2,0,0,28,160,89,278
20210621,21JUN2021:00:00:00,UFU MUÑIZ,132,132,98,145,21,264,206,58,224,40,0,15,64,45,82,38,12,8,0,24,133,49,206
20210621,21JUN2021:00:00:00,UFU PENNA,31,20,29,19,3,51,49,2,51,0,0,3,3,25,7,5,4,4,0,9,22,18,49
20210621,21JUN2021:00:00:00,UFU PIROVANO,141,130,197,52,22,271,255,16,267,4,0,3,56,86,53,32,20,21,0,54,95,106,255
20210621,21JUN2021:00:00:00,UFU PIÑERO,100,51,85,54,12,151,145,6,145,6,0,3,43,26,36,19,14,10,0,19,84,41,145
20210621,21JUN2021:00:00:00,UFU RAMOS MEJIA,128,129,184,54,19,257,245,12,245,12,6,16,51,64,30,49,26,15,0,44,107,94,245
20210621,21JUN2021:00:00:00,UFU RIVADAVIA,74,84,104,32,22,158,146,12,148,10,0,2,47,40,33,18,11,7,0,24,70,52,146
20210621,21JUN2021:00:00:00,UFU SANTOJANNI,169,138,145,137,25,307,295,12,299,8,5,30,61,59,82,50,9,11,0,37,181,77,295
20210621,21JUN2021:00:00:00,UFU TORNU,79,101,117,40,23,180,170,10,170,10,8,7,31,60,38,14,15,7,0,30,93,47,170
20210621,21JUN2021:00:00:00,UFU VELEZ SARSFIELD,144,139,196,67,20,283,283,0,283,0,0,9,57,53,72,44,32,16,0,36,165,82,283
20210621,21JUN2021:00:00:00,UFU ZUBIZARRETA,149,143,190,73,29,292,290,2,292,0,0,25,54,92,67,38,9,7,0,36,165,89,290
20210622,22JUN2021:00:00:00,UFU ALVAREZ,185,133,219,78,21,318,304,14,310,8,34,14,60,71,60,44,29,6,0,35,172,97,304
20210622,22JUN2021:00:00:00,UFU ARGERICH,79,55,81,42,11,134,126,8,128,6,10,10,27,41,17,9,16,4,0,23,52,51,126
20210622,22JUN2021:00:00:00,UFU BORDA-MOYANO,39,32,36,27,8,71,61,10,61,10,0,6,15,15,6,15,10,4,0,6,34,21,61
20210622,22JUN2021:00:00:00,UFU DURAND,184,125,246,33,30,309,303,6,303,6,5,10,86,71,77,38,15,7,0,45,176,82,303
20210622,22JUN2021:00:00:00,UFU ELIZALDE,130,108,48,181,9,238,212,26,234,4,127,74,10,11,12,3,0,1,0,7,148,57,212
20210622,22JUN2021:00:00:00,UFU FERNANDEZ,84,53,88,39,10,137,119,18,129,8,0,3,25,42,30,25,11,1,0,18,13,88,119
20210622,22JUN2021:00:00:00,UFU FERRER,103,90,89,79,25,193,189,4,189,4,0,0,48,76,34,22,4,9,0,21,119,49,189
20210622,22JUN2021:00:00:00,UFU GRIERSON,179,139,162,126,30,318,302,16,304,14,0,10,93,68,81,51,10,5,0,46,173,83,302
20210622,22JUN2021:00:00:00,UFU GUTIERREZ,166,129,206,68,21,295,283,12,293,2,61,45,54,70,36,21,8,0,0,39,153,90,283
20210622,22JUN2021:00:00:00,UFU MUÑIZ,133,221,141,176,37,354,301,53,317,37,0,9,61,113,91,42,34,4,0,38,181,82,301
20210622,22JUN2021:00:00:00,UFU PENNA,68,73,107,32,2,141,117,24,137,4,0,5,19,45,37,13,14,8,0,14,75,28,117
20210622,22JUN2021:00:00:00,UFU PIROVANO,200,124,228,53,43,324,282,42,316,8,0,4,75,85,57,39,38,26,0,50,117,115,282
20210622,22JUN2021:00:00:00,UFU PIÑERO,132,105,154,61,22,237,223,14,229,8,6,12,73,38,64,13,20,11,0,10,147,58,223
20210622,22JUN2021:00:00:00,UFU RAMOS MEJIA,243,210,346,63,44,453,343,110,429,24,6,17,118,121,90,50,33,18,0,52,178,111,343
20210622,22JUN2021:00:00:00,UFU RIVADAVIA,139,73,154,35,23,212,208,4,210,2,0,3,50,66,39,30,19,5,0,33,97,77,208
20210622,22JUN2021:00:00:00,UFU SANTOJANNI,177,154,150,165,16,331,319,12,329,2,3,10,67,92,82,41,27,9,0,45,195,77,319
20210622,22JUN2021:00:00:00,UFU TORNU,107,123,171,37,22,230,214,16,216,14,6,9,34,67,57,23,25,9,0,28,125,57,214
20210622,22JUN2021:00:00:00,UFU VELEZ SARSFIELD,177,137,211,76,27,314,308,6,308,6,0,2,84,86,72,41,21,8,0,58,168,82,308
20210622,22JUN2021:00:00:00,UFU ZUBIZARRETA,132,137,146,97,26,269,267,2,269,0,0,4,56,86,34,40,27,22,0,42,152,73,267
20210623,23JUN2021:00:00:00,UFU ALVAREZ,194,178,280,73,19,372,362,10,362,10,23,21,80,93,89,44,17,5,0,42,213,107,362
20210623,23JUN2021:00:00:00,UFU ARGERICH,76,58,67,63,4,134,120,14,124,10,15,16,28,25,20,11,13,6,0,32,40,48,120
20210623,23JUN2021:00:00:00,UFU BORDA-MOYANO,76,23,58,32,9,99,85,14,85,14,0,4,19,17,11,29,8,11,0,14,39,32,85
20210623,23JUN2021:00:00:00,UFU DURAND,180,113,210,34,49,293,285,8,287,6,2,13,67,108,60,19,11,13,0,30,189,66,285
20210623,23JUN2021:00:00:00,UFU ELIZALDE,122,85,59,142,6,207,191,16,197,10,94,60,16,23,4,7,3,0,0,4,135,52,191
20210623,23JUN2021:00:00:00,UFU FERNANDEZ,119,90,142,33,34,209,191,18,199,10,0,2,61,48,47,26,15,10,0,25,95,71,191
20210623,23JUN2021:00:00:00,UFU FERRER,86,45,47,82,2,131,131,0,131,0,3,0,33,51,26,15,1,2,0,16,80,35,131
20210623,23JUN2021:00:00:00,UFU GRIERSON,178,115,129,124,40,293,287,6,287,6,0,21,49,96,62,40,15,10,0,38,170,77,287
20210623,23JUN2021:00:00:00,UFU GUTIERREZ,191,153,223,94,27,344,324,20,342,2,72,84,57,76,35,14,5,1,0,22,219,82,324
20210623,23JUN2021:00:00:00,UFU MUÑIZ,166,265,170,231,30,431,343,88,391,40,2,10,107,137,111,46,15,3,0,40,218,85,343
20210623,23JUN2021:00:00:00,UFU PENNA,57,55,96,15,1,112,100,12,112,0,0,0,39,12,18,26,16,1,0,17,56,27,100
20210623,23JUN2021:00:00:00,UFU PIROVANO,148,113,189,45,27,261,239,22,257,4,0,5,54,72,65,44,14,7,0,42,100,97,239
20210623,23JUN2021:00:00:00,UFU PIÑERO,104,109,131,77,5,213,201,12,211,2,15,5,44,55,45,33,2,14,0,16,135,48,201
20210623,23JUN2021:00:00:00,UFU RAMOS MEJIA,163,173,241,69,26,336,304,32,326,10,9,11,74,91,67,41,34,9,0,38,158,108,304
20210623,23JUN2021:00:00:00,UFU RIVADAVIA,104,97,135,46,20,201,155,46,155,46,0,9,78,56,27,21,8,2,0,30,60,65,155
20210623,23JUN2021:00:00:00,UFU SANTOJANNI,179,118,154,131,12,297,293,4,295,2,7,24,50,68,52,32,43,21,0,29,192,72,293
20210623,23JUN2021:00:00:00,UFU TORNU,125,120,186,34,25,245,207,38,211,34,22,24,46,50,50,25,24,4,0,18,134,52,207
20210623,23JUN2021:00:00:00,UFU VELEZ SARSFIELD,154,130,170,73,41,284,270,14,276,8,0,8,55,76,66,52,19,8,0,32,165,73,270
20210623,23JUN2021:00:00:00,UFU ZUBIZARRETA,72,107,109,54,16,179,179,0,179,0,0,9,44,43,41,23,6,13,0,26,100,53,179
20210624,24JUN2021:00:00:00,UFU ALVAREZ,207,172,268,86,25,379,357,22,361,18,21,23,128,83,65,30,13,16,0,48,200,108,357
20210624,24JUN2021:00:00:00,UFU ARGERICH,57,47,60,36,8,104,86,18,92,12,0,5,21,32,19,18,7,2,0,18,31,36,86
20210624,24JUN2021:00:00:00,UFU BORDA-MOYANO,67,30,56,37,4,97,91,6,91,6,0,0,7,17,24,30,8,11,0,7,59,25,91
20210624,24JUN2021:00:00:00,UFU DURAND,167,147,246,17,51,314,306,8,308,6,2,26,90,112,43,19,19,3,0,44,184,78,306
20210624,24JUN2021:00:00:00,UFU ELIZALDE,124,112,87,140,9,236,216,20,222,14,143,62,4,14,9,1,3,0,0,14,145,57,216
20210624,24JUN2021:00:00:00,UFU FERNANDEZ,100,67,133,16,18,167,143,24,157,10,0,0,36,54,35,16,13,13,0,24,69,50,143
20210624,24JUN2021:00:00:00,UFU FERRER,150,84,98,127,9,234,224,10,224,10,0,3,71,72,45,26,17,0,0,26,138,60,224
20210624,24JUN2021:00:00:00,UFU GRIERSON,150,108,107,119,32,258,250,8,250,8,0,19,62,51,64,36,17,9,0,36,148,66,250
20210624,24JUN2021:00:00:00,UFU GUTIERREZ,173,157,211,81,38,330,298,32,318,12,108,42,37,77,37,24,5,0,0,26,189,82,298
20210624,24JUN2021:00:00:00,UFU MUÑIZ,191,190,143,205,33,381,317,64,337,44,1,7,86,95,84,71,29,8,0,41,202,74,317
20210624,24JUN2021:00:00:00,UFU PENNA,49,52,72,20,9,101,83,18,93,8,0,1,24,31,24,12,9,0,0,10,56,17,83
20210624,24JUN2021:00:00:00,UFU PIROVANO,157,115,210,25,37,272,246,26,264,8,0,16,48,88,54,35,13,18,0,42,109,95,246
20210624,24JUN2021:00:00:00,UFU PIÑERO,98,96,120,51,23,194,184,10,186,8,0,5,49,44,54,29,8,5,0,22,121,38,184
20210624,24JUN2021:00:00:00,UFU RAMOS MEJIA,148,101,161,47,41,249,221,28,231,18,4,6,68,68,43,34,20,6,0,34,112,73,221
20210624,24JUN2021:00:00:00,UFU RIVADAVIA,151,86,156,46,35,237,189,48,197,40,1,12,75,59,47,20,18,5,0,32,88,69,189
20210624,24JUN2021:00:00:00,UFU SANTOJANNI,234,163,224,158,15,397,389,8,393,4,4,18,98,73,107,41,34,22,0,40,255,94,389
20210614,14JUN2021:00:00:00,UFU PIROVANO,152,104,179,53,24,256,226,30,244,12,0,2,46,86,39,38,25,20,0,29,115,82,226
20210614,14JUN2021:00:00:00,UFU PIÑERO,150,130,181,93,6,280,250,30,264,16,6,12,61,84,32,57,22,6,0,40,152,57,250
20210614,14JUN2021:00:00:00,UFU RAMOS MEJIA,265,175,302,108,30,440,374,66,412,28,24,14,115,99,73,56,44,15,0,49,193,131,374
20210614,14JUN2021:00:00:00,UFU RIVADAVIA,132,89,141,53,27,221,207,14,209,12,0,7,70,51,29,38,20,6,0,31,91,85,207
20210614,14JUN2021:00:00:00,UFU SANTOJANNI,200,136,145,170,21,336,322,14,330,6,2,23,68,72,80,46,32,13,0,44,204,74,322
20210614,14JUN2021:00:00:00,UFU TORNU,161,190,250,79,22,351,317,34,319,32,26,24,67,71,83,52,20,8,0,37,199,78,317
20210614,14JUN2021:00:00:00,UFU VELEZ SARSFIELD,175,148,209,106,8,323,315,8,319,4,0,7,64,91,66,43,43,9,0,53,169,93,315
20210614,14JUN2021:00:00:00,UFU ZUBIZARRETA,183,153,166,154,16,336,332,4,336,0,0,4,80,109,61,53,19,10,0,41,199,92,332
20210615,15JUN2021:00:00:00,UFU ALVAREZ,135,177,247,59,6,312,145,167,145,167,19,13,89,64,36,42,28,21,0,17,87,41,145
20210615,15JUN2021:00:00:00,UFU ARGERICH,64,53,66,51,0,117,41,76,41,76,4,10,24,27,36,12,4,0,0,9,13,18,41
20210615,15JUN2021:00:00:00,UFU BORDA-MOYANO,34,48,54,28,0,82,40,42,40,42,0,7,15,14,21,13,10,2,0,2,22,16,40
20210615,15JUN2021:00:00:00,UFU DURAND,136,129,223,38,4,265,123,142,123,142,4,20,81,73,40,24,17,6,0,17,73,33,123
20210615,15JUN2021:00:00:00,UFU ELIZALDE,119,85,61,143,0,204,110,94,128,76,103,51,14,24,8,4,0,0,0,5,79,26,110
20210615,15JUN2021:00:00:00,UFU FERNANDEZ,147,115,198,40,24,262,150,112,246,16,0,6,69,46,61,51,22,7,0,21,20,109,150
20210615,15JUN2021:00:00:00,UFU FERRER,97,94,86,98,7,191,77,114,77,114,0,4,33,51,52,33,11,7,0,13,40,24,77
20210615,15JUN2021:00:00:00,UFU GRIERSON,119,126,96,114,35,245,113,132,113,132,0,12,65,67,54,32,15,0,0,18,66,29,113
20210615,15JUN2021:00:00:00,UFU GUTIERREZ,149,132,241,39,1,281,129,152,135,146,95,32,60,55,26,11,2,0,0,11,72,45,129
20210615,15JUN2021:00:00:00,UFU MUÑIZ,118,158,113,151,12,276,70,206,74,202,2,13,61,70,60,39,25,6,0,10,33,27,70
20210615,15JUN2021:00:00:00,UFU PENNA,65,69,115,15,4,134,68,66,70,64,0,2,21,34,29,17,25,6,0,6,37,25,68
20210615,15JUN2021:00:00:00,UFU PIROVANO,151,90,202,26,13,241,121,120,121,120,0,7,56,52,56,44,21,5,0,42,33,46,121
20210615,15JUN2021:00:00:00,UFU PIÑERO,115,98,119,78,16,213,101,112,111,102,8,18,52,70,23,27,9,6,0,17,58,26,101
20210615,15JUN2021:00:00:00,UFU RAMOS MEJIA,197,139,230,92,14,336,148,188,154,182,13,9,92,89,59,36,23,15,0,18,81,48,148
20210615,15JUN2021:00:00:00,UFU RIVADAVIA,119,126,148,72,25,245,97,148,105,140,0,7,65,74,40,35,13,11,0,13,43,41,97
20210615,15JUN2021:00:00:00,UFU SANTOJANNI,123,98,124,92,5,221,113,108,113,108,0,19,52,50,43,28,25,4,0,16,64,33,113
20210615,15JUN2021:00:00:00,UFU TORNU,131,103,152,72,10,234,88,146,92,142,15,17,35,66,48,41,12,0,0,14,49,23,88
20210615,15JUN2021:00:00:00,UFU VELEZ SARSFIELD,126,115,184,48,9,241,133,108,133,108,0,4,49,60,72,32,21,3,0,19,75,39,133
20210615,15JUN2021:00:00:00,UFU ZUBIZARRETA,49,70,63,52,4,119,117,2,119,0,0,0,29,40,18,9,18,5,0,14,70,33,117
20210616,16JUN2021:00:00:00,UFU ALVAREZ,141,97,173,46,19,238,217,21,217,21,20,20,48,55,49,26,15,5,0,43,100,74,217
20210616,16JUN2021:00:00:00,UFU ARGERICH,68,57,64,41,20,125,111,14,113,12,2,5,35,32,15,12,16,8,0,25,39,46,111
20210616,16JUN2021:00:00:00,UFU BORDA-MOYANO,28,24,27,23,2,52,50,2,50,2,0,3,13,12,6,15,3,0,0,3,32,15,50
20210616,16JUN2021:00:00:00,UFU DURAND,134,109,178,28,37,243,233,10,235,8,6,10,62,79,48,21,12,5,0,33,140,60,233
20210616,16JUN2021:00:00:00,UFU ELIZALDE,103,85,67,103,18,188,176,12,180,8,94,55,9,14,12,2,2,0,0,2,124,50,176
20210616,16JUN2021:00:00:00,UFU FERNANDEZ,108,59,121,15,31,167,141,26,151,16,0,3,52,43,32,16,8,13,0,23,20,98,141
20210616,16JUN2021:00:00:00,UFU FERRER,127,87,106,68,40,214,208,6,208,6,0,4,64,51,38,40,12,5,0,22,128,58,208
20210616,16JUN2021:00:00:00,UFU GRIERSON,87,109,80,75,41,196,184,12,188,8,0,11,62,43,43,35,0,2,0,35,87,60,184
20210616,16JUN2021:00:00:00,UFU GUTIERREZ,139,113,147,59,46,252,226,26,248,4,60,32,34,69,40,13,4,0,0,26,123,77,226
20210616,16JUN2021:00:00:00,UFU MUÑIZ,164,238,134,205,63,402,284,118,336,66,4,20,91,111,92,51,18,15,0,43,167,74,284
20210616,16JUN2021:00:00:00,UFU PENNA,67,56,94,18,11,123,109,14,119,4,0,3,36,43,14,12,6,9,0,15,62,32,109
20210616,16JUN2021:00:00:00,UFU PIROVANO,151,97,178,31,39,248,222,26,238,10,0,7,51,70,65,34,18,3,0,54,79,89,222
20210616,16JUN2021:00:00:00,UFU PIÑERO,76,101,132,23,22,177,155,22,167,10,6,0,63,49,23,20,10,6,0,11,106,36,155
20210616,16JUN2021:00:00:00,UFU RAMOS MEJIA,174,178,225,74,53,352,288,64,324,28,8,20,65,101,79,47,22,10,0,32,150,106,288
20210616,16JUN2021:00:00:00,UFU RIVADAVIA,131,86,151,39,27,217,143,74,155,62,2,2,51,55,40,39,14,14,0,25,60,58,143
20210616,16JUN2021:00:00:00,UFU SANTOJANNI,140,112,123,85,44,252,248,4,250,2,9,11,88,54,32,38,13,7,0,30,165,53,248
20210616,16JUN2021:00:00:00,UFU TORNU,92,86,108,32,38,178,164,14,164,14,5,16,24,44,45,25,16,3,0,23,90,50,164
20210616,16JUN2021:00:00:00,UFU VELEZ SARSFIELD,145,96,158,57,26,241,223,18,237,4,0,8,72,68,52,18,7,16,0,30,126,67,223
20210616,16JUN2021:00:00:00,UFU ZUBIZARRETA,88,35,83,26,14,123,115,8,123,0,0,8,31,36,14,22,4,8,0,15,68,32,115
20210617,17JUN2021:00:00:00,UFU ALVAREZ,169,111,203,52,25,280,266,14,266,14,11,29,48,95,57,16,16,8,0,31,163,72,266
20210617,17JUN2021:00:00:00,UFU ARGERICH,59,67,79,43,4,126,124,2,124,2,0,6,19,27,34,24,10,6,0,23,40,60,124
20210617,17JUN2021:00:00:00,UFU BORDA-MOYANO,81,19,68,26,6,100,82,18,82,18,0,3,17,22,17,17,15,9,0,6,47,29,82
20210617,17JUN2021:00:00:00,UFU DURAND,128,80,142,45,21,208,202,6,202,6,6,12,52,49,57,22,7,3,0,31,117,54,202
20210617,17JUN2021:00:00:00,UFU ELIZALDE,87,96,63,120,0,183,159,24,173,10,117,27,4,24,9,2,0,0,0,6,108,45,159
20210617,17JUN2021:00:00:00,UFU FERNANDEZ,115,65,125,37,18,180,170,10,172,8,0,4,47,49,39,18,17,6,0,26,68,76,170
20210617,17JUN2021:00:00:00,UFU FERRER,81,67,85,50,13,148,140,8,142,6,0,0,49,50,8,22,15,4,0,8,96,36,140
20210617,17JUN2021:00:00:00,UFU GRIERSON,111,117,86,129,13,228,226,2,226,2,0,18,55,37,68,35,14,1,0,31,126,69,226
20210617,17JUN2021:00:00:00,UFU GUTIERREZ,148,97,181,51,13,245,237,8,243,2,52,36,42,49,34,27,5,0,0,35,134,68,237
20210617,17JUN2021:00:00:00,UFU MUÑIZ,119,236,144,185,26,355,273,82,287,68,0,16,69,98,103,45,20,4,0,24,190,59,273
20210617,17JUN2021:00:00:00,UFU PENNA,78,57,101,25,9,135,115,20,129,6,2,3,21,49,31,15,10,4,0,19,63,33,115
20210617,17JUN2021:00:00:00,UFU PIROVANO,155,122,216,35,26,277,227,50,277,0,0,4,71,66,46,38,28,24,0,44,94,89,227
20210617,17JUN2021:00:00:00,UFU PIÑERO,80,64,93,44,7,144,134,10,136,8,2,4,39,42,22,26,2,7,0,15,82,37,134
20210617,17JUN2021:00:00:00,UFU RAMOS MEJIA,150,137,202,47,38,287,247,40,265,22,12,12,56,70,69,26,23,19,0,37,119,89,247
20210617,17JUN2021:00:00:00,UFU RIVADAVIA,98,98,126,44,26,196,158,38,160,36,0,2,72,40,29,33,14,6,0,22,71,64,158
20210617,17JUN2021:00:00:00,UFU SANTOJANNI,152,131,129,131,23,283,271,12,279,4,6,18,63,79,57,29,14,17,0,28,171,72,271
20210617,17JUN2021:00:00:00,UFU TORNU,115,118,153,61,19,233,205,28,215,18,18,18,63,55,32,22,23,2,0,18,123,59,205
20210617,17JUN2021:00:00:00,UFU VELEZ SARSFIELD,133,113,169,54,23,246,240,6,244,2,0,4,51,73,50,37,20,11,0,41,130,69,240
20210528,28MAY2021:00:00:00,UFU PIÑERO,167,101,174,69,25,268,246,22,258,10,3,8,69,60,51,58,11,8,0,47,131,68,246
20210528,28MAY2021:00:00:00,UFU RAMOS MEJIA,216,201,296,79,42,417,331,86,387,30,12,26,92,93,88,56,42,8,0,62,139,130,331
20210528,28MAY2021:00:00:00,UFU RIVADAVIA,179,139,231,53,34,318,278,40,302,16,0,13,94,72,39,68,26,6,0,53,31,192,278
20210528,28MAY2021:00:00:00,UFU SANTOJANNI,207,162,236,118,15,369,351,18,365,4,8,23,90,116,71,37,18,6,0,63,203,85,351
20210528,28MAY2021:00:00:00,UFU TORNU,154,121,209,52,14,275,249,26,249,26,10,17,54,82,64,27,16,5,0,50,125,70,249
20210528,28MAY2021:00:00:00,UFU VELEZ SARSFIELD,158,147,206,77,22,305,293,12,301,4,0,5,63,82,61,52,26,16,0,45,149,99,293
20210528,28MAY2021:00:00:00,UFU ZUBIZARRETA,178,173,232,111,8,351,349,2,351,0,0,17,87,103,57,42,32,13,0,52,206,91,349
20210529,29MAY2021:00:00:00,UFU ALVAREZ,175,137,230,73,9,312,298,14,300,12,4,20,62,68,57,63,23,15,0,69,141,88,298
20210529,29MAY2021:00:00:00,UFU ARGERICH,27,20,25,22,0,47,47,0,47,0,0,0,10,17,10,8,0,2,0,15,13,18,47
20210529,29MAY2021:00:00:00,UFU BORDA-MOYANO,38,24,28,32,2,62,52,10,52,10,0,9,15,7,13,14,4,0,0,6,31,15,52
20210529,29MAY2021:00:00:00,UFU DURAND,161,114,236,22,17,275,263,12,263,12,2,8,69,70,54,39,17,16,0,56,132,75,263
20210529,29MAY2021:00:00:00,UFU ELIZALDE,48,55,38,56,9,103,91,12,101,2,48,20,5,10,11,9,0,0,0,8,51,32,91
20210529,29MAY2021:00:00:00,UFU FERNANDEZ,185,133,244,51,23,318,116,202,314,4,0,7,66,96,61,55,24,9,0,27,43,46,116
20210529,29MAY2021:00:00:00,UFU FERRER,90,68,80,67,11,158,150,8,150,8,0,0,40,44,51,14,7,2,0,36,76,38,150
20210529,29MAY2021:00:00:00,UFU GRIERSON,137,131,133,57,78,268,256,12,256,12,0,15,64,73,59,39,15,3,0,59,102,95,256
20210529,29MAY2021:00:00:00,UFU GUTIERREZ,121,121,166,52,24,242,224,18,236,6,34,48,40,56,29,29,6,0,0,36,110,77,224
20210529,29MAY2021:00:00:00,UFU MUÑIZ,157,178,133,184,18,335,265,70,279,56,0,6,89,88,67,55,23,7,0,53,143,69,265
20210529,29MAY2021:00:00:00,UFU PENNA,46,20,42,17,7,66,50,16,62,4,4,9,4,14,5,19,10,1,0,16,18,16,50
20210529,29MAY2021:00:00:00,UFU PIROVANO,147,165,221,68,23,312,273,39,310,2,0,5,67,88,77,48,21,6,0,65,90,118,273
20210529,29MAY2021:00:00:00,UFU PIÑERO,93,106,121,65,13,199,193,6,195,4,0,4,54,51,36,24,23,7,0,40,93,60,193
20210529,29MAY2021:00:00:00,UFU RAMOS MEJIA,156,170,237,60,29,326,206,120,274,52,1,8,57,104,67,35,37,17,0,28,102,75,206
20210529,29MAY2021:00:00:00,UFU RIVADAVIA,99,78,136,32,9,177,167,10,169,8,0,6,41,43,29,42,10,6,0,34,55,73,167
20210529,29MAY2021:00:00:00,UFU SANTOJANNI,188,197,198,160,27,385,359,26,365,20,0,23,76,117,79,46,32,12,0,75,174,110,359
20210529,29MAY2021:00:00:00,UFU TORNU,72,58,75,35,20,130,126,4,126,4,0,5,23,43,22,24,10,3,0,27,61,36,126
20210529,29MAY2021:00:00:00,UFU VELEZ SARSFIELD,124,149,186,69,18,273,263,10,269,4,0,8,76,45,62,48,19,15,0,51,138,74,263
20210529,29MAY2021:00:00:00,UFU ZUBIZARRETA,166,86,161,81,10,252,250,2,252,0,0,10,50,57,63,41,17,14,0,39,141,70,250
20210530,30MAY2021:00:00:00,UFU ALVAREZ,128,108,203,22,11,236,210,26,214,22,5,11,50,65,56,30,13,6,0,66,78,66,210
20210530,30MAY2021:00:00:00,UFU ARGERICH,30,42,29,43,0,72,68,4,72,0,0,2,15,27,11,8,5,4,0,22,16,29,68
20210530,30MAY2021:00:00:00,UFU BORDA-MOYANO,16,18,27,3,4,34,24,10,24,10,0,2,6,6,6,8,2,4,0,1,16,7,24
20210530,30MAY2021:00:00:00,UFU DURAND,177,112,231,42,16,289,281,8,281,8,5,27,49,69,71,46,16,6,0,57,153,71,281
20210530,30MAY2021:00:00:00,UFU ELIZALDE,70,38,39,66,3,108,96,12,106,2,25,33,8,17,13,5,7,0,0,9,50,37,96
20210530,30MAY2021:00:00:00,UFU FERNANDEZ,97,84,145,29,7,181,119,62,171,10,0,4,44,47,37,26,14,9,0,34,38,46,119
20210530,30MAY2021:00:00:00,UFU FERRER,40,35,39,25,11,75,73,2,73,2,0,0,10,13,35,10,5,2,0,9,43,21,73
20210530,30MAY2021:00:00:00,UFU GRIERSON,140,114,163,61,30,254,216,38,250,4,4,9,68,57,51,44,14,7,0,56,83,77,216
20210530,30MAY2021:00:00:00,UFU GUTIERREZ,128,102,165,33,32,230,212,18,222,8,29,28,45,41,45,24,18,0,0,35,119,57,212
20210530,30MAY2021:00:00:00,UFU MUÑIZ,151,169,124,172,24,320,190,130,252,68,2,16,65,74,70,59,25,9,0,40,101,49,190
20210530,30MAY2021:00:00:00,UFU PENNA,65,43,90,17,1,108,100,8,106,2,0,7,13,26,22,25,12,3,0,22,44,34,100
20210530,30MAY2021:00:00:00,UFU PIROVANO,132,84,167,37,12,216,192,24,212,4,7,9,22,49,43,53,24,9,0,60,49,82,192
20210530,30MAY2021:00:00:00,UFU PIÑERO,115,67,127,50,5,182,172,10,180,2,0,6,43,47,32,34,17,3,0,35,90,45,172
20210530,30MAY2021:00:00:00,UFU RAMOS MEJIA,155,100,189,35,31,255,185,70,237,18,5,7,58,84,53,32,10,6,0,54,73,58,185
20210530,30MAY2021:00:00:00,UFU RIVADAVIA,108,90,141,33,24,198,174,24,176,22,0,3,74,50,28,23,10,10,0,35,59,79,174
20210530,30MAY2021:00:00:00,UFU SANTOJANNI,162,150,162,130,20,312,278,34,302,10,0,12,70,90,62,47,27,4,0,54,156,68,278
20210530,30MAY2021:00:00:00,UFU TORNU,72,58,94,26,10,130,116,14,116,14,0,0,41,28,20,26,15,0,0,23,57,36,116
20210530,30MAY2021:00:00:00,UFU VELEZ SARSFIELD,129,131,172,62,26,260,256,4,258,2,0,15,66,64,58,38,17,2,0,41,136,79,256
20210530,30MAY2021:00:00:00,UFU ZUBIZARRETA,117,102,161,56,2,219,217,2,219,0,0,4,43,32,57,42,18,23,0,34,122,61,217
20210531,31MAY2021:00:00:00,UFU ALVAREZ,242,162,303,81,20,404,360,44,376,28,8,28,107,104,66,44,31,16,0,63,191,106,360
20210531,31MAY2021:00:00:00,UFU ARGERICH,96,86,110,66,6,182,164,18,166,16,6,5,33,51,31,32,11,13,0,42,55,67,164
20210531,31MAY2021:00:00:00,UFU BORDA-MOYANO,81,33,65,48,1,114,106,8,106,8,2,3,15,31,18,24,17,4,0,18,48,40,106
20210531,31MAY2021:00:00:00,UFU DURAND,145,183,259,50,19,328,316,12,316,12,5,16,82,85,67,37,22,14,0,58,183,75,316
20210531,31MAY2021:00:00:00,UFU ELIZALDE,98,61,59,95,5,159,137,22,147,12,62,53,15,13,9,4,3,0,0,11,77,49,137
20210531,31MAY2021:00:00:00,UFU FERNANDEZ,117,76,135,53,5,193,171,22,191,2,0,3,44,51,54,28,11,2,0,28,72,71,171
20210531,31MAY2021:00:00:00,UFU FERRER,57,40,44,49,4,97,91,6,91,6,0,4,35,26,19,13,0,0,0,20,44,27,91
20210531,31MAY2021:00:00:00,UFU GRIERSON,118,162,128,147,5,280,268,12,272,8,2,11,65,60,87,34,12,9,0,73,94,101,268
20210531,31MAY2021:00:00:00,UFU GUTIERREZ,157,145,217,59,26,302,282,20,300,2,56,32,47,73,60,27,7,0,0,28,156,96,282
20210531,31MAY2021:00:00:00,UFU MUÑIZ,222,274,193,280,23,496,380,116,434,62,0,11,120,116,122,87,22,18,0,58,228,94,380
20210531,31MAY2021:00:00:00,UFU PENNA,107,97,156,40,8,204,168,36,192,12,0,4,42,73,38,24,17,6,0,31,92,45,168
20210531,31MAY2021:00:00:00,UFU PIROVANO,119,112,156,51,24,231,211,20,229,2,0,0,37,58,59,39,22,16,0,49,74,88,211
20210531,31MAY2021:00:00:00,UFU PIÑERO,147,135,180,86,16,282,262,20,268,14,0,5,75,83,47,40,24,8,0,42,155,64,262
20210531,31MAY2021:00:00:00,UFU RAMOS MEJIA,201,153,256,84,14,354,274,80,330,24,8,6,90,86,73,61,22,8,0,37,132,104,274
20210531,31MAY2021:00:00:00,UFU RIVADAVIA,194,118,223,73,16,312,264,48,294,18,0,7,89,69,60,44,30,13,0,43,51,169,264
20210531,31MAY2021:00:00:00,UFU SANTOJANNI,191,173,152,190,22,364,356,8,362,2,0,7,84,84,93,63,30,3,0,51,216,89,356
20210531,31MAY2021:00:00:00,UFU TORNU,146,109,169,69,17,255,237,18,237,18,14,22,55,55,45,48,9,7,0,41,138,57,237
20210531,31MAY2021:00:00:00,UFU VELEZ SARSFIELD,123,127,181,59,10,250,244,6,248,2,0,10,56,63,67,25,11,18,0,46,126,72,244
20210531,31MAY2021:00:00:00,UFU ZUBIZARRETA,219,149,210,147,11,368,330,38,368,0,0,15,90,78,72,55,37,21,0,50,180,100,330
20210601,01JUN2021:00:00:00,UFU ALVAREZ,188,187,273,87,15,375,365,10,367,8,21,10,83,104,81,48,14,14,0,57,204,104,365
20210601,01JUN2021:00:00:00,UFU ARGERICH,110,79,98,89,2,189,161,28,177,12,6,8,31,52,33,37,15,7,0,49,45,67,161
20210601,01JUN2021:00:00:00,UFU BORDA-MOYANO,45,29,42,25,7,74,66,8,66,8,0,4,6,5,21,30,8,0,0,3,45,18,66
20210601,01JUN2021:00:00:00,UFU DURAND,159,146,225,62,18,305,293,12,293,12,8,18,61,81,58,30,35,14,0,63,152,78,293
20210601,01JUN2021:00:00:00,UFU ELIZALDE,117,87,61,139,4,204,170,34,192,12,66,70,21,17,26,4,0,0,0,7,96,67,170
20210601,01JUN2021:00:00:00,UFU FERNANDEZ,151,101,172,67,13,252,160,92,244,8,0,4,61,60,62,36,23,6,0,26,69,64,160
20210601,01JUN2021:00:00:00,UFU FERRER,120,95,95,109,11,215,215,0,215,0,0,0,44,60,48,37,21,5,0,48,98,69,215
20210601,01JUN2021:00:00:00,UFU GRIERSON,157,133,128,152,10,290,261,29,281,9,0,10,73,78,49,49,23,8,0,53,109,99,261
20210601,01JUN2021:00:00:00,UFU GUTIERREZ,202,136,220,101,17,338,306,32,338,0,68,50,78,65,43,24,6,4,0,27,176,100,306
20210601,01JUN2021:00:00:00,UFU MUÑIZ,174,244,188,197,33,418,332,86,364,54,0,8,108,109,92,67,27,7,0,60,179,93,332
20210601,01JUN2021:00:00:00,UFU PENNA,105,70,138,37,0,175,141,34,169,6,0,5,19,47,47,32,18,7,0,39,63,39,141
20210601,01JUN2021:00:00:00,UFU PIROVANO,145,159,234,42,28,304,270,34,304,0,0,4,65,77,67,43,24,24,0,69,98,103,270
20210601,01JUN2021:00:00:00,UFU PIÑERO,128,94,149,61,12,222,214,8,216,6,4,14,52,62,35,30,21,4,0,48,75,91,214
20210601,01JUN2021:00:00:00,UFU RAMOS MEJIA,161,195,255,73,28,356,276,80,340,16,10,24,74,100,59,52,25,12,0,46,124,106,276
20210601,01JUN2021:00:00:00,UFU RIVADAVIA,224,129,231,108,14,353,333,20,347,6,0,3,96,102,49,67,24,12,0,45,76,210,333
20210601,01JUN2021:00:00:00,UFU SANTOJANNI,215,179,190,175,29,394,372,22,386,8,6,21,87,90,79,65,29,17,0,58,222,92,372
20210601,01JUN2021:00:00:00,UFU TORNU,140,139,164,91,24,279,253,26,259,20,8,14,56,66,54,50,13,18,0,39,140,70,253
20210601,01JUN2021:00:00:00,UFU VELEZ SARSFIELD,136,117,176,61,16,253,249,4,251,2,0,2,58,63,47,37,31,15,0,58,113,78,249
20210601,01JUN2021:00:00:00,UFU ZUBIZARRETA,128,121,145,96,8,249,247,2,249,0,0,4,55,68,43,42,24,13,0,39,143,65,247
20210602,02JUN2021:00:00:00,UFU ALVAREZ,249,196,313,104,28,445,425,20,427,18,23,35,99,108,90,49,32,9,0,74,226,125,425
20210602,02JUN2021:00:00:00,UFU ARGERICH,88,85,97,68,8,173,147,26,151,22,13,14,24,53,35,24,5,5,0,31,53,62,147
20210602,02JUN2021:00:00:00,UFU BORDA-MOYANO,97,22,86,31,2,119,105,14,105,14,0,0,11,18,7,40,26,17,0,5,57,43,105
20210602,02JUN2021:00:00:00,UFU DURAND,185,141,228,58,40,326,316,10,318,8,5,7,71,117,67,31,19,9,0,49,190,77,316
20210602,02JUN2021:00:00:00,UFU ELIZALDE,111,60,62,106,3,171,161,10,169,2,54,62,7,17,21,10,0,0,0,6,96,59,161
20210602,02JUN2021:00:00:00,UFU FERNANDEZ,140,119,166,67,26,259,156,103,246,13,0,1,36,82,56,47,26,11,0,22,73,61,156
20210602,02JUN2021:00:00:00,UFU FERRER,130,85,120,88,7,215,205,10,207,8,0,5,33,57,78,23,16,3,0,45,125,35,205
20210602,02JUN2021:00:00:00,UFU GRIERSON,134,149,126,135,22,283,279,4,279,4,0,16,60,65,70,54,15,3,0,60,104,115,279
20210602,02JUN2021:00:00:00,UFU GUTIERREZ,154,115,189,49,31,269,253,16,265,4,27,32,64,81,25,27,13,0,0,31,159,63,253
20210602,02JUN2021:00:00:00,UFU MUÑIZ,197,228,155,251,19,425,317,108,373,52,0,11,108,124,91,64,13,14,0,49,196,72,317
20210602,02JUN2021:00:00:00,UFU PENNA,95,81,126,42,8,176,154,22,170,6,2,7,43,41,22,21,27,13,0,20,89,45,154
20210602,02JUN2021:00:00:00,UFU PIROVANO,149,127,189,59,28,276,244,32,272,4,0,7,74,76,43,34,26,16,0,71,76,96,244
20210602,02JUN2021:00:00:00,UFU PIÑERO,85,86,117,47,7,171,163,8,165,6,0,1,38,45,38,30,12,7,0,49,60,54,163
20210602,02JUN2021:00:00:00,UFU RAMOS MEJIA,192,157,242,87,20,349,287,62,331,18,6,12,78,94,66,54,31,8,0,45,129,113,287
20210602,02JUN2021:00:00:00,UFU RIVADAVIA,198,140,238,75,25,338,232,106,242,96,0,12,115,81,49,49,28,4,0,45,79,108,232
20210602,02JUN2021:00:00:00,UFU SANTOJANNI,186,143,180,126,23,329,317,12,321,8,7,22,76,84,64,44,19,13,0,39,215,63,317
20210602,02JUN2021:00:00:00,UFU TORNU,154,128,198,45,39,282,252,30,260,22,9,19,64,74,40,42,19,15,0,39,123,87,252
20210602,02JUN2021:00:00:00,UFU VELEZ SARSFIELD,158,110,180,61,27,268,254,14,266,2,0,9,81,53,41,37,30,17,0,35,147,72,254
20210602,02JUN2021:00:00:00,UFU ZUBIZARRETA,62,48,71,39,0,110,110,0,110,0,0,2,28,38,21,3,10,8,0,10,69,31,110
20210603,03JUN2021:00:00:00,UFU ALVAREZ,218,182,267,122,11,400,390,10,390,10,14,27,87,107,72,53,35,5,0,55,234,101,390
20210603,03JUN2021:00:00:00,UFU ARGERICH,82,83,92,71,2,165,147,18,149,16,4,7,38,51,27,25,4,9,0,38,49,60,147
20210603,03JUN2021:00:00:00,UFU BORDA-MOYANO,114,71,121,60,4,185,167,18,167,18,0,0,20,38,33,35,39,20,0,8,90,69,167
20210603,03JUN2021:00:00:00,UFU DURAND,145,137,210,59,13,282,272,10,280,2,6,22,75,79,42,45,13,0,0,64,140,68,272
20210603,03JUN2021:00:00:00,UFU ELIZALDE,94,54,58,87,3,148,130,18,144,4,66,40,11,16,8,5,2,0,0,9,78,43,130
20210603,03JUN2021:00:00:00,UFU FERNANDEZ,177,126,228,55,20,303,197,106,293,10,0,2,82,89,56,35,26,13,0,21,88,88,197
20210603,03JUN2021:00:00:00,UFU FERRER,122,75,117,78,2,197,189,8,189,8,2,0,48,54,35,38,16,4,0,32,109,48,189
20210603,03JUN2021:00:00:00,UFU GRIERSON,128,102,88,124,18,230,226,4,228,2,0,22,50,60,41,43,7,7,0,38,101,87,226
20210603,03JUN2021:00:00:00,UFU GUTIERREZ,166,135,219,70,12,301,265,36,301,0,53,32,75,64,40,33,4,0,0,35,152,75,265
20210603,03JUN2021:00:00:00,UFU MUÑIZ,166,219,152,216,17,385,279,106,305,80,3,3,95,99,81,74,22,8,0,42,168,69,279
20210603,03JUN2021:00:00:00,UFU PENNA,68,66,105,26,3,134,102,32,124,10,0,3,20,43,35,15,15,3,0,9,64,29,102
20210603,03JUN2021:00:00:00,UFU PIROVANO,120,146,200,40,26,266,232,34,264,2,0,7,72,72,42,34,26,13,0,53,87,92,232
20210603,03JUN2021:00:00:00,UFU PIÑERO,60,72,98,32,2,132,124,8,126,6,0,4,47,27,20,12,14,8,0,23,52,49,124
20210603,03JUN2021:00:00:00,UFU RAMOS MEJIA,148,152,204,68,28,300,262,38,288,12,2,12,62,73,78,43,19,11,0,45,125,92,262
20210603,03JUN2021:00:00:00,UFU RIVADAVIA,138,118,170,72,14,256,190,66,200,56,0,10,69,74,46,26,19,12,0,31,67,92,190
20210603,03JUN2021:00:00:00,UFU SANTOJANNI,201,135,164,161,11,336,324,12,330,6,11,12,49,115,70,49,21,9,0,36,203,85,324
20210603,03JUN2021:00:00:00,UFU TORNU,105,111,153,52,11,216,192,24,192,24,6,18,46,38,39,50,11,8,0,24,111,55,192
20210603,03JUN2021:00:00:00,UFU VELEZ SARSFIELD,178,128,219,77,10,306,270,36,302,4,2,6,94,52,50,62,31,9,0,40,153,77,270
20210603,03JUN2021:00:00:00,UFU ZUBIZARRETA,45,27,30,42,0,72,72,0,72,0,0,2,14,27,14,9,4,2,0,6,50,16,72
20210604,04JUN2021:00:00:00,UFU ALVAREZ,214,187,280,79,42,401,383,18,383,18,20,22,120,77,62,46,35,19,0,52,232,99,383
20210604,04JUN2021:00:00:00,UFU ARGERICH,96,55,89,54,8,151,115,36,125,26,4,7,42,35,30,22,9,2,0,23,50,42,115
20210604,04JUN2021:00:00:00,UFU BORDA-MOYANO,35,46,43,31,7,81,69,12,69,12,0,10,11,17,25,5,2,11,0,4,41,24,69
20210604,04JUN2021:00:00:00,UFU DURAND,149,149,208,56,34,298,298,0,298,0,0,1,66,116,52,30,26,7,0,49,172,77,298
20210604,04JUN2021:00:00:00,UFU ELIZALDE,86,63,60,85,4,149,121,28,139,10,66,43,10,10,12,6,2,0,0,16,61,44,121
20210604,04JUN2021:00:00:00,UFU FERNANDEZ,102,80,132,37,13,182,148,34,174,8,0,9,48,46,28,18,22,11,0,17,63,68,148
20210604,04JUN2021:00:00:00,UFU FERRER,86,92,77,79,22,178,172,6,172,6,0,0,43,36,43,30,21,5,0,32,97,43,172
20210604,04JUN2021:00:00:00,UFU GRIERSON,134,98,101,112,19,232,220,12,224,8,0,16,61,64,48,17,22,4,0,29,118,73,220
20210604,04JUN2021:00:00:00,UFU GUTIERREZ,149,130,183,69,27,279,255,24,279,0,54,41,66,56,25,16,21,0,0,36,138,81,255
20210604,04JUN2021:00:00:00,UFU MUÑIZ,254,232,161,298,27,486,374,112,418,68,0,11,138,134,82,78,26,17,0,56,218,100,374
20210604,04JUN2021:00:00:00,UFU PENNA,104,80,140,35,9,184,142,42,176,8,0,7,41,48,44,29,11,4,0,33,66,43,142
20210604,04JUN2021:00:00:00,UFU PIROVANO,138,113,187,37,27,251,213,38,247,4,0,0,54,73,39,39,21,25,0,60,66,87,213
20210604,04JUN2021:00:00:00,UFU PIÑERO,124,99,150,70,3,223,217,6,219,4,0,4,41,73,47,37,14,7,0,36,129,51,217
20210604,04JUN2021:00:00:00,UFU RAMOS MEJIA,196,144,245,69,26,340,288,52,318,22,3,11,81,82,79,48,28,8,0,35,140,112,288
20210604,04JUN2021:00:00:00,UFU RIVADAVIA,110,89,133,38,28,199,195,4,197,2,0,8,53,38,48,27,16,9,0,45,69,80,195
20210604,04JUN2021:00:00:00,UFU SANTOJANNI,177,173,151,177,22,350,328,22,346,4,8,14,118,84,64,49,11,2,0,47,199,82,328
20210604,04JUN2021:00:00:00,UFU TORNU,152,131,203,52,28,283,259,24,259,24,7,20,52,82,60,44,15,3,0,35,154,68,259
20210604,04JUN2021:00:00:00,UFU VELEZ SARSFIELD,183,120,191,90,22,303,289,14,293,10,0,4,48,84,56,61,21,29,0,43,162,84,289
20210604,04JUN2021:00:00:00,UFU ZUBIZARRETA,83,85,88,68,12,168,166,2,168,0,0,3,47,32,42,26,13,5,0,18,105,43,166
20210605,05JUN2021:00:00:00,UFU ALVAREZ,129,103,171,52,9,232,216,16,218,14,9,18,60,65,48,20,9,3,0,44,109,63,216
20210605,05JUN2021:00:00:00,UFU ARGERICH,24,25,31,17,1,49,49,0,49,0,1,4,10,15,9,8,0,2,0,21,9,19,49
20210605,05JUN2021:00:00:00,UFU BORDA-MOYANO,22,20,29,13,0,42,36,6,36,6,0,7,10,12,4,7,0,2,0,4,22,10,36
20210605,05JUN2021:00:00:00,UFU DURAND,104,88,163,29,0,192,190,2,190,2,2,15,29,51,54,19,17,5,0,39,107,44,190
20210605,05JUN2021:00:00:00,UFU ELIZALDE,54,59,47,62,4,113,95,18,105,8,47,39,4,10,8,5,0,0,0,3,52,40,95
20210605,05JUN2021:00:00:00,UFU FERNANDEZ,68,45,86,18,9,113,95,18,111,2,0,2,23,29,33,17,6,3,0,16,38,41,95
20210605,05JUN2021:00:00:00,UFU FERRER,66,76,81,56,5,142,140,2,140,2,0,3,26,43,41,18,9,2,0,23,84,33,140
20210605,05JUN2021:00:00:00,UFU GRIERSON,135,105,118,90,32,240,226,14,226,14,0,2,89,47,40,33,24,5,0,36,108,82,226
20210605,05JUN2021:00:00:00,UFU GUTIERREZ,131,103,171,46,17,234,224,10,228,6,45,18,43,54,37,29,8,0,0,35,112,75,224
20210605,05JUN2021:00:00:00,UFU MUÑIZ,174,206,159,208,13,380,249,131,313,67,0,4,75,119,93,51,31,7,0,32,153,64,249
20210605,05JUN2021:00:00:00,UFU PENNA,56,35,75,10,6,91,81,10,91,0,4,0,23,14,22,14,10,4,0,10,49,22,81
20210605,05JUN2021:00:00:00,UFU PIROVANO,167,144,276,30,5,311,263,48,301,10,0,5,71,77,64,51,36,7,0,61,92,110,263
20210605,05JUN2021:00:00:00,UFU PIÑERO,124,64,133,43,12,188,188,0,188,0,0,4,59,64,40,20,0,1,0,31,99,55,188
20210605,05JUN2021:00:00:00,UFU RAMOS MEJIA,205,128,232,57,44,333,193,140,297,36,5,9,82,95,67,40,30,5,0,31,102,60,193
20210605,05JUN2021:00:00:00,UFU RIVADAVIA,102,79,140,35,6,181,167,14,173,8,0,4,54,65,22,19,5,12,0,19,102,46,167
20210605,05JUN2021:00:00:00,UFU SANTOJANNI,179,141,201,110,9,320,308,12,318,2,0,15,89,72,57,43,32,12,0,52,180,76,308
20210605,05JUN2021:00:00:00,UFU TORNU,72,84,120,30,6,156,144,12,144,12,7,5,26,46,29,32,6,5,0,19,85,40,144
20210605,05JUN2021:00:00:00,UFU VELEZ SARSFIELD,137,107,171,66,7,244,242,2,244,0,0,5,72,53,43,38,21,12,0,28,143,71,242
20210605,05JUN2021:00:00:00,UFU ZUBIZARRETA,107,89,115,81,0,196,196,0,196,0,0,10,27,58,36,31,22,12,0,31,110,55,196
20210606,06JUN2021:00:00:00,UFU ALVAREZ,136,99,185,34,16,235,227,8,227,8,7,11,58,66,47,30,15,1,0,55,107,65,227
20210606,06JUN2021:00:00:00,UFU ARGERICH,27,30,34,19,4,57,55,2,57,0,4,5,12,9,8,13,6,0,0,16,15,24,55
20210606,06JUN2021:00:00:00,UFU BORDA-MOYANO,48,30,51,25,2,78,74,4,74,4,0,0,11,19,13,10,10,15,0,3,47,24,74
20210606,06JUN2021:00:00:00,UFU DURAND,75,85,139,21,0,160,154,6,154,6,6,9,21,52,37,16,7,12,0,24,86,44,154
20210606,06JUN2021:00:00:00,UFU ELIZALDE,81,25,29,73,4,106,84,22,102,4,45,26,9,13,7,4,0,2,0,8,44,32,84
20210606,06JUN2021:00:00:00,UFU FERNANDEZ,64,53,84,29,4,117,77,40,113,4,0,3,34,42,8,17,7,6,0,21,23,33,77
20210606,06JUN2021:00:00:00,UFU FERRER,65,56,64,53,4,121,113,8,113,8,0,0,21,47,28,12,10,3,0,20,60,33,113
20210606,06JUN2021:00:00:00,UFU GRIERSON,54,82,60,49,27,136,132,4,132,4,4,9,24,40,26,21,9,3,0,33,48,51,132
20210606,06JUN2021:00:00:00,UFU GUTIERREZ,126,94,172,43,5,220,211,9,215,5,44,32,29,45,34,27,5,4,0,27,116,68,211
20210606,06JUN2021:00:00:00,UFU MUÑIZ,105,136,114,124,3,241,179,62,207,34,0,5,50,66,54,40,19,7,0,26,105,48,179
20210606,06JUN2021:00:00:00,UFU PENNA,45,29,60,14,0,74,58,16,68,6,0,3,19,16,15,15,4,2,0,9,31,18,58
20210606,06JUN2021:00:00:00,UFU PIROVANO,127,119,197,35,14,246,226,20,238,8,4,11,54,60,66,22,15,14,0,50,78,98,226
20210606,06JUN2021:00:00:00,UFU PIÑERO,64,70,89,38,7,134,128,6,132,2,0,2,26,42,37,13,8,6,0,26,68,34,128
20210606,06JUN2021:00:00:00,UFU RAMOS MEJIA,113,121,174,38,22,234,158,76,226,8,6,5,57,60,50,36,13,7,0,30,69,59,158
20210606,06JUN2021:00:00:00,UFU RIVADAVIA,64,86,108,29,13,150,138,12,142,8,0,0,46,30,18,41,7,8,0,20,78,39,138
20210606,06JUN2021:00:00:00,UFU SANTOJANNI,145,115,136,103,21,260,248,12,256,4,0,2,57,52,52,42,33,22,0,46,137,65,248
20210606,06JUN2021:00:00:00,UFU TORNU,83,56,105,23,11,139,115,24,119,20,5,14,20,34,26,18,20,2,0,15,64,36,115
20210606,06JUN2021:00:00:00,UFU VELEZ SARSFIELD,139,114,198,51,4,253,245,8,249,4,0,7,51,46,62,53,20,14,0,39,133,73,245
20210606,06JUN2021:00:00:00,UFU ZUBIZARRETA,54,37,57,34,0,91,91,0,91,0,0,3,17,28,21,10,5,7,0,15,48,28,91
20210607,07JUN2021:00:00:00,UFU ALVAREZ,204,167,278,76,17,371,330,41,336,35,11,11,98,90,76,35,30,20,0,50,182,98,330
20210607,07JUN2021:00:00:00,UFU ARGERICH,101,68,105,60,4,169,143,26,147,22,8,7,41,34,26,24,15,14,0,42,43,58,143
20210607,07JUN2021:00:00:00,UFU BORDA-MOYANO,60,27,57,28,2,87,85,2,85,2,0,7,9,21,19,15,16,0,0,4,51,30,85
20210607,07JUN2021:00:00:00,UFU DURAND,160,127,230,47,10,287,271,16,281,6,0,6,54,90,68,45,17,7,0,46,157,68,271
20210607,07JUN2021:00:00:00,UFU ELIZALDE,107,99,88,115,3,206,178,28,194,12,77,76,9,17,18,9,0,0,0,6,89,83,178
20210607,07JUN2021:00:00:00,UFU FERNANDEZ,107,98,153,36,16,205,177,28,181,24,0,6,50,57,28,37,17,10,0,35,13,129,177
20210607,07JUN2021:00:00:00,UFU FERRER,141,88,121,106,2,229,224,5,224,5,0,7,52,71,37,37,16,9,0,35,129,60,224
20210607,07JUN2021:00:00:00,UFU GRIERSON,152,110,90,166,6,262,258,4,260,2,0,15,83,69,56,19,12,8,0,34,132,92,258
20210607,07JUN2021:00:00:00,UFU GUTIERREZ,109,79,102,71,15,188,168,20,184,4,73,39,18,17,19,22,0,0,0,18,93,55,168
20210607,07JUN2021:00:00:00,UFU MUÑIZ,151,236,173,186,28,387,275,112,323,64,0,7,79,101,95,53,37,15,0,45,161,69,275
20210607,07JUN2021:00:00:00,UFU PENNA,128,111,187,46,6,239,221,18,235,4,12,16,56,56,45,39,7,8,0,25,135,61,221
20210607,07JUN2021:00:00:00,UFU PIROVANO,147,104,173,54,24,251,231,20,245,6,2,8,58,63,58,36,16,10,0,50,92,89,231
20210607,07JUN2021:00:00:00,UFU PIÑERO,118,110,127,95,6,228,198,30,220,8,0,11,68,55,29,40,16,9,0,27,122,47,198
20210607,07JUN2021:00:00:00,UFU RAMOS MEJIA,194,183,240,113,24,377,315,62,357,20,4,22,80,82,71,50,44,24,0,59,140,116,315
20210607,07JUN2021:00:00:00,UFU RIVADAVIA,193,142,206,91,38,335,292,43,312,23,0,19,79,75,67,57,28,10,0,48,117,127,292
20220225,25FEB2022:00:00:00,UFU ALVAREZ,184,138,233,59,30,322,322,0,322,0,29,20,107,66,50,30,11,9,0,5,220,97,322
20220225,25FEB2022:00:00:00,UFU ARGERICH,17,29,20,26,0,46,46,0,46,0,2,2,20,10,7,3,2,0,0,7,20,19,46
20220225,25FEB2022:00:00:00,UFU BORDA-MOYANO,35,25,33,21,6,60,60,0,60,0,0,5,12,18,11,9,4,1,0,1,35,24,60
20220225,25FEB2022:00:00:00,UFU DURAND,158,135,247,30,16,293,293,0,293,0,0,18,74,70,43,47,24,17,0,27,130,135,293
20220225,25FEB2022:00:00:00,UFU ELIZALDE,124,97,78,136,7,221,221,0,221,0,155,37,8,12,8,1,0,0,0,3,111,107,221
20220225,25FEB2022:00:00:00,UFU FERNANDEZ,78,78,110,23,24,157,157,0,157,0,4,6,38,35,18,33,13,10,0,10,84,63,157
20220225,25FEB2022:00:00:00,UFU FERRER,119,101,86,134,0,220,220,0,220,0,0,5,73,67,46,14,10,5,0,4,157,59,220
20220225,25FEB2022:00:00:00,UFU GRIERSON,69,93,97,54,11,162,162,0,162,0,0,16,52,33,34,15,9,3,0,2,119,41,162
20220225,25FEB2022:00:00:00,UFU GUTIERREZ,155,140,189,66,41,296,296,0,296,0,189,66,14,20,3,4,0,0,0,5,207,84,296
20220225,25FEB2022:00:00:00,UFU MUÑIZ,75,128,87,93,26,206,206,0,206,0,5,12,35,53,47,28,11,15,0,4,134,68,206
20220225,25FEB2022:00:00:00,UFU PENNA,88,107,92,91,12,195,195,0,195,0,35,25,26,32,40,12,13,12,0,11,140,44,195
20220225,25FEB2022:00:00:00,UFU PIROVANO,93,92,122,38,25,185,185,0,185,0,0,4,33,47,36,36,17,12,0,14,97,74,185
20220225,25FEB2022:00:00:00,UFU PIÑERO,76,88,114,39,11,164,164,0,164,0,0,30,37,29,55,4,5,4,0,2,121,41,164
20220225,25FEB2022:00:00:00,UFU RAMOS MEJIA,134,134,198,61,10,269,269,0,269,0,7,18,69,72,44,29,21,9,0,7,152,108,269
20220225,25FEB2022:00:00:00,UFU RIVADAVIA,154,109,183,45,38,266,266,0,266,0,3,5,81,69,32,37,25,14,0,18,150,98,266
20220225,25FEB2022:00:00:00,UFU SANTOJANNI,128,119,145,88,14,247,247,0,247,0,5,34,65,48,33,31,24,7,0,15,134,98,247
20220225,25FEB2022:00:00:00,UFU TORNU,79,75,106,32,16,154,154,0,154,0,11,26,31,25,33,13,7,8,0,7,72,75,154
20220225,25FEB2022:00:00:00,UFU VELEZ SARSFIELD,120,127,160,76,13,249,249,0,249,0,2,27,48,55,46,38,20,13,0,9,162,78,249
20220225,25FEB2022:00:00:00,UFU ZUBIZARRETA,94,101,108,74,13,195,195,0,195,0,0,19,33,54,38,21,16,14,0,10,87,98,195
20220226,26FEB2022:00:00:00,UFU ALVAREZ,148,91,192,21,26,239,239,0,239,0,24,17,60,36,40,22,27,13,0,9,140,90,239
20220226,26FEB2022:00:00:00,UFU ARGERICH,49,53,57,36,9,102,102,0,102,0,10,2,29,23,20,8,6,4,0,4,50,48,102
20220226,26FEB2022:00:00:00,UFU BORDA-MOYANO,28,18,17,22,7,46,46,0,46,0,0,12,10,5,9,5,5,0,0,0,35,11,46
20220226,26FEB2022:00:00:00,UFU DURAND,54,72,107,13,6,126,126,0,126,0,0,10,36,29,26,15,5,5,0,6,67,53,126
20220226,26FEB2022:00:00:00,UFU ELIZALDE,84,81,66,84,15,165,165,0,165,0,104,45,4,9,3,0,0,0,0,0,89,76,165
20220226,26FEB2022:00:00:00,UFU FERNANDEZ,54,66,100,20,0,120,120,0,120,0,0,7,43,17,13,17,11,12,0,6,69,45,120
20220226,26FEB2022:00:00:00,UFU FERRER,52,71,54,63,6,123,123,0,123,0,0,0,38,37,29,11,8,0,0,2,87,34,123
20220226,26FEB2022:00:00:00,UFU GRIERSON,67,73,98,31,11,140,140,0,140,0,0,5,51,48,20,14,2,0,0,1,108,31,140
20220226,26FEB2022:00:00:00,UFU GUTIERREZ,176,164,227,93,23,343,343,0,343,0,199,93,7,20,15,3,6,0,0,6,228,109,343
20220226,26FEB2022:00:00:00,UFU MUÑIZ,109,86,90,91,14,195,195,0,195,0,9,17,33,54,35,26,13,8,0,3,133,59,195
20220226,26FEB2022:00:00:00,UFU PENNA,105,68,73,92,8,173,173,0,173,0,30,40,27,41,25,2,8,0,0,1,127,45,173
20220226,26FEB2022:00:00:00,UFU PIROVANO,92,82,123,27,24,174,174,0,174,0,2,11,39,36,43,13,16,14,0,12,92,70,174
20220226,26FEB2022:00:00:00,UFU PIÑERO,79,83,137,20,5,162,162,0,162,0,2,15,62,33,26,17,5,2,0,10,112,39,162
20220226,26FEB2022:00:00:00,UFU RAMOS MEJIA,115,148,183,63,17,263,263,0,263,0,30,8,48,60,46,39,17,15,0,6,184,73,263
20220226,26FEB2022:00:00:00,UFU RIVADAVIA,150,117,183,62,24,269,269,0,269,0,2,8,79,69,54,38,11,8,0,11,145,113,269
20220226,26FEB2022:00:00:00,UFU SANTOJANNI,98,100,103,83,12,198,198,0,198,0,0,18,44,42,35,22,20,17,0,14,98,86,198
20220226,26FEB2022:00:00:00,UFU TORNU,84,71,124,22,9,155,155,0,155,0,4,22,30,28,28,15,9,19,0,8,76,71,155
20220226,26FEB2022:00:00:00,UFU VELEZ SARSFIELD,105,128,151,68,14,233,233,0,233,0,0,7,61,77,32,18,19,19,0,6,153,74,233
20220226,26FEB2022:00:00:00,UFU ZUBIZARRETA,87,103,109,73,8,190,190,0,190,0,0,13,49,49,33,10,23,13,0,8,86,96,190
20220227,27FEB2022:00:00:00,UFU ALVAREZ,106,116,190,18,14,222,222,0,222,0,20,19,55,52,35,21,9,11,0,4,149,69,222
20220227,27FEB2022:00:00:00,UFU ARGERICH,46,63,70,39,0,109,109,0,109,0,1,8,20,20,19,15,10,16,0,1,55,53,109
20220227,27FEB2022:00:00:00,UFU BORDA-MOYANO,35,27,29,26,7,62,62,0,62,0,0,6,11,20,12,9,1,3,0,2,42,18,62
20220227,27FEB2022:00:00:00,UFU DURAND,64,86,131,17,2,150,150,0,150,0,0,5,35,43,28,13,14,12,0,16,70,64,150
20220227,27FEB2022:00:00:00,UFU ELIZALDE,85,81,85,77,4,166,166,0,166,0,108,38,3,5,11,1,0,0,0,2,88,76,166
20220227,27FEB2022:00:00:00,UFU FERNANDEZ,58,63,93,24,4,121,121,0,121,0,0,9,31,25,24,10,14,8,0,4,72,45,121
20220227,27FEB2022:00:00:00,UFU FERRER,29,42,33,36,2,71,71,0,71,0,0,0,18,18,16,9,5,5,0,2,52,17,71
20220227,27FEB2022:00:00:00,UFU GRIERSON,81,87,90,58,20,168,168,0,168,0,0,15,37,43,30,20,13,10,0,4,114,50,168
20220227,27FEB2022:00:00:00,UFU GUTIERREZ,178,158,215,102,21,338,338,0,338,0,219,75,0,16,21,7,0,0,0,8,229,101,338
20220227,27FEB2022:00:00:00,UFU MUÑIZ,71,76,71,61,16,148,148,0,148,0,4,12,32,23,30,32,6,9,0,5,102,41,148
20220227,27FEB2022:00:00:00,UFU PENNA,47,70,78,29,10,117,117,0,117,0,1,10,21,34,19,7,16,9,0,6,83,28,117
20220227,27FEB2022:00:00:00,UFU PIROVANO,85,89,126,33,16,175,175,0,175,0,13,8,27,55,30,18,16,8,0,11,85,79,175
20220227,27FEB2022:00:00:00,UFU PIÑERO,77,85,121,32,9,162,162,0,162,0,0,15,47,40,22,21,17,0,0,2,116,42,162
20220227,27FEB2022:00:00:00,UFU RAMOS MEJIA,95,108,137,36,30,203,203,0,203,0,12,16,53,45,25,22,19,11,0,5,145,51,203
20220227,27FEB2022:00:00:00,UFU RIVADAVIA,86,85,127,32,12,171,171,0,171,0,0,6,49,44,23,15,11,23,0,5,98,68,171
20220227,27FEB2022:00:00:00,UFU SANTOJANNI,66,69,67,58,10,135,135,0,135,0,0,16,27,35,27,12,12,6,0,8,65,62,135
20220227,27FEB2022:00:00:00,UFU TORNU,63,68,108,10,13,131,131,0,131,0,7,19,14,34,28,8,16,5,0,2,87,42,131
20220227,27FEB2022:00:00:00,UFU VELEZ SARSFIELD,81,102,101,72,10,183,183,0,183,0,0,20,36,41,46,20,15,5,0,11,112,60,183
20220227,27FEB2022:00:00:00,UFU ZUBIZARRETA,78,88,129,34,3,166,166,0,166,0,0,14,18,27,50,24,15,18,0,9,77,80,166
20220228,28FEB2022:00:00:00,UFU ALVAREZ,195,176,326,23,22,371,371,0,371,0,26,33,55,62,67,51,42,35,0,8,244,119,371
20220228,28FEB2022:00:00:00,UFU ARGERICH,59,56,89,26,0,115,115,0,115,0,6,5,34,20,17,18,9,6,0,5,55,55,115
20220228,28FEB2022:00:00:00,UFU BORDA-MOYANO,56,67,65,52,6,123,123,0,123,0,1,10,47,13,26,16,7,3,0,6,76,40,123
20220228,28FEB2022:00:00:00,UFU DURAND,134,77,182,17,12,211,211,0,211,0,0,13,32,61,27,40,17,21,0,15,112,84,211
20220228,28FEB2022:00:00:00,UFU ELIZALDE,156,155,146,156,10,312,312,0,312,0,200,90,4,12,2,2,2,0,0,7,165,140,312
20220228,28FEB2022:00:00:00,UFU FERNANDEZ,69,65,104,17,14,135,135,0,135,0,1,5,37,42,20,12,9,9,0,8,49,78,135
20220228,28FEB2022:00:00:00,UFU FERRER,133,139,127,131,14,272,272,0,272,0,0,3,73,89,56,22,20,9,0,3,191,78,272
20220228,28FEB2022:00:00:00,UFU GRIERSON,87,95,97,81,4,182,182,0,182,0,0,16,25,48,34,30,20,9,0,0,136,46,182
20220228,28FEB2022:00:00:00,UFU GUTIERREZ,234,218,289,131,32,452,452,0,452,0,293,101,19,17,17,5,0,0,0,6,305,141,452
20220424,24APR2022:00:00:00,UFU VELEZ SARSFIELD,60,33,77,8,8,93,93,0,93,0,0,2,13,24,24,20,3,7,0,15,36,42,93
20220424,24APR2022:00:00:00,UFU ZUBIZARRETA,70,33,79,22,3,104,104,0,104,0,1,16,7,16,17,18,9,20,0,5,52,47,104
20220425,25APR2022:00:00:00,UFU ALVAREZ,73,62,122,9,4,135,135,0,135,0,11,9,22,26,30,16,11,10,0,14,67,54,135
20220425,25APR2022:00:00:00,UFU ARGERICH,36,32,49,19,0,68,68,0,68,0,0,4,17,20,7,9,4,7,0,3,33,32,68
20220425,25APR2022:00:00:00,UFU DURAND,77,47,107,9,10,126,126,0,126,0,2,8,13,30,29,28,8,8,0,11,61,54,126
20220425,25APR2022:00:00:00,UFU FERNANDEZ,38,25,56,2,5,63,63,0,63,0,0,3,7,13,13,12,6,9,0,6,35,22,63
20220425,25APR2022:00:00:00,UFU GUTIERREZ,104,95,102,84,13,199,199,0,199,0,112,57,6,9,9,4,2,0,0,15,99,85,199
20220425,25APR2022:00:00:00,UFU MUÑIZ,67,49,52,59,5,116,116,0,116,0,3,11,19,20,21,19,18,5,0,9,54,53,116
20220425,25APR2022:00:00:00,UFU PIROVANO,147,97,195,26,23,244,244,0,244,0,0,24,41,60,56,30,19,14,0,29,108,107,244
20220425,25APR2022:00:00:00,UFU PIÑERO,25,24,37,10,2,49,49,0,49,0,0,2,4,17,16,4,4,2,0,1,24,24,49
20220425,25APR2022:00:00:00,UFU RAMOS MEJIA,66,54,85,30,5,120,120,0,120,0,0,1,24,29,18,18,12,18,0,8,66,46,120
20220425,25APR2022:00:00:00,UFU RIVADAVIA,163,122,208,49,28,285,285,0,285,0,0,6,66,67,40,46,42,18,0,14,149,121,285
20220425,25APR2022:00:00:00,UFU SANTOJANNI,46,48,60,30,4,94,94,0,94,0,0,5,10,18,28,20,10,3,0,10,44,39,94
20220425,25APR2022:00:00:00,UFU TORNU,54,47,86,12,3,101,101,0,101,0,11,17,10,28,14,7,9,5,0,6,46,49,101
20220425,25APR2022:00:00:00,UFU VELEZ SARSFIELD,73,47,96,16,8,120,120,0,120,0,0,9,24,25,15,20,16,11,0,9,54,57,120
20220425,25APR2022:00:00:00,UFU ZUBIZARRETA,53,21,51,18,5,74,74,0,74,0,0,4,3,24,12,11,11,9,0,11,36,27,74
20220426,26APR2022:00:00:00,UFU ALVAREZ,102,54,123,23,15,161,161,0,161,0,15,13,24,31,23,25,20,10,0,20,72,69,161
20220426,26APR2022:00:00:00,UFU ARGERICH,14,24,22,14,6,42,42,0,42,0,4,4,7,15,5,0,7,0,0,1,24,17,42
20220426,26APR2022:00:00:00,UFU DURAND,84,39,94,16,14,124,124,0,124,0,1,9,25,29,27,13,14,6,0,22,53,49,124
20220426,26APR2022:00:00:00,UFU FERNANDEZ,33,17,34,11,10,55,55,0,55,0,5,3,7,11,7,11,2,9,0,4,26,25,55
20220426,26APR2022:00:00:00,UFU GUTIERREZ,100,80,126,40,18,184,184,0,184,0,111,66,0,3,2,2,0,0,0,11,92,81,184
20220426,26APR2022:00:00:00,UFU MUÑIZ,56,41,33,56,9,98,98,0,98,0,4,5,16,27,30,14,0,2,0,6,46,46,98
20220426,26APR2022:00:00:00,UFU PENNA,0,4,4,0,0,4,4,0,4,0,0,0,0,2,0,2,0,0,0,0,2,2,4
20220426,26APR2022:00:00:00,UFU PIROVANO,91,57,114,23,12,149,149,0,149,0,1,4,17,47,19,27,17,17,0,25,54,70,149
20220426,26APR2022:00:00:00,UFU PIÑERO,11,12,13,6,6,25,25,0,25,0,2,4,7,3,1,6,1,1,0,1,15,9,25
20220426,26APR2022:00:00:00,UFU RAMOS MEJIA,67,49,88,17,14,119,119,0,119,0,3,2,29,26,26,15,14,4,0,9,62,48,119
20220426,26APR2022:00:00:00,UFU RIVADAVIA,139,62,158,26,25,209,209,0,209,0,8,2,51,54,24,27,27,16,0,13,102,93,209
20220426,26APR2022:00:00:00,UFU SANTOJANNI,60,55,78,27,10,115,115,0,115,0,0,14,16,22,25,18,14,6,0,29,36,47,115
20220426,26APR2022:00:00:00,UFU TORNU,51,49,79,17,5,101,101,0,101,0,4,15,10,19,14,20,11,8,0,13,36,52,101
20220426,26APR2022:00:00:00,UFU VELEZ SARSFIELD,100,50,119,17,14,150,150,0,150,0,2,10,22,39,31,24,10,12,0,15,61,74,150
20220426,26APR2022:00:00:00,UFU ZUBIZARRETA,28,24,31,16,12,59,59,0,59,0,7,7,11,6,9,13,5,1,0,13,20,26,59
20220427,27APR2022:00:00:00,UFU ALVAREZ,73,46,104,13,2,119,119,0,119,0,7,4,26,16,17,20,14,15,0,16,55,48,119
20220427,27APR2022:00:00:00,UFU ARGERICH,20,19,31,5,3,39,39,0,39,0,0,5,5,13,9,2,4,1,0,1,22,16,39
20220427,27APR2022:00:00:00,UFU DURAND,56,47,96,7,0,103,103,0,103,0,0,10,24,18,14,14,19,4,0,16,43,44,103
20220427,27APR2022:00:00:00,UFU FERNANDEZ,32,46,64,2,12,78,78,0,78,0,0,4,22,16,21,7,5,3,0,8,36,34,78
20220427,27APR2022:00:00:00,UFU GUTIERREZ,89,99,124,55,10,189,189,0,189,0,140,35,0,4,4,6,0,0,0,9,97,83,189
20220427,27APR2022:00:00:00,UFU MUÑIZ,87,81,91,63,14,168,168,0,168,0,10,4,31,33,34,29,15,12,0,3,94,71,168
20220427,27APR2022:00:00:00,UFU PENNA,6,9,8,4,3,15,15,0,15,0,0,1,4,4,3,0,1,2,0,2,6,7,15
20220427,27APR2022:00:00:00,UFU PIROVANO,157,76,187,21,27,235,235,0,235,0,2,16,38,59,59,21,22,18,0,31,101,103,235
20220427,27APR2022:00:00:00,UFU PIÑERO,19,20,33,2,4,39,39,0,39,0,0,2,10,9,8,8,1,1,0,6,15,18,39
20220427,27APR2022:00:00:00,UFU RAMOS MEJIA,64,43,87,14,6,107,107,0,107,0,0,3,20,25,14,16,21,8,0,7,57,43,107
20220427,27APR2022:00:00:00,UFU RIVADAVIA,114,114,179,23,27,229,229,0,229,0,1,10,44,45,33,29,31,36,0,22,107,100,229
20220427,27APR2022:00:00:00,UFU SANTOJANNI,76,32,76,18,14,108,108,0,108,0,0,4,21,24,23,9,15,12,0,22,48,38,108
20220427,27APR2022:00:00:00,UFU TORNU,67,42,100,1,8,109,109,0,109,0,4,18,14,10,28,19,11,5,0,15,41,52,109
20220427,27APR2022:00:00:00,UFU VELEZ SARSFIELD,79,58,120,12,5,137,137,0,137,0,0,3,27,27,19,34,8,19,0,26,51,60,137
20220427,27APR2022:00:00:00,UFU ZUBIZARRETA,40,28,40,20,9,69,69,0,69,0,1,6,12,16,15,11,6,2,0,7,33,29,69
20220428,28APR2022:00:00:00,UFU ALVAREZ,69,57,101,17,11,129,129,0,129,0,5,12,19,23,27,18,9,16,0,12,67,50,129
20220428,28APR2022:00:00:00,UFU ARGERICH,27,5,18,9,5,32,32,0,32,0,0,3,7,10,2,3,4,3,0,2,11,19,32
20220428,28APR2022:00:00:00,UFU DURAND,65,31,90,0,6,96,96,0,96,0,0,3,24,16,18,15,15,5,0,18,42,36,96
20220428,28APR2022:00:00:00,UFU FERNANDEZ,40,33,53,1,19,73,73,0,73,0,0,0,16,17,17,5,12,6,0,10,34,29,73
20220428,28APR2022:00:00:00,UFU GUTIERREZ,74,96,101,61,14,176,176,0,176,0,137,30,3,2,2,2,0,0,0,10,88,78,176
20220428,28APR2022:00:00:00,UFU MUÑIZ,70,75,70,56,23,149,149,0,149,0,7,3,41,32,25,20,6,15,0,5,89,55,149
20220428,28APR2022:00:00:00,UFU PENNA,12,8,16,4,2,22,22,0,22,0,2,2,1,6,7,2,2,0,0,4,8,10,22
20220428,28APR2022:00:00:00,UFU PIROVANO,118,73,158,16,18,192,192,0,192,0,1,18,21,36,59,29,14,14,0,31,87,74,192
20220428,28APR2022:00:00:00,UFU PIÑERO,19,22,33,6,2,41,41,0,41,0,0,3,10,11,1,6,8,2,0,4,20,17,41
20220428,28APR2022:00:00:00,UFU RAMOS MEJIA,56,37,69,15,9,93,93,0,93,0,0,0,12,30,25,8,11,7,0,11,51,31,93
20220428,28APR2022:00:00:00,UFU RIVADAVIA,178,100,211,42,26,279,279,0,279,0,1,14,55,73,41,44,22,29,0,29,136,114,279
20220428,28APR2022:00:00:00,UFU SANTOJANNI,53,36,58,24,7,89,89,0,89,0,0,4,10,30,11,16,10,8,0,24,34,31,89
20220428,28APR2022:00:00:00,UFU TORNU,66,39,94,8,3,105,105,0,105,0,4,12,14,25,6,27,9,8,0,19,39,47,105
20220428,28APR2022:00:00:00,UFU VELEZ SARSFIELD,76,63,119,15,6,140,140,0,140,0,1,11,21,34,30,23,7,13,0,19,56,65,140
20220428,28APR2022:00:00:00,UFU ZUBIZARRETA,53,34,63,15,10,88,88,0,88,0,1,7,16,21,14,10,12,7,0,18,29,41,88
20220429,29APR2022:00:00:00,UFU ALVAREZ,74,35,95,7,7,109,109,0,109,0,4,11,12,21,20,25,8,8,0,21,51,37,109
20220429,29APR2022:00:00:00,UFU ARGERICH,21,16,19,14,4,37,37,0,37,0,0,0,4,14,8,4,3,4,0,2,17,18,37
20220429,29APR2022:00:00:00,UFU DURAND,65,40,88,4,13,105,105,0,105,0,0,6,19,18,27,11,17,7,0,17,54,34,105
20220429,29APR2022:00:00:00,UFU FERNANDEZ,20,16,25,1,10,36,36,0,36,0,0,1,6,8,7,4,7,3,0,10,21,5,36
20220429,29APR2022:00:00:00,UFU GUTIERREZ,59,45,69,31,4,104,104,0,104,0,72,25,4,1,0,2,0,0,0,7,64,33,104
20220429,29APR2022:00:00:00,UFU MUÑIZ,45,45,43,35,12,90,90,0,90,0,3,5,28,23,11,11,6,3,0,4,49,37,90
20220228,28FEB2022:00:00:00,UFU MUÑIZ,112,131,116,113,16,245,245,0,245,0,13,17,41,50,66,26,24,8,0,5,163,76,245
20220228,28FEB2022:00:00:00,UFU PENNA,177,107,147,127,10,284,284,0,284,0,27,34,62,77,43,28,6,7,0,4,188,92,284
20220228,28FEB2022:00:00:00,UFU PIROVANO,111,84,133,31,31,195,195,0,195,0,0,4,48,51,29,32,15,16,0,9,105,81,195
20220228,28FEB2022:00:00:00,UFU PIÑERO,81,69,120,25,5,150,150,0,150,0,0,9,45,33,35,17,1,10,0,5,104,41,150
20220228,28FEB2022:00:00:00,UFU RAMOS MEJIA,175,149,250,38,37,325,325,0,325,0,39,37,75,61,50,28,21,14,0,5,166,154,325
20220228,28FEB2022:00:00:00,UFU RIVADAVIA,196,126,218,68,38,324,324,0,324,0,2,17,94,83,40,34,26,28,0,16,178,130,324
20220228,28FEB2022:00:00:00,UFU SANTOJANNI,127,142,171,89,10,270,270,0,270,0,11,40,59,60,38,27,26,9,0,9,135,123,270
20220228,28FEB2022:00:00:00,UFU TORNU,79,90,149,15,5,169,169,0,169,0,12,16,26,48,19,19,5,24,0,7,101,61,169
20220228,28FEB2022:00:00:00,UFU VELEZ SARSFIELD,164,136,223,57,20,300,300,0,300,0,0,22,54,83,78,23,22,18,0,11,198,91,300
20220228,28FEB2022:00:00:00,UFU ZUBIZARRETA,121,107,136,80,13,229,229,0,229,0,1,16,35,55,32,46,23,21,0,12,106,111,229
20220301,01MAR2022:00:00:00,UFU ALVAREZ,205,177,298,53,31,382,382,0,382,0,22,34,81,78,61,22,50,34,0,5,249,128,382
20220301,01MAR2022:00:00:00,UFU ARGERICH,62,39,42,56,3,101,101,0,101,0,5,8,28,20,16,15,7,2,0,4,52,45,101
20220301,01MAR2022:00:00:00,UFU BORDA-MOYANO,60,50,57,49,4,110,110,0,110,0,3,11,33,21,16,18,7,1,0,3,65,42,110
20220301,01MAR2022:00:00:00,UFU DURAND,114,104,194,9,15,218,218,0,218,0,0,13,52,48,43,30,18,14,0,19,112,87,218
20220301,01MAR2022:00:00:00,UFU ELIZALDE,84,59,41,98,4,143,143,0,143,0,59,65,4,10,2,3,0,0,0,2,77,64,143
20220301,01MAR2022:00:00:00,UFU FERNANDEZ,113,97,159,22,30,211,211,0,211,0,3,13,65,36,43,21,22,8,0,4,118,89,211
20220301,01MAR2022:00:00:00,UFU FERRER,151,131,136,136,10,282,282,0,282,0,0,5,80,81,49,37,18,12,0,2,200,80,282
20220301,01MAR2022:00:00:00,UFU GRIERSON,77,100,107,62,8,177,177,0,177,0,0,16,50,50,29,27,3,2,0,1,125,51,177
20220301,01MAR2022:00:00:00,UFU GUTIERREZ,231,205,283,135,18,436,436,0,436,0,238,146,1,13,32,4,2,0,0,5,307,124,436
20220301,01MAR2022:00:00:00,UFU MUÑIZ,125,128,123,117,14,254,254,0,254,0,8,25,73,42,49,40,10,7,0,0,183,71,254
20220301,01MAR2022:00:00:00,UFU PENNA,131,103,142,89,6,237,237,0,237,0,2,28,75,60,21,29,19,3,0,3,177,57,237
20220301,01MAR2022:00:00:00,UFU PIROVANO,157,155,259,30,23,312,312,0,312,0,2,17,74,72,70,33,23,21,0,21,124,167,312
20220301,01MAR2022:00:00:00,UFU PIÑERO,141,120,214,37,10,261,261,0,261,0,3,22,65,67,42,31,22,9,0,3,185,72,261
20220301,01MAR2022:00:00:00,UFU RAMOS MEJIA,240,129,283,39,47,369,369,0,369,0,33,29,73,76,63,46,24,25,0,18,216,135,369
20220301,01MAR2022:00:00:00,UFU RIVADAVIA,192,174,256,74,37,367,367,0,367,0,1,13,105,96,57,37,33,25,0,10,208,149,367
20220301,01MAR2022:00:00:00,UFU SANTOJANNI,157,165,161,142,19,322,322,0,322,0,5,45,82,58,53,33,26,20,0,8,157,156,322
20220301,01MAR2022:00:00:00,UFU TORNU,168,152,278,27,15,320,320,0,320,0,30,61,41,67,64,25,17,15,0,14,197,109,320
20220301,01MAR2022:00:00:00,UFU VELEZ SARSFIELD,215,183,281,93,24,398,398,0,398,0,0,19,85,81,88,67,39,19,0,8,269,121,398
20220301,01MAR2022:00:00:00,UFU ZUBIZARRETA,158,175,216,95,24,335,335,0,335,0,2,24,59,80,49,50,42,29,0,18,142,175,335
20220302,02MAR2022:00:00:00,UFU ALVAREZ,319,291,441,101,69,611,611,0,611,0,58,46,151,115,101,67,53,20,0,12,394,205,611
20220302,02MAR2022:00:00:00,UFU ARGERICH,68,53,63,54,4,121,121,0,121,0,16,8,16,23,22,26,7,3,0,7,55,57,121
20220302,02MAR2022:00:00:00,UFU BORDA-MOYANO,91,79,99,67,4,170,170,0,170,0,8,16,37,47,38,18,6,0,0,1,100,68,170
20220302,02MAR2022:00:00:00,UFU DURAND,191,194,337,39,9,385,385,0,385,0,0,24,96,114,62,35,27,27,0,18,218,149,385
20220302,02MAR2022:00:00:00,UFU ELIZALDE,155,181,143,187,10,340,340,0,340,0,219,110,1,8,1,1,0,0,0,1,176,163,340
20220302,02MAR2022:00:00:00,UFU FERNANDEZ,169,126,201,35,59,295,295,0,295,0,0,9,86,86,53,38,13,10,0,3,157,135,295
20220302,02MAR2022:00:00:00,UFU FERRER,177,197,147,193,34,374,374,0,374,0,0,6,119,108,60,52,24,5,0,12,266,96,374
20220302,02MAR2022:00:00:00,UFU GRIERSON,178,131,191,104,15,310,310,0,310,0,1,24,107,81,38,38,12,9,0,4,220,86,310
20220302,02MAR2022:00:00:00,UFU GUTIERREZ,269,313,394,139,49,582,582,0,582,0,323,184,9,12,35,9,7,3,0,5,397,180,582
20220302,02MAR2022:00:00:00,UFU MUÑIZ,193,221,212,159,43,414,414,0,414,0,5,29,99,91,81,69,30,10,0,2,303,108,414
20220302,02MAR2022:00:00:00,UFU PENNA,205,154,187,163,9,359,359,0,359,0,35,33,96,100,50,26,9,10,0,3,265,90,359
20220302,02MAR2022:00:00:00,UFU PIROVANO,240,162,291,38,73,402,402,0,402,0,0,15,93,135,56,50,41,12,0,12,215,175,402
20220302,02MAR2022:00:00:00,UFU PIÑERO,229,186,304,94,18,416,416,0,416,0,4,22,119,102,68,55,20,26,0,5,304,107,416
20220302,02MAR2022:00:00:00,UFU RAMOS MEJIA,213,245,317,89,52,458,458,0,458,0,4,18,124,136,76,28,41,31,0,14,225,219,458
20220302,02MAR2022:00:00:00,UFU RIVADAVIA,302,276,449,80,50,579,579,0,579,0,1,5,198,153,74,61,63,24,0,13,310,254,579
20220302,02MAR2022:00:00:00,UFU SANTOJANNI,183,188,200,151,20,371,371,0,371,0,15,42,60,90,54,49,28,33,0,27,161,183,371
20220302,02MAR2022:00:00:00,UFU TORNU,213,234,361,74,12,447,447,0,447,0,40,38,92,108,76,27,39,27,0,6,291,149,447
20220302,02MAR2022:00:00:00,UFU VELEZ SARSFIELD,254,213,320,123,25,468,468,0,468,0,1,30,123,132,95,39,32,16,0,8,311,149,468
20220302,02MAR2022:00:00:00,UFU ZUBIZARRETA,158,171,186,115,28,329,329,0,329,0,0,15,104,64,62,45,19,20,0,17,148,164,329
20220303,03MAR2022:00:00:00,UFU ALVAREZ,326,298,446,143,35,624,624,0,624,0,77,63,202,135,46,47,23,31,0,8,386,230,624
20220303,03MAR2022:00:00:00,UFU ARGERICH,82,60,73,61,8,142,142,0,142,0,2,8,30,39,27,23,13,0,0,7,66,66,142
20220303,03MAR2022:00:00:00,UFU BORDA-MOYANO,48,72,66,50,4,120,120,0,120,0,2,16,18,20,34,19,11,0,0,5,67,47,120
20220303,03MAR2022:00:00:00,UFU DURAND,197,174,315,47,9,371,371,0,371,0,0,24,103,105,72,36,18,13,0,11,198,162,371
20220303,03MAR2022:00:00:00,UFU ELIZALDE,183,129,129,177,7,313,313,0,313,0,202,79,7,18,5,0,1,1,0,1,167,145,313
20220303,03MAR2022:00:00:00,UFU FERNANDEZ,208,157,245,49,71,365,365,0,365,0,0,10,130,101,50,33,32,9,0,6,199,160,365
20220303,03MAR2022:00:00:00,UFU FERRER,170,171,144,175,22,341,341,0,341,0,0,0,132,91,79,22,7,10,0,8,247,86,341
20220303,03MAR2022:00:00:00,UFU GRIERSON,119,89,153,44,11,208,208,0,208,0,0,13,73,48,20,24,20,10,0,2,153,53,208
20220303,03MAR2022:00:00:00,UFU GUTIERREZ,276,225,323,138,41,502,502,0,502,0,292,140,9,20,25,16,0,0,0,13,330,159,502
20220303,03MAR2022:00:00:00,UFU MUÑIZ,199,213,193,187,32,412,412,0,412,0,7,34,113,70,81,67,34,6,0,4,292,116,412
20220303,03MAR2022:00:00:00,UFU PENNA,144,129,140,127,6,273,273,0,273,0,23,20,76,72,42,26,12,2,0,2,201,70,273
20220303,03MAR2022:00:00:00,UFU PIROVANO,220,210,299,74,57,430,430,0,430,0,0,28,118,146,71,32,20,15,0,11,242,177,430
20220303,03MAR2022:00:00:00,UFU PIÑERO,163,151,232,63,21,316,316,0,316,0,2,28,100,96,52,16,16,6,0,4,233,78,316
20220303,03MAR2022:00:00:00,UFU RAMOS MEJIA,307,230,399,93,45,537,537,0,537,0,2,27,148,138,90,78,29,25,0,5,370,162,537
20220303,03MAR2022:00:00:00,UFU RIVADAVIA,202,149,263,51,41,355,355,0,355,0,4,16,102,119,44,30,29,11,0,14,192,149,355
20220303,03MAR2022:00:00:00,UFU SANTOJANNI,204,192,214,160,22,396,396,0,396,0,3,44,111,91,62,39,35,11,0,18,223,155,396
20220429,29APR2022:00:00:00,UFU PENNA,24,7,25,7,0,32,32,0,32,0,0,5,8,4,4,4,2,5,0,3,19,10,32
20220429,29APR2022:00:00:00,UFU PIROVANO,160,77,190,24,23,237,237,0,237,0,0,10,44,65,53,27,23,15,0,45,81,111,237
20220429,29APR2022:00:00:00,UFU PIÑERO,18,20,28,1,9,38,38,0,38,0,0,6,4,13,6,3,4,2,0,10,15,13,38
20220429,29APR2022:00:00:00,UFU RAMOS MEJIA,60,31,81,2,8,91,91,0,91,0,1,2,6,25,21,13,4,19,0,15,46,30,91
20220429,29APR2022:00:00:00,UFU RIVADAVIA,154,116,193,42,35,270,270,0,270,0,1,4,56,60,49,34,41,25,0,27,138,105,270
20220429,29APR2022:00:00:00,UFU SANTOJANNI,75,43,81,32,5,118,118,0,118,0,0,12,6,21,39,19,14,7,0,30,40,48,118
20220429,29APR2022:00:00:00,UFU TORNU,60,51,90,5,17,112,112,0,112,0,5,11,8,35,31,13,2,7,0,9,57,46,112
20220429,29APR2022:00:00:00,UFU VELEZ SARSFIELD,52,53,90,5,10,105,105,0,105,0,0,12,15,4,21,21,16,16,0,19,36,50,105
20220429,29APR2022:00:00:00,UFU ZUBIZARRETA,44,24,44,16,8,68,68,0,68,0,0,9,8,17,10,6,10,8,0,14,36,18,68
20220430,30APR2022:00:00:00,UFU ALVAREZ,49,43,80,5,7,92,92,0,92,0,0,3,8,14,24,15,20,8,0,20,44,28,92
20220430,30APR2022:00:00:00,UFU DURAND,40,56,92,1,3,96,96,0,96,0,0,1,12,26,24,11,14,8,0,25,44,27,96
20220430,30APR2022:00:00:00,UFU GUTIERREZ,61,42,76,25,2,103,103,0,103,0,59,37,0,2,5,0,0,0,0,10,43,49,103
20220430,30APR2022:00:00:00,UFU MUÑIZ,32,71,49,41,13,103,103,0,103,0,0,8,14,22,25,20,8,6,0,7,63,33,103
20220430,30APR2022:00:00:00,UFU PIROVANO,116,90,166,17,23,206,206,0,206,0,0,9,19,45,50,35,26,22,0,49,88,69,206
20220430,30APR2022:00:00:00,UFU PIÑERO,27,12,35,4,0,39,39,0,39,0,0,1,7,7,10,3,10,1,0,5,25,9,39
20220430,30APR2022:00:00:00,UFU RAMOS MEJIA,67,35,83,5,15,103,103,0,103,0,9,7,10,24,26,12,9,6,0,17,43,43,103
20220430,30APR2022:00:00:00,UFU RIVADAVIA,141,89,175,31,25,231,231,0,231,0,1,2,36,42,56,48,29,17,0,24,103,104,231
20220430,30APR2022:00:00:00,UFU SANTOJANNI,61,54,73,29,13,115,115,0,115,0,0,4,7,36,20,27,12,9,0,23,55,37,115
20220430,30APR2022:00:00:00,UFU TORNU,25,7,31,1,0,32,32,0,32,0,0,7,6,2,3,10,3,1,0,3,8,21,32
20220430,30APR2022:00:00:00,UFU VELEZ SARSFIELD,89,61,116,18,16,150,150,0,150,0,0,8,27,21,36,34,18,6,0,21,56,73,150
20220430,30APR2022:00:00:00,UFU ZUBIZARRETA,64,50,91,14,9,114,114,0,114,0,0,21,11,16,34,17,12,3,0,22,54,38,114
20220501,01MAY2022:00:00:00,UFU ALVAREZ,75,55,107,12,11,130,130,0,130,0,8,18,17,12,29,25,13,8,0,21,62,47,130
20220501,01MAY2022:00:00:00,UFU DURAND,33,22,50,0,5,55,55,0,55,0,0,3,7,21,9,5,9,1,0,20,22,13,55
20220501,01MAY2022:00:00:00,UFU GUTIERREZ,45,45,67,17,6,90,90,0,90,0,38,45,1,2,0,0,4,0,0,16,33,41,90
20220501,01MAY2022:00:00:00,UFU MUÑIZ,41,37,35,36,7,78,78,0,78,0,0,2,19,15,14,19,8,1,0,5,46,27,78
20220501,01MAY2022:00:00:00,UFU PIROVANO,115,68,146,23,14,183,183,0,183,0,0,6,25,53,58,19,14,8,0,62,66,55,183
20220501,01MAY2022:00:00:00,UFU PIÑERO,12,9,16,2,3,21,21,0,21,0,0,1,2,2,3,9,4,0,0,2,12,7,21
20220501,01MAY2022:00:00:00,UFU RAMOS MEJIA,52,36,74,9,5,88,88,0,88,0,3,5,12,20,17,11,11,9,0,10,53,25,88
20220501,01MAY2022:00:00:00,UFU RIVADAVIA,118,76,143,12,39,194,194,0,194,0,0,3,39,28,48,28,17,31,0,30,92,72,194
20220501,01MAY2022:00:00:00,UFU SANTOJANNI,36,19,46,6,3,55,55,0,55,0,0,6,4,17,7,10,6,5,0,15,22,18,55
20220501,01MAY2022:00:00:00,UFU TORNU,24,39,53,6,4,63,63,0,63,0,11,5,3,7,12,9,10,6,0,7,30,26,63
20220501,01MAY2022:00:00:00,UFU ZUBIZARRETA,115,63,146,13,22,181,181,0,181,0,3,15,27,32,42,29,21,12,0,32,73,76,181
20220502,02MAY2022:00:00:00,UFU ALVAREZ,69,52,87,23,11,121,121,0,121,0,6,12,21,26,13,25,14,4,0,18,42,61,121
20220502,02MAY2022:00:00:00,UFU ARGERICH,42,21,45,13,5,63,63,0,63,0,0,2,11,11,20,7,8,4,0,4,26,33,63
20220502,02MAY2022:00:00:00,UFU DURAND,116,77,177,10,6,193,193,0,193,0,0,6,22,40,38,42,27,18,0,44,57,92,193
20220502,02MAY2022:00:00:00,UFU GUTIERREZ,82,49,78,38,15,131,131,0,131,0,87,20,12,6,0,2,4,0,0,6,65,60,131
20220502,02MAY2022:00:00:00,UFU MUÑIZ,36,49,39,38,8,85,85,0,85,0,0,6,16,20,11,18,12,2,0,0,25,60,85
20220502,02MAY2022:00:00:00,UFU PENNA,29,16,37,6,2,45,45,0,45,0,0,2,9,15,6,7,4,2,0,0,23,22,45
20220502,02MAY2022:00:00:00,UFU PIROVANO,131,99,178,12,40,230,230,0,230,0,0,21,26,48,56,28,29,22,0,34,81,115,230
20220502,02MAY2022:00:00:00,UFU PIÑERO,52,36,68,12,8,88,88,0,88,0,0,14,6,8,20,20,10,10,0,12,32,44,88
20220502,02MAY2022:00:00:00,UFU RAMOS MEJIA,64,56,83,29,8,120,120,0,120,0,0,6,17,31,12,15,23,16,0,7,40,73,120
20220502,02MAY2022:00:00:00,UFU RIVADAVIA,213,133,252,56,38,346,346,0,346,0,0,7,52,72,69,64,41,41,0,46,125,174,346
20220502,02MAY2022:00:00:00,UFU SANTOJANNI,121,87,140,49,19,208,208,0,208,0,0,19,21,32,39,42,28,27,0,55,63,90,208
20220502,02MAY2022:00:00:00,UFU TORNU,82,50,106,11,15,132,132,0,132,0,6,8,10,10,34,22,20,22,0,13,62,57,132
20220502,02MAY2022:00:00:00,UFU ZUBIZARRETA,84,62,113,19,14,146,146,0,146,0,0,8,24,28,33,28,19,6,0,20,52,74,146
20220503,03MAY2022:00:00:00,UFU ALVAREZ,79,40,100,9,10,119,119,0,119,0,2,10,18,21,20,26,11,11,0,20,64,35,119
20220503,03MAY2022:00:00:00,UFU ARGERICH,34,14,34,9,5,48,48,0,48,0,0,1,9,18,8,5,7,0,0,5,23,20,48
20220503,03MAY2022:00:00:00,UFU DURAND,112,80,167,14,11,192,192,0,192,0,0,9,22,49,52,24,17,19,0,31,101,60,192
20220503,03MAY2022:00:00:00,UFU GUTIERREZ,53,89,101,27,14,142,142,0,142,0,67,49,8,6,9,0,3,0,0,12,70,60,142
20220503,03MAY2022:00:00:00,UFU MUÑIZ,39,41,32,36,15,83,83,0,83,0,5,3,18,13,19,12,9,4,0,3,24,56,83
20220503,03MAY2022:00:00:00,UFU PENNA,19,13,25,4,3,32,32,0,32,0,0,2,4,9,5,7,5,0,0,3,19,10,32
20220503,03MAY2022:00:00:00,UFU PIROVANO,228,142,292,29,49,370,370,0,370,0,0,12,75,104,67,47,35,30,0,64,132,173,370
20220503,03MAY2022:00:00:00,UFU PIÑERO,40,38,67,3,8,78,78,0,78,0,1,7,5,23,7,16,11,8,0,11,49,18,78
20220503,03MAY2022:00:00:00,UFU RAMOS MEJIA,46,32,61,13,4,78,78,0,78,0,0,1,9,19,23,13,8,5,0,8,49,21,78
20220503,03MAY2022:00:00:00,UFU RIVADAVIA,235,122,245,54,62,361,361,0,361,0,4,3,96,82,59,51,33,33,0,44,173,144,361
20220503,03MAY2022:00:00:00,UFU SANTOJANNI,101,81,138,29,15,182,182,0,182,0,0,16,27,26,45,29,26,13,0,58,76,47,182
20220503,03MAY2022:00:00:00,UFU TORNU,91,61,124,16,12,152,152,0,152,0,17,19,14,21,21,25,20,15,0,19,73,60,152
20220503,03MAY2022:00:00:00,UFU ZUBIZARRETA,58,49,79,19,9,107,107,0,107,0,0,8,11,30,30,11,9,8,0,23,50,34,107
20220504,04MAY2022:00:00:00,UFU ALVAREZ,64,41,73,13,23,109,109,0,109,0,4,8,11,28,30,10,10,8,0,23,50,36,109
20220504,04MAY2022:00:00:00,UFU ARGERICH,46,29,53,13,11,77,77,0,77,0,6,4,5,14,19,9,11,9,0,10,32,35,77
20220504,04MAY2022:00:00:00,UFU DURAND,136,77,176,20,21,217,217,0,217,0,4,8,28,47,45,35,26,24,0,40,88,89,217
20220504,04MAY2022:00:00:00,UFU GUTIERREZ,81,87,111,42,20,173,173,0,173,0,120,39,2,3,7,0,2,0,0,12,83,78,173
20220504,04MAY2022:00:00:00,UFU MUÑIZ,42,41,46,28,11,85,85,0,85,0,9,3,12,21,17,11,7,5,0,1,20,63,85
20220504,04MAY2022:00:00:00,UFU PENNA,32,10,34,4,7,45,45,0,45,0,3,0,4,13,8,9,4,4,0,5,23,16,45
20220504,04MAY2022:00:00:00,UFU PIROVANO,223,135,278,41,41,360,360,0,360,0,2,16,73,82,92,47,32,16,0,84,152,124,360
20220504,04MAY2022:00:00:00,UFU PIÑERO,42,52,72,11,13,96,96,0,96,0,2,7,16,29,20,17,4,1,0,6,60,30,96
20220504,04MAY2022:00:00:00,UFU RAMOS MEJIA,100,52,126,12,15,153,153,0,153,0,1,3,22,36,41,29,14,7,0,23,84,46,153
20220504,04MAY2022:00:00:00,UFU RIVADAVIA,306,181,380,60,56,496,496,0,496,0,11,21,118,121,94,61,34,36,0,87,214,195,496
20220303,03MAR2022:00:00:00,UFU TORNU,252,237,404,68,18,490,490,0,490,0,57,67,98,117,65,28,27,31,0,7,316,166,490
20220303,03MAR2022:00:00:00,UFU VELEZ SARSFIELD,250,233,318,119,47,484,484,0,484,0,1,45,138,98,109,60,20,13,0,7,317,160,484
20220303,03MAR2022:00:00:00,UFU ZUBIZARRETA,146,145,166,99,26,291,291,0,291,0,0,24,100,54,50,25,15,23,0,6,139,146,291
20220304,04MAR2022:00:00:00,UFU ALVAREZ,290,174,338,93,33,464,464,0,464,0,41,38,128,100,74,50,22,11,0,6,292,166,464
20220304,04MAR2022:00:00:00,UFU ARGERICH,61,46,61,45,1,107,107,0,107,0,8,10,24,33,11,11,6,4,0,8,46,52,107
20220304,04MAR2022:00:00:00,UFU BORDA-MOYANO,69,46,57,52,6,115,115,0,115,0,0,11,27,29,21,16,8,3,0,1,70,44,115
20220304,04MAR2022:00:00:00,UFU DURAND,191,164,322,29,5,356,356,0,356,0,1,31,83,106,66,27,29,13,0,14,195,147,356
20220304,04MAR2022:00:00:00,UFU ELIZALDE,127,111,69,158,11,238,238,0,238,0,148,64,6,14,3,2,1,0,0,4,116,118,238
20220304,04MAR2022:00:00:00,UFU FERNANDEZ,122,107,146,41,43,230,230,0,230,0,1,15,60,64,33,32,18,7,0,6,122,102,230
20220304,04MAR2022:00:00:00,UFU FERRER,122,116,118,114,6,238,238,0,238,0,0,0,85,73,51,18,8,3,0,8,163,67,238
20220304,04MAR2022:00:00:00,UFU GRIERSON,32,55,51,31,5,87,87,0,87,0,0,9,30,20,17,6,1,4,0,0,54,33,87
20220304,04MAR2022:00:00:00,UFU GUTIERREZ,193,216,258,138,16,412,412,0,412,0,215,145,18,20,10,0,4,0,0,7,293,112,412
20220304,04MAR2022:00:00:00,UFU MUÑIZ,141,200,109,212,20,341,341,0,341,0,0,28,80,70,80,40,36,7,0,7,227,106,341
20220304,04MAR2022:00:00:00,UFU PENNA,156,154,171,132,7,310,310,0,310,0,26,38,93,82,37,17,17,0,0,5,221,83,310
20220304,04MAR2022:00:00:00,UFU PIROVANO,185,149,207,65,62,334,334,0,334,0,0,19,105,84,62,35,16,13,0,11,174,149,334
20220304,04MAR2022:00:00:00,UFU PIÑERO,206,182,278,52,59,389,389,0,389,0,1,35,105,114,58,34,21,21,0,3,282,104,389
20220304,04MAR2022:00:00:00,UFU RAMOS MEJIA,227,230,337,76,44,457,457,0,457,0,2,19,155,105,87,46,26,17,0,15,278,164,457
20220304,04MAR2022:00:00:00,UFU RIVADAVIA,250,174,299,76,52,427,427,0,427,0,3,9,147,119,50,33,32,34,0,11,235,181,427
20220304,04MAR2022:00:00:00,UFU SANTOJANNI,198,169,195,150,22,367,367,0,367,0,0,53,95,81,59,40,23,16,0,8,216,143,367
20220304,04MAR2022:00:00:00,UFU TORNU,156,168,277,33,14,324,324,0,324,0,21,26,75,78,62,23,24,15,0,11,208,105,324
20220304,04MAR2022:00:00:00,UFU VELEZ SARSFIELD,174,173,248,86,13,347,347,0,347,0,0,27,94,61,63,49,37,16,0,8,225,114,347
20220304,04MAR2022:00:00:00,UFU ZUBIZARRETA,134,104,141,87,10,238,238,0,238,0,0,26,68,47,38,27,20,12,0,11,108,119,238
20220305,05MAR2022:00:00:00,UFU ALVAREZ,168,183,275,58,18,351,351,0,351,0,21,36,56,95,57,29,32,25,0,5,193,153,351
20220305,05MAR2022:00:00:00,UFU BORDA-MOYANO,45,75,58,58,4,120,120,0,120,0,0,7,39,33,11,9,20,1,0,2,75,43,120
20220305,05MAR2022:00:00:00,UFU DURAND,118,131,216,15,18,249,249,0,249,0,4,12,59,66,45,27,18,18,0,13,138,98,249
20220305,05MAR2022:00:00:00,UFU ELIZALDE,120,132,80,168,5,253,253,0,253,0,140,97,3,8,3,2,0,0,0,1,144,108,253
20220305,05MAR2022:00:00:00,UFU FERNANDEZ,116,94,161,32,17,210,210,0,210,0,0,14,49,38,32,35,25,17,0,3,120,87,210
20220305,05MAR2022:00:00:00,UFU FERRER,112,104,78,118,20,216,216,0,216,0,0,8,64,50,35,34,22,3,0,3,156,57,216
20220305,05MAR2022:00:00:00,UFU GRIERSON,124,83,130,71,6,207,207,0,207,0,0,16,63,37,48,34,7,2,0,2,147,58,207
20220305,05MAR2022:00:00:00,UFU GUTIERREZ,219,170,254,102,34,390,390,0,390,0,224,137,9,8,12,0,0,0,0,5,264,118,390
20220305,05MAR2022:00:00:00,UFU MUÑIZ,121,154,128,129,20,277,277,0,277,0,7,22,78,57,59,23,23,8,0,8,180,88,277
20220305,05MAR2022:00:00:00,UFU PENNA,98,64,87,67,8,162,162,0,162,0,15,14,54,40,17,6,7,9,0,1,115,46,162
20220305,05MAR2022:00:00:00,UFU PIROVANO,195,138,258,42,34,334,334,0,334,0,1,20,64,86,72,42,30,19,0,25,171,138,334
20220305,05MAR2022:00:00:00,UFU PIÑERO,127,109,159,52,26,237,237,0,237,0,1,43,61,38,46,32,8,8,0,10,169,58,237
20220305,05MAR2022:00:00:00,UFU RAMOS MEJIA,158,143,219,54,30,303,303,0,303,0,41,40,63,66,38,25,11,19,0,9,150,144,303
20220305,05MAR2022:00:00:00,UFU RIVADAVIA,177,162,249,49,42,340,340,0,340,0,1,6,115,76,51,44,30,17,0,7,193,139,340
20220305,05MAR2022:00:00:00,UFU SANTOJANNI,144,152,180,98,18,296,296,0,296,0,0,43,84,48,44,37,28,12,0,4,156,136,296
20220305,05MAR2022:00:00:00,UFU TORNU,106,91,178,12,7,197,197,0,197,0,11,46,34,52,37,2,3,12,0,12,91,94,197
20220305,05MAR2022:00:00:00,UFU VELEZ SARSFIELD,155,125,177,87,16,280,280,0,280,0,0,40,75,58,32,28,41,6,0,8,182,90,280
20220305,05MAR2022:00:00:00,UFU ZUBIZARRETA,151,165,198,109,10,317,317,0,317,0,1,47,59,72,51,28,35,24,0,6,151,160,317
20220306,06MAR2022:00:00:00,UFU ALVAREZ,148,103,216,20,16,252,252,0,252,0,25,35,46,56,33,23,19,15,0,6,137,109,252
20220306,06MAR2022:00:00:00,UFU BORDA-MOYANO,30,39,45,21,3,69,69,0,69,0,0,6,14,16,19,9,5,0,0,1,49,19,69
20220306,06MAR2022:00:00:00,UFU DURAND,135,124,221,28,10,259,259,0,259,0,0,26,41,65,64,26,30,7,0,13,139,107,259
20220306,06MAR2022:00:00:00,UFU ELIZALDE,159,131,107,178,6,291,291,0,291,0,177,92,4,13,3,1,1,0,0,0,154,137,291
20220306,06MAR2022:00:00:00,UFU FERNANDEZ,101,78,151,9,20,180,180,0,180,0,1,18,41,49,33,16,16,6,0,5,99,76,180
20220306,06MAR2022:00:00:00,UFU FERRER,115,88,93,94,16,203,203,0,203,0,0,5,69,52,30,19,20,8,0,3,158,42,203
20220306,06MAR2022:00:00:00,UFU GRIERSON,68,84,72,68,12,152,152,0,152,0,0,9,61,35,23,13,8,3,0,1,104,47,152
20220306,06MAR2022:00:00:00,UFU GUTIERREZ,198,213,290,91,30,411,411,0,411,0,215,176,2,13,0,5,0,0,0,10,273,125,411
20220306,06MAR2022:00:00:00,UFU MUÑIZ,92,121,115,90,8,213,213,0,213,0,5,27,38,43,34,39,19,8,0,9,141,63,213
20220306,06MAR2022:00:00:00,UFU PENNA,72,59,59,63,9,131,131,0,131,0,4,8,41,32,23,12,10,1,0,0,92,39,131
20220306,06MAR2022:00:00:00,UFU PIROVANO,154,146,235,36,30,301,301,0,301,0,1,32,69,79,46,38,18,18,0,12,165,124,301
20220306,06MAR2022:00:00:00,UFU PIÑERO,122,74,120,56,20,196,196,0,196,0,0,25,39,49,48,21,7,7,0,2,146,47,196
20220306,06MAR2022:00:00:00,UFU RAMOS MEJIA,162,138,216,50,34,300,300,0,300,0,24,71,52,34,46,26,25,22,0,8,160,131,300
20220306,06MAR2022:00:00:00,UFU RIVADAVIA,168,130,211,54,36,301,301,0,301,0,3,15,66,94,39,44,23,17,0,13,169,119,301
20220306,06MAR2022:00:00:00,UFU SANTOJANNI,121,139,117,128,15,260,260,0,260,0,0,40,53,68,34,22,32,11,0,9,133,118,260
20220306,06MAR2022:00:00:00,UFU TORNU,134,122,196,35,25,256,256,0,256,0,31,48,21,52,52,20,12,20,0,9,164,83,256
20220306,06MAR2022:00:00:00,UFU VELEZ SARSFIELD,164,136,207,72,21,300,300,0,300,0,0,22,75,64,71,32,13,23,0,7,201,92,300
20220306,06MAR2022:00:00:00,UFU ZUBIZARRETA,137,126,153,94,16,263,263,0,263,0,0,31,57,82,43,24,12,14,0,10,123,130,263
20220307,07MAR2022:00:00:00,UFU ALVAREZ,259,313,419,96,57,572,572,0,572,0,73,60,137,156,64,35,29,18,0,6,364,202,572
20220307,07MAR2022:00:00:00,UFU ARGERICH,75,85,82,76,2,160,160,0,160,0,20,24,25,42,13,29,3,4,0,1,77,82,160
20220307,07MAR2022:00:00:00,UFU BORDA-MOYANO,66,71,71,54,12,137,137,0,137,0,3,22,29,41,16,10,13,3,0,3,91,43,137
20220307,07MAR2022:00:00:00,UFU DURAND,180,114,249,28,17,294,294,0,294,0,0,25,98,68,44,35,13,11,0,12,161,121,294
20220307,07MAR2022:00:00:00,UFU ELIZALDE,168,185,111,239,3,353,353,0,353,0,217,104,10,7,10,3,2,0,0,4,181,168,353
20220307,07MAR2022:00:00:00,UFU FERNANDEZ,126,88,155,32,27,214,214,0,214,0,0,17,63,64,25,26,9,10,0,8,124,82,214
20220504,04MAY2022:00:00:00,UFU SANTOJANNI,40,30,44,17,11,72,72,0,72,0,2,6,6,18,18,14,5,3,0,32,27,13,72
20220504,04MAY2022:00:00:00,UFU TORNU,101,61,131,23,9,163,163,0,163,0,22,14,17,34,37,9,9,21,0,16,72,75,163
20220504,04MAY2022:00:00:00,UFU ZUBIZARRETA,81,66,118,18,15,151,151,0,151,0,4,4,25,38,31,16,19,14,0,49,57,45,151
20220505,05MAY2022:00:00:00,UFU ALVAREZ,107,54,134,10,19,163,163,0,163,0,2,8,19,31,40,39,21,3,0,37,76,50,163
20220505,05MAY2022:00:00:00,UFU ARGERICH,55,32,68,17,2,87,87,0,87,0,0,7,11,29,20,12,7,1,0,5,38,44,87
20220505,05MAY2022:00:00:00,UFU DURAND,123,74,187,6,4,197,197,0,197,0,0,11,21,49,35,34,36,11,0,60,79,58,197
20220505,05MAY2022:00:00:00,UFU GUTIERREZ,140,88,156,52,20,228,228,0,228,0,128,70,10,6,6,6,2,0,0,13,108,107,228
20220505,05MAY2022:00:00:00,UFU MUÑIZ,44,61,45,47,13,105,105,0,105,0,1,3,18,32,18,15,17,1,0,4,37,64,105
20220505,05MAY2022:00:00:00,UFU PENNA,45,24,45,21,3,69,69,0,69,0,0,3,16,17,13,8,11,1,0,13,34,22,69
20220505,05MAY2022:00:00:00,UFU PIROVANO,227,164,309,41,41,391,391,0,391,0,0,21,66,95,87,60,31,31,0,87,162,142,391
20220505,05MAY2022:00:00:00,UFU PIÑERO,47,31,65,11,3,79,79,0,79,0,1,8,12,16,14,19,6,3,0,8,47,24,79
20220505,05MAY2022:00:00:00,UFU RAMOS MEJIA,110,81,160,22,11,193,193,0,193,0,2,5,32,44,44,25,30,11,0,21,106,66,193
20220505,05MAY2022:00:00:00,UFU RIVADAVIA,335,178,377,67,73,517,517,0,517,0,6,18,125,112,99,56,59,42,0,69,271,177,517
20220505,05MAY2022:00:00:00,UFU SANTOJANNI,188,147,245,61,29,335,335,0,335,0,0,22,39,54,67,78,42,33,0,138,81,116,335
20220505,05MAY2022:00:00:00,UFU TORNU,92,54,136,10,0,146,146,0,146,0,6,16,24,34,25,14,16,11,0,27,62,57,146
20220505,05MAY2022:00:00:00,UFU ZUBIZARRETA,84,69,126,14,13,153,153,0,153,0,0,20,14,33,37,21,20,8,0,44,65,44,153
20220506,06MAY2022:00:00:00,UFU ALVAREZ,120,58,148,16,14,178,178,0,178,0,0,14,21,41,34,37,13,18,0,38,90,50,178
20220506,06MAY2022:00:00:00,UFU ARGERICH,54,35,67,13,9,89,89,0,89,0,0,7,20,14,25,6,11,6,0,13,40,36,89
20220506,06MAY2022:00:00:00,UFU DURAND,106,83,177,12,2,191,191,0,191,0,2,16,24,52,39,25,21,12,0,46,90,55,191
20220506,06MAY2022:00:00:00,UFU GUTIERREZ,66,64,86,27,17,130,130,0,130,0,62,43,5,4,12,4,0,0,0,8,58,64,130
20220506,06MAY2022:00:00:00,UFU MUÑIZ,43,45,38,40,10,88,88,0,88,0,4,8,11,19,17,18,7,4,0,3,22,63,88
20220506,06MAY2022:00:00:00,UFU PENNA,50,35,55,28,2,85,85,0,85,0,3,7,11,25,11,13,8,7,0,14,41,30,85
20220506,06MAY2022:00:00:00,UFU PIROVANO,240,162,323,37,44,404,404,0,404,0,2,24,56,95,85,76,36,30,0,88,157,159,404
20220506,06MAY2022:00:00:00,UFU PIÑERO,53,33,72,8,9,89,89,0,89,0,3,4,15,18,18,14,9,8,0,17,47,25,89
20220506,06MAY2022:00:00:00,UFU RAMOS MEJIA,101,79,138,29,15,182,182,0,182,0,2,3,16,49,52,30,16,14,0,27,93,62,182
20220506,06MAY2022:00:00:00,UFU RIVADAVIA,315,180,388,72,38,498,498,0,498,0,7,22,107,116,107,67,35,37,0,91,210,196,498
20220506,06MAY2022:00:00:00,UFU SANTOJANNI,195,114,224,59,26,309,309,0,309,0,0,13,36,54,99,46,29,32,0,85,89,133,309
20220506,06MAY2022:00:00:00,UFU TORNU,118,81,160,34,5,199,199,0,199,0,14,8,22,42,54,25,19,15,0,28,82,89,199
20220506,06MAY2022:00:00:00,UFU ZUBIZARRETA,97,83,140,27,15,182,182,0,182,0,2,10,24,50,30,34,17,15,0,59,66,57,182
20220507,07MAY2022:00:00:00,UFU ALVAREZ,104,74,160,14,5,179,179,0,179,0,1,10,30,33,36,34,17,18,0,40,81,58,179
20220507,07MAY2022:00:00:00,UFU DURAND,81,68,141,3,5,149,149,0,149,0,0,2,22,42,29,16,15,23,0,37,69,43,149
20220507,07MAY2022:00:00:00,UFU GUTIERREZ,104,70,137,26,11,174,174,0,174,0,116,56,0,2,0,0,0,0,0,21,71,82,174
20220507,07MAY2022:00:00:00,UFU MUÑIZ,70,49,65,42,12,119,119,0,119,0,0,9,13,25,27,22,17,6,0,12,26,81,119
20220507,07MAY2022:00:00:00,UFU PIROVANO,211,181,321,35,38,394,394,0,394,0,2,27,35,82,99,74,45,30,0,117,136,141,394
20220507,07MAY2022:00:00:00,UFU PIÑERO,48,54,79,15,8,102,102,0,102,0,2,4,16,22,27,17,12,2,0,23,46,33,102
20220507,07MAY2022:00:00:00,UFU RAMOS MEJIA,119,70,163,16,11,190,190,0,190,0,16,17,41,33,35,12,15,21,0,32,91,67,190
20220507,07MAY2022:00:00:00,UFU RIVADAVIA,265,167,342,29,66,437,437,0,437,0,5,8,68,91,94,71,49,51,0,101,181,154,437
20220507,07MAY2022:00:00:00,UFU SANTOJANNI,186,140,244,51,32,327,327,0,327,0,4,35,31,72,77,57,22,29,0,67,111,149,327
20220507,07MAY2022:00:00:00,UFU TORNU,61,43,88,13,3,104,104,0,104,0,7,12,11,20,28,14,8,4,0,12,41,51,104
20220507,07MAY2022:00:00:00,UFU ZUBIZARRETA,198,139,266,55,20,341,341,0,341,0,4,23,43,60,60,74,60,17,0,87,120,134,341
20220508,08MAY2022:00:00:00,UFU ALVAREZ,113,64,151,16,10,177,177,0,177,0,0,8,26,33,46,28,26,10,0,41,85,51,177
20220508,08MAY2022:00:00:00,UFU DURAND,120,79,178,7,15,200,200,0,200,0,1,4,17,56,54,35,22,11,0,65,76,59,200
20220508,08MAY2022:00:00:00,UFU GUTIERREZ,94,75,129,24,16,169,169,0,169,0,93,64,2,0,5,2,0,3,0,31,65,73,169
20220508,08MAY2022:00:00:00,UFU MUÑIZ,90,57,94,35,19,148,148,0,148,0,5,14,9,38,43,20,17,2,0,6,60,82,148
20220508,08MAY2022:00:00:00,UFU PIROVANO,262,152,352,27,36,415,415,0,415,0,1,14,62,109,80,98,32,19,0,145,140,130,415
20220508,08MAY2022:00:00:00,UFU PIÑERO,70,51,101,9,11,121,121,0,121,0,0,10,14,28,29,21,13,6,0,30,49,42,121
20220508,08MAY2022:00:00:00,UFU RAMOS MEJIA,121,79,170,11,22,203,203,0,203,0,18,25,27,24,44,26,19,20,0,43,99,61,203
20220508,08MAY2022:00:00:00,UFU RIVADAVIA,324,180,398,39,72,509,509,0,509,0,8,35,85,95,113,66,68,39,0,94,194,221,509
20220508,08MAY2022:00:00:00,UFU SANTOJANNI,143,68,160,37,14,211,211,0,211,0,0,23,30,33,53,36,20,16,0,49,74,88,211
20220508,08MAY2022:00:00:00,UFU TORNU,77,29,89,10,8,107,107,0,107,0,10,14,10,27,18,17,7,4,0,13,45,49,107
20220508,08MAY2022:00:00:00,UFU ZUBIZARRETA,201,128,248,55,29,332,332,0,332,0,3,27,28,45,87,68,50,24,0,87,112,133,332
20220509,09MAY2022:00:00:00,UFU ALVAREZ,142,108,215,23,12,250,250,0,250,0,0,13,27,49,70,37,30,24,0,49,112,89,250
20220509,09MAY2022:00:00:00,UFU ARGERICH,68,37,84,13,8,105,105,0,105,0,0,5,17,18,28,25,6,6,0,19,36,50,105
20220509,09MAY2022:00:00:00,UFU DURAND,145,107,220,17,16,253,253,0,253,0,1,14,41,55,53,39,39,11,0,63,113,77,253
20220509,09MAY2022:00:00:00,UFU GUTIERREZ,163,160,183,114,28,325,325,0,325,0,199,74,12,10,22,8,0,0,0,25,141,159,325
20220509,09MAY2022:00:00:00,UFU MUÑIZ,123,70,110,60,25,195,195,0,195,0,6,13,37,50,24,38,18,9,0,4,91,99,195
20220509,09MAY2022:00:00:00,UFU PENNA,33,37,46,19,7,72,72,0,72,0,2,8,12,25,6,9,8,2,0,22,30,20,72
20220509,09MAY2022:00:00:00,UFU PIROVANO,305,201,415,36,58,509,509,0,509,0,3,26,73,120,107,96,45,39,0,147,189,173,509
20220509,09MAY2022:00:00:00,UFU PIÑERO,76,43,87,20,12,119,119,0,119,0,0,11,25,25,19,18,17,4,0,34,54,31,119
20220509,09MAY2022:00:00:00,UFU RAMOS MEJIA,158,85,179,42,24,245,245,0,245,0,2,1,37,59,61,40,25,20,0,38,131,76,245
20220509,09MAY2022:00:00:00,UFU RIVADAVIA,546,309,663,125,71,859,859,0,859,0,4,22,177,193,191,118,101,53,0,155,377,327,859
20220509,09MAY2022:00:00:00,UFU SANTOJANNI,266,139,296,70,40,406,406,0,406,0,1,30,51,86,76,85,43,34,0,108,136,158,406
20220509,09MAY2022:00:00:00,UFU TORNU,184,93,227,27,23,277,277,0,277,0,7,30,22,69,60,44,31,14,0,36,113,128,277
20220509,09MAY2022:00:00:00,UFU ZUBIZARRETA,126,79,155,28,26,209,209,0,209,0,4,15,13,45,53,30,31,18,0,62,74,73,209
20220510,10MAY2022:00:00:00,UFU ALVAREZ,123,87,177,18,15,210,210,0,210,0,0,9,50,49,39,25,25,13,0,53,88,69,210
20220510,10MAY2022:00:00:00,UFU ARGERICH,68,68,93,25,18,136,136,0,136,0,0,6,20,46,23,25,14,2,0,21,60,55,136
20220307,07MAR2022:00:00:00,UFU FERRER,115,128,88,142,13,243,243,0,243,0,0,10,79,73,58,14,5,4,0,7,164,72,243
20220307,07MAR2022:00:00:00,UFU GRIERSON,118,152,178,77,16,271,271,0,271,0,3,19,67,66,58,22,21,15,0,3,195,73,271
20220307,07MAR2022:00:00:00,UFU GUTIERREZ,306,327,421,174,38,633,633,0,633,0,368,203,20,16,19,7,0,0,0,4,413,216,633
20220307,07MAR2022:00:00:00,UFU MUÑIZ,130,193,151,133,40,324,324,0,324,0,19,20,72,76,74,34,20,9,0,4,230,90,324
20220307,07MAR2022:00:00:00,UFU PENNA,141,110,86,152,14,252,252,0,252,0,15,30,65,54,55,12,17,4,0,4,184,64,252
20220307,07MAR2022:00:00:00,UFU PIROVANO,199,151,237,50,63,350,350,0,350,0,0,32,86,95,70,33,20,14,0,10,195,144,350
20220307,07MAR2022:00:00:00,UFU PIÑERO,176,150,268,49,12,329,329,0,329,0,1,28,90,80,62,25,23,20,0,3,243,81,329
20220307,07MAR2022:00:00:00,UFU RAMOS MEJIA,187,196,274,84,25,383,383,0,383,0,4,22,93,95,76,40,27,26,0,3,191,189,383
20220307,07MAR2022:00:00:00,UFU RIVADAVIA,268,170,300,75,64,439,439,0,439,0,1,26,138,109,59,33,40,33,0,17,240,181,439
20220307,07MAR2022:00:00:00,UFU SANTOJANNI,191,218,231,147,31,409,409,0,409,0,2,47,86,97,76,62,16,23,0,9,227,173,409
20220307,07MAR2022:00:00:00,UFU TORNU,227,188,350,58,7,415,415,0,415,0,59,70,66,94,59,31,21,15,0,8,253,151,415
20220307,07MAR2022:00:00:00,UFU VELEZ SARSFIELD,180,178,239,110,9,358,358,0,358,0,0,39,86,73,86,43,24,7,0,6,244,108,358
20220307,07MAR2022:00:00:00,UFU ZUBIZARRETA,155,120,160,97,19,276,276,0,276,0,1,41,68,50,49,28,21,18,0,20,119,137,276
20220308,08MAR2022:00:00:00,UFU ALVAREZ,273,237,368,99,43,510,510,0,510,0,47,86,122,112,65,20,35,23,0,1,334,175,510
20220308,08MAR2022:00:00:00,UFU ARGERICH,73,75,75,71,2,148,148,0,148,0,14,12,53,42,7,13,5,2,0,4,74,69,148
20220308,08MAR2022:00:00:00,UFU BORDA-MOYANO,55,79,76,51,7,134,134,0,134,0,3,23,33,24,31,11,7,2,0,2,81,51,134
20220308,08MAR2022:00:00:00,UFU DURAND,175,157,279,34,19,332,332,0,332,0,0,36,76,97,55,31,21,16,0,9,188,135,332
20220308,08MAR2022:00:00:00,UFU ELIZALDE,121,151,78,185,9,272,272,0,272,0,165,72,15,13,7,0,0,0,0,7,138,127,272
20220308,08MAR2022:00:00:00,UFU FERNANDEZ,122,92,165,27,24,216,216,0,216,0,2,16,60,31,57,13,16,21,0,11,120,85,216
20220308,08MAR2022:00:00:00,UFU FERRER,146,146,130,139,23,292,292,0,292,0,0,3,118,81,44,37,9,0,0,5,215,72,292
20220308,08MAR2022:00:00:00,UFU GRIERSON,80,77,101,52,4,157,157,0,157,0,0,17,54,29,21,12,13,11,0,1,111,45,157
20220308,08MAR2022:00:00:00,UFU GUTIERREZ,324,303,415,163,49,627,627,0,627,0,359,204,16,22,12,14,0,0,0,6,391,227,627
20220308,08MAR2022:00:00:00,UFU MUÑIZ,118,155,115,143,16,274,274,0,274,0,6,23,43,81,65,24,24,8,0,3,197,74,274
20220308,08MAR2022:00:00:00,UFU PENNA,97,102,111,82,6,199,199,0,199,0,25,20,66,38,22,8,18,2,0,0,143,52,199
20220308,08MAR2022:00:00:00,UFU PIROVANO,213,150,243,49,71,363,363,0,363,0,0,32,104,72,66,38,23,28,0,20,192,151,363
20220308,08MAR2022:00:00:00,UFU PIÑERO,105,114,143,51,25,219,219,0,219,0,0,24,63,53,55,15,9,0,0,3,157,56,219
20220308,08MAR2022:00:00:00,UFU RAMOS MEJIA,181,205,266,92,28,386,386,0,386,0,4,21,100,95,74,28,43,21,0,10,185,190,386
20220308,08MAR2022:00:00:00,UFU RIVADAVIA,262,161,304,80,40,424,424,0,424,0,1,13,136,112,45,50,46,21,0,15,227,182,424
20220308,08MAR2022:00:00:00,UFU SANTOJANNI,128,156,160,100,24,284,284,0,284,0,0,45,52,81,44,31,14,17,0,11,140,133,284
20220308,08MAR2022:00:00:00,UFU TORNU,210,213,333,86,4,423,423,0,423,0,43,57,89,93,68,29,27,17,0,3,276,144,423
20220308,08MAR2022:00:00:00,UFU VELEZ SARSFIELD,181,161,251,75,16,342,342,0,342,0,0,42,65,80,71,35,29,20,0,1,232,109,342
20220308,08MAR2022:00:00:00,UFU ZUBIZARRETA,118,115,139,80,14,233,233,0,233,0,0,25,58,48,49,26,17,10,0,9,108,116,233
20220309,09MAR2022:00:00:00,UFU ALVAREZ,244,190,331,89,14,434,434,0,434,0,37,62,119,69,63,46,30,8,0,7,281,146,434
20220309,09MAR2022:00:00:00,UFU ARGERICH,68,67,89,44,2,135,135,0,135,0,24,14,24,27,18,17,6,5,0,3,64,67,135
20220309,09MAR2022:00:00:00,UFU BORDA-MOYANO,49,43,62,27,3,92,92,0,92,0,3,2,16,26,25,9,5,6,0,7,52,33,92
20220309,09MAR2022:00:00:00,UFU DURAND,149,164,261,33,19,313,313,0,313,0,0,26,105,63,61,23,18,17,0,9,171,133,313
20220309,09MAR2022:00:00:00,UFU ELIZALDE,60,66,46,77,3,126,126,0,126,0,83,29,1,5,8,0,0,0,0,1,64,61,126
20220309,09MAR2022:00:00:00,UFU FERNANDEZ,118,78,145,11,41,197,197,0,197,0,3,5,62,63,23,27,11,3,0,8,112,77,197
20220309,09MAR2022:00:00:00,UFU FERRER,97,85,101,72,9,182,182,0,182,0,0,5,47,71,38,10,9,2,0,1,132,49,182
20220309,09MAR2022:00:00:00,UFU GRIERSON,60,78,93,35,11,139,139,0,139,0,1,16,34,45,17,8,13,5,0,2,96,41,139
20220309,09MAR2022:00:00:00,UFU GUTIERREZ,238,179,258,133,26,417,417,0,417,0,214,158,10,16,14,5,0,0,0,4,270,142,417
20220309,09MAR2022:00:00:00,UFU MUÑIZ,150,140,121,138,31,290,290,0,290,0,9,24,44,60,70,38,36,9,0,4,201,85,290
20220309,09MAR2022:00:00:00,UFU PENNA,80,80,92,64,4,160,160,0,160,0,26,18,53,22,21,13,5,2,0,1,112,47,160
20220309,09MAR2022:00:00:00,UFU PIROVANO,154,168,248,27,47,322,322,0,322,0,0,22,96,78,42,51,17,16,0,11,183,128,322
20220309,09MAR2022:00:00:00,UFU PIÑERO,147,100,186,48,14,248,248,0,248,0,1,27,76,57,44,25,12,6,0,1,180,66,248
20220309,09MAR2022:00:00:00,UFU RAMOS MEJIA,123,158,206,42,33,281,281,0,281,0,0,7,84,64,61,39,21,5,0,8,143,130,281
20220309,09MAR2022:00:00:00,UFU RIVADAVIA,219,166,276,71,40,387,387,0,387,0,2,19,127,94,70,29,26,20,0,12,212,163,387
20220309,09MAR2022:00:00:00,UFU SANTOJANNI,147,113,135,111,14,260,260,0,260,0,3,30,80,39,55,37,10,6,0,8,146,106,260
20220309,09MAR2022:00:00:00,UFU TORNU,145,161,255,46,5,306,306,0,306,0,25,48,62,64,53,25,13,16,0,6,201,98,306
20220309,09MAR2022:00:00:00,UFU VELEZ SARSFIELD,129,140,199,54,17,270,270,0,270,0,1,28,73,69,30,37,24,8,0,7,179,84,270
20220309,09MAR2022:00:00:00,UFU ZUBIZARRETA,153,124,154,94,30,278,278,0,278,0,1,32,71,59,42,39,18,16,0,9,132,137,278
20220310,10MAR2022:00:00:00,UFU ALVAREZ,189,167,252,43,62,357,357,0,357,0,30,47,85,77,55,16,31,16,0,6,206,145,357
20220310,10MAR2022:00:00:00,UFU ARGERICH,60,64,72,39,19,130,130,0,130,0,9,15,32,34,16,10,6,8,0,1,68,60,130
20220310,10MAR2022:00:00:00,UFU BORDA-MOYANO,79,53,72,37,30,139,139,0,139,0,7,14,24,36,31,10,9,8,0,3,79,57,139
20220310,10MAR2022:00:00:00,UFU DURAND,162,147,253,35,26,314,314,0,314,0,5,31,87,74,43,41,22,11,0,6,179,129,314
20220310,10MAR2022:00:00:00,UFU ELIZALDE,154,150,107,143,58,308,308,0,308,0,177,110,2,10,4,2,3,0,0,2,144,162,308
20220310,10MAR2022:00:00:00,UFU FERNANDEZ,124,86,147,25,40,212,212,0,212,0,2,11,56,55,36,26,19,7,0,5,104,103,212
20220310,10MAR2022:00:00:00,UFU FERRER,133,130,119,114,33,266,266,0,266,0,3,10,90,90,31,13,20,9,0,10,188,68,266
20220310,10MAR2022:00:00:00,UFU GRIERSON,93,136,158,41,33,232,232,0,232,0,4,34,70,40,47,18,11,8,0,0,165,67,232
20220310,10MAR2022:00:00:00,UFU GUTIERREZ,277,201,299,123,61,483,483,0,483,0,261,171,10,22,11,4,4,0,0,5,319,159,483
20220310,10MAR2022:00:00:00,UFU MUÑIZ,101,154,150,67,41,258,258,0,258,0,5,23,46,98,38,27,8,13,0,10,171,77,258
20220310,10MAR2022:00:00:00,UFU PENNA,86,94,92,71,17,180,180,0,180,0,19,25,36,56,13,24,4,3,0,3,130,46,180
20220310,10MAR2022:00:00:00,UFU PIROVANO,168,153,230,41,55,326,326,0,326,0,5,24,94,93,57,30,11,12,0,7,179,139,326
20220310,10MAR2022:00:00:00,UFU PIÑERO,125,103,174,27,28,229,229,0,229,0,1,19,76,42,39,21,19,12,0,4,167,58,229
20220510,10MAY2022:00:00:00,UFU DURAND,188,123,273,26,12,311,311,0,311,0,0,10,49,73,70,57,34,18,0,101,121,89,311
20220510,10MAY2022:00:00:00,UFU GUTIERREZ,183,178,240,84,40,364,364,0,364,0,187,119,4,16,24,10,4,0,0,24,170,170,364
20220510,10MAY2022:00:00:00,UFU MUÑIZ,101,93,112,71,15,198,198,0,198,0,28,12,34,44,27,31,11,11,0,5,92,101,198
20220510,10MAY2022:00:00:00,UFU PENNA,56,42,79,11,8,98,98,0,98,0,3,6,15,22,25,15,4,8,0,17,43,38,98
20220510,10MAY2022:00:00:00,UFU PIROVANO,366,257,495,59,75,629,629,0,629,0,6,28,92,177,141,110,50,25,0,150,231,247,629
20220510,10MAY2022:00:00:00,UFU PIÑERO,125,78,168,15,20,203,203,0,203,0,2,22,31,42,46,36,12,12,0,37,104,62,203
20220510,10MAY2022:00:00:00,UFU RAMOS MEJIA,170,84,207,27,21,255,255,0,255,0,1,0,44,53,58,31,49,19,0,48,121,86,255
20220510,10MAY2022:00:00:00,UFU RIVADAVIA,497,274,598,82,95,775,775,0,775,0,4,20,154,187,153,115,78,64,0,133,373,269,775
20220510,10MAY2022:00:00:00,UFU SANTOJANNI,273,200,325,99,52,476,476,0,476,0,3,48,48,107,122,76,42,30,0,134,135,203,476
20220510,10MAY2022:00:00:00,UFU TORNU,91,86,158,16,4,178,178,0,178,0,13,16,19,32,49,29,17,3,0,31,47,100,178
20220510,10MAY2022:00:00:00,UFU ZUBIZARRETA,161,109,183,55,32,270,270,0,270,0,1,10,45,55,62,52,23,22,0,78,79,113,270
20220511,11MAY2022:00:00:00,UFU ALVAREZ,358,185,460,48,37,545,545,0,545,0,2,44,78,132,107,90,56,36,0,117,261,167,545
20220511,11MAY2022:00:00:00,UFU ARGERICH,102,65,122,31,16,169,169,0,169,0,4,8,38,43,27,31,9,9,0,19,65,85,169
20220511,11MAY2022:00:00:00,UFU DURAND,316,193,456,28,28,512,512,0,512,0,3,16,85,148,98,82,49,31,0,103,184,225,512
20220511,11MAY2022:00:00:00,UFU GUTIERREZ,155,161,215,87,16,318,318,0,318,0,177,106,2,7,13,11,2,0,0,27,157,134,318
20220511,11MAY2022:00:00:00,UFU MUÑIZ,91,61,79,63,11,153,153,0,153,0,7,9,12,42,34,34,11,4,0,12,72,69,153
20220511,11MAY2022:00:00:00,UFU PENNA,53,29,52,21,10,83,83,0,83,0,1,2,18,20,15,20,3,4,0,13,48,22,83
20220511,11MAY2022:00:00:00,UFU PIROVANO,415,261,548,59,71,678,678,0,678,0,2,41,98,213,147,80,64,33,0,195,223,260,678
20220511,11MAY2022:00:00:00,UFU PIÑERO,93,80,132,22,21,175,175,0,175,0,4,17,27,43,34,27,21,2,0,47,83,45,175
20220511,11MAY2022:00:00:00,UFU RAMOS MEJIA,144,117,199,33,30,262,262,0,262,0,1,0,40,76,64,49,20,12,0,50,127,85,262
20220511,11MAY2022:00:00:00,UFU RIVADAVIA,576,335,668,129,123,920,920,0,920,0,9,28,184,244,179,138,78,60,0,217,338,365,920
20220511,11MAY2022:00:00:00,UFU SANTOJANNI,313,212,441,63,21,525,525,0,525,0,0,51,70,104,124,77,59,40,0,166,169,186,525
20220511,11MAY2022:00:00:00,UFU TORNU,125,82,180,20,7,207,207,0,207,0,16,10,27,44,32,32,28,18,0,29,52,125,207
20220511,11MAY2022:00:00:00,UFU ZUBIZARRETA,136,101,169,47,22,238,238,0,238,0,1,31,36,35,57,36,28,14,0,67,95,76,238
20220512,12MAY2022:00:00:00,UFU ALVAREZ,264,195,362,55,47,464,464,0,464,0,5,46,91,106,93,56,41,26,0,82,218,164,464
20220512,12MAY2022:00:00:00,UFU ARGERICH,110,39,110,31,8,149,149,0,149,0,1,7,33,28,29,28,15,8,0,26,53,70,149
20220512,12MAY2022:00:00:00,UFU DURAND,274,190,429,15,23,467,467,0,467,0,3,20,69,131,109,54,56,25,0,151,170,146,467
20220512,12MAY2022:00:00:00,UFU GUTIERREZ,175,144,200,100,20,320,320,0,320,0,176,100,2,12,22,4,4,0,0,17,160,143,320
20220512,12MAY2022:00:00:00,UFU MUÑIZ,122,69,98,79,17,194,194,0,194,0,4,14,36,46,42,29,18,5,0,22,84,88,194
20220512,12MAY2022:00:00:00,UFU PENNA,54,18,57,9,6,72,72,0,72,0,2,1,20,18,10,13,6,2,0,12,38,22,72
20220512,12MAY2022:00:00:00,UFU PIROVANO,410,286,535,74,90,699,699,0,699,0,3,53,110,198,145,94,62,34,0,176,255,268,699
20220512,12MAY2022:00:00:00,UFU PIÑERO,109,77,166,13,8,187,187,0,187,0,1,11,25,34,48,39,18,11,0,28,97,62,187
20220512,12MAY2022:00:00:00,UFU RAMOS MEJIA,164,118,214,31,37,282,282,0,282,0,0,1,46,62,87,43,15,28,0,69,130,83,282
20220512,12MAY2022:00:00:00,UFU RIVADAVIA,501,304,631,91,93,815,815,0,815,0,10,31,199,175,156,119,85,40,0,162,347,306,815
20220512,12MAY2022:00:00:00,UFU SANTOJANNI,328,200,424,64,41,529,529,0,529,0,1,34,77,117,98,87,68,47,0,191,146,190,529
20220512,12MAY2022:00:00:00,UFU TORNU,114,71,154,24,7,185,185,0,185,0,21,20,24,37,41,21,10,11,0,17,42,126,185
20220512,12MAY2022:00:00:00,UFU ZUBIZARRETA,205,121,245,48,33,326,326,0,326,0,0,23,43,71,71,50,32,36,0,93,116,117,326
20220513,13MAY2022:00:00:00,UFU ALVAREZ,303,189,419,34,43,496,496,0,496,0,4,26,100,122,90,68,57,29,0,112,207,177,496
20220513,13MAY2022:00:00:00,UFU ARGERICH,80,40,86,23,13,122,122,0,122,0,2,9,14,33,32,10,17,5,0,17,53,52,122
20220513,13MAY2022:00:00:00,UFU DURAND,326,230,492,37,28,557,557,0,557,0,1,31,92,145,127,45,63,53,0,126,237,194,557
20220513,13MAY2022:00:00:00,UFU GUTIERREZ,161,172,246,50,39,335,335,0,335,0,181,107,6,7,22,12,0,0,0,31,153,151,335
20220513,13MAY2022:00:00:00,UFU MUÑIZ,115,96,142,51,20,213,213,0,213,0,7,14,27,56,54,34,16,5,0,24,91,98,213
20220513,13MAY2022:00:00:00,UFU PENNA,50,28,56,20,2,78,78,0,78,0,0,12,8,16,12,10,13,7,0,14,46,18,78
20220513,13MAY2022:00:00:00,UFU PIROVANO,348,257,484,52,73,609,609,0,609,0,4,32,76,171,142,91,46,47,0,154,245,210,609
20220513,13MAY2022:00:00:00,UFU PIÑERO,94,72,137,13,16,166,166,0,166,0,0,3,40,42,28,31,16,6,0,33,87,46,166
20220513,13MAY2022:00:00:00,UFU RAMOS MEJIA,180,105,247,22,18,287,287,0,287,0,2,4,35,75,52,54,38,27,0,44,148,95,287
20220513,13MAY2022:00:00:00,UFU RIVADAVIA,591,344,716,123,96,935,935,0,935,0,0,30,199,218,140,139,125,84,0,150,356,429,935
20220513,13MAY2022:00:00:00,UFU SANTOJANNI,349,225,401,128,50,579,579,0,579,0,6,52,70,117,143,80,65,46,0,162,173,244,579
20220513,13MAY2022:00:00:00,UFU TORNU,119,86,171,25,9,205,205,0,205,0,20,20,28,32,52,21,15,17,0,29,76,100,205
20220513,13MAY2022:00:00:00,UFU ZUBIZARRETA,196,172,265,69,39,373,373,0,373,0,5,22,44,70,94,52,49,37,0,105,135,133,373
20220514,14MAY2022:00:00:00,UFU ALVAREZ,249,172,370,22,31,423,423,0,423,0,2,41,40,89,104,70,47,30,0,89,182,152,423
20220514,14MAY2022:00:00:00,UFU ARGERICH,8,2,9,0,1,10,10,0,10,0,0,1,1,1,1,4,1,1,0,0,8,2,10
20220514,14MAY2022:00:00:00,UFU DURAND,289,148,398,19,21,438,438,0,438,0,1,25,79,115,98,52,43,25,0,124,161,153,438
20220514,14MAY2022:00:00:00,UFU GUTIERREZ,128,118,174,46,28,248,248,0,248,0,152,83,3,2,8,0,0,0,0,15,93,139,248
20220514,14MAY2022:00:00:00,UFU MUÑIZ,142,116,178,57,26,261,261,0,261,0,3,21,27,59,63,43,31,14,0,52,94,115,261
20220514,14MAY2022:00:00:00,UFU PIROVANO,344,205,423,72,57,552,552,0,552,0,3,26,57,145,111,103,67,40,0,153,193,206,552
20220514,14MAY2022:00:00:00,UFU PIÑERO,112,70,159,15,9,183,183,0,183,0,1,26,28,22,44,26,27,9,0,39,80,64,183
20220514,14MAY2022:00:00:00,UFU RAMOS MEJIA,160,121,239,20,22,281,281,0,281,0,14,31,28,77,45,41,27,18,0,46,133,102,281
20220514,14MAY2022:00:00:00,UFU RIVADAVIA,437,240,555,53,79,687,687,0,687,0,10,11,124,148,119,118,90,67,0,124,260,302,687
20220514,14MAY2022:00:00:00,UFU SANTOJANNI,265,169,274,115,53,442,442,0,442,0,10,32,50,79,103,55,86,27,0,96,136,209,442
20220514,14MAY2022:00:00:00,UFU TORNU,89,62,123,19,9,151,151,0,151,0,30,13,15,29,16,25,18,5,0,18,52,81,151
20220514,14MAY2022:00:00:00,UFU ZUBIZARRETA,277,185,344,89,34,467,467,0,467,0,5,44,43,73,113,60,90,39,0,81,186,200,467
20220515,15MAY2022:00:00:00,UFU ALVAREZ,218,182,340,35,80,455,455,0,455,0,55,30,42,99,93,77,42,17,0,116,171,168,455
20220515,15MAY2022:00:00:00,UFU ARGERICH,20,20,26,12,17,55,55,0,55,0,16,3,6,4,13,8,5,0,0,9,20,26,55
20220310,10MAR2022:00:00:00,UFU RAMOS MEJIA,205,174,254,70,55,379,379,0,379,0,0,15,114,100,63,49,25,13,0,8,201,170,379
20220310,10MAR2022:00:00:00,UFU RIVADAVIA,209,152,245,64,64,373,373,0,373,0,14,10,115,99,42,42,33,18,0,8,212,152,373
20220310,10MAR2022:00:00:00,UFU SANTOJANNI,127,113,129,74,37,240,240,0,240,0,1,39,58,40,48,17,23,14,0,10,106,124,240
20220310,10MAR2022:00:00:00,UFU TORNU,199,160,258,62,44,364,364,0,364,0,53,50,45,96,72,17,19,12,0,5,218,141,364
20220310,10MAR2022:00:00:00,UFU VELEZ SARSFIELD,170,178,255,70,25,350,350,0,350,0,2,26,88,98,50,44,15,27,0,5,230,115,350
20220310,10MAR2022:00:00:00,UFU ZUBIZARRETA,144,88,142,64,27,233,233,0,233,0,1,28,42,48,38,33,20,23,0,2,115,116,233
20220311,11MAR2022:00:00:00,UFU ALVAREZ,191,151,266,60,18,344,344,0,344,0,44,27,77,81,35,36,23,21,0,1,207,136,344
20220311,11MAR2022:00:00:00,UFU ARGERICH,32,53,45,40,3,88,88,0,88,0,9,1,17,26,14,8,10,3,0,0,34,54,88
20220311,11MAR2022:00:00:00,UFU BORDA-MOYANO,36,42,40,27,11,78,78,0,78,0,3,5,16,21,13,6,12,2,0,0,51,27,78
20220311,11MAR2022:00:00:00,UFU DURAND,140,146,244,14,29,287,287,0,287,0,1,29,64,74,47,34,15,23,0,5,160,122,287
20220311,11MAR2022:00:00:00,UFU ELIZALDE,121,111,70,145,21,236,236,0,236,0,152,71,5,3,4,1,0,0,0,2,107,127,236
20220311,11MAR2022:00:00:00,UFU FERNANDEZ,79,67,117,19,12,148,148,0,148,0,2,9,32,35,26,19,10,15,0,2,83,63,148
20220311,11MAR2022:00:00:00,UFU FERRER,129,106,112,112,12,236,236,0,236,0,4,9,84,48,35,43,11,2,0,2,172,62,236
20220311,11MAR2022:00:00:00,UFU GRIERSON,86,59,97,37,12,146,146,0,146,0,1,21,32,36,15,23,18,0,0,1,101,44,146
20220311,11MAR2022:00:00:00,UFU GUTIERREZ,208,192,276,84,43,403,403,0,403,0,231,143,8,9,10,2,0,0,0,0,286,117,403
20220311,11MAR2022:00:00:00,UFU MUÑIZ,117,116,116,92,30,238,238,0,238,0,10,14,46,52,48,53,10,5,0,3,164,71,238
20220311,11MAR2022:00:00:00,UFU PENNA,107,106,127,84,4,215,215,0,215,0,38,21,43,49,28,13,17,6,0,5,144,65,215
20220311,11MAR2022:00:00:00,UFU PIROVANO,135,134,189,50,33,272,272,0,272,0,3,16,80,63,52,22,16,20,0,11,148,113,272
20220311,11MAR2022:00:00:00,UFU PIÑERO,110,84,160,29,5,194,194,0,194,0,0,17,38,50,38,23,20,8,0,2,141,51,194
20220311,11MAR2022:00:00:00,UFU RAMOS MEJIA,156,106,212,28,23,263,263,0,263,0,1,5,56,71,58,29,35,8,0,4,171,88,263
20220311,11MAR2022:00:00:00,UFU RIVADAVIA,196,153,248,45,63,356,356,0,356,0,7,18,120,57,59,37,37,21,0,9,193,152,356
20220311,11MAR2022:00:00:00,UFU SANTOJANNI,138,136,154,97,27,278,278,0,278,0,6,45,64,55,35,33,23,17,0,9,155,114,278
20220311,11MAR2022:00:00:00,UFU TORNU,136,113,202,37,10,249,249,0,249,0,13,38,46,39,46,14,39,14,0,5,155,89,249
20220311,11MAR2022:00:00:00,UFU VELEZ SARSFIELD,143,122,200,45,20,265,265,0,265,0,0,24,77,70,46,21,22,5,0,5,166,94,265
20220311,11MAR2022:00:00:00,UFU ZUBIZARRETA,100,100,126,62,12,200,200,0,200,0,0,37,23,40,34,34,22,10,0,5,95,100,200
20220312,12MAR2022:00:00:00,UFU ALVAREZ,166,140,247,37,22,306,306,0,306,0,22,33,63,49,37,42,48,12,0,5,189,112,306
20220312,12MAR2022:00:00:00,UFU ARGERICH,50,32,54,25,3,82,82,0,82,0,0,5,17,21,17,10,8,4,0,1,44,37,82
20220312,12MAR2022:00:00:00,UFU BORDA-MOYANO,41,38,49,30,0,79,79,0,79,0,1,15,14,24,20,1,4,0,0,1,54,24,79
20220312,12MAR2022:00:00:00,UFU DURAND,91,62,130,19,4,153,153,0,153,0,0,5,27,39,35,26,16,5,0,3,89,61,153
20220312,12MAR2022:00:00:00,UFU ELIZALDE,91,112,92,108,3,203,203,0,203,0,129,60,2,9,2,1,0,0,0,3,98,102,203
20220312,12MAR2022:00:00:00,UFU FERNANDEZ,81,88,138,25,6,169,169,0,169,0,0,3,56,43,20,21,16,10,0,2,97,70,169
20220312,12MAR2022:00:00:00,UFU FERRER,104,56,85,69,6,160,160,0,160,0,0,3,34,64,23,15,10,11,0,1,117,42,160
20220312,12MAR2022:00:00:00,UFU GRIERSON,70,58,79,41,8,128,128,0,128,0,0,3,49,23,16,18,12,7,0,3,89,36,128
20220312,12MAR2022:00:00:00,UFU GUTIERREZ,190,158,221,106,21,348,348,0,348,0,213,102,4,6,19,4,0,0,0,3,247,97,348
20220312,12MAR2022:00:00:00,UFU MUÑIZ,79,126,109,86,11,206,206,0,206,0,7,17,30,42,46,39,20,5,0,6,138,61,206
20220312,12MAR2022:00:00:00,UFU PENNA,64,43,62,45,0,107,107,0,107,0,0,5,25,31,20,15,6,5,0,0,78,29,107
20220312,12MAR2022:00:00:00,UFU PIROVANO,148,128,214,34,28,276,276,0,276,0,0,17,68,72,43,29,22,25,0,8,149,119,276
20220312,12MAR2022:00:00:00,UFU PIÑERO,70,74,105,28,12,145,145,0,145,0,1,14,35,25,35,7,21,7,0,2,104,39,145
20220312,12MAR2022:00:00:00,UFU RAMOS MEJIA,118,130,180,39,29,248,248,0,248,0,6,33,67,65,29,25,13,10,0,3,140,105,248
20220312,12MAR2022:00:00:00,UFU RIVADAVIA,133,112,186,33,28,247,247,0,247,0,2,11,91,49,36,24,26,8,0,3,138,105,247
20220312,12MAR2022:00:00:00,UFU SANTOJANNI,96,76,104,62,6,172,172,0,172,0,0,23,28,39,24,30,20,8,0,8,94,70,172
20220312,12MAR2022:00:00:00,UFU TORNU,67,87,122,23,9,154,154,0,154,0,11,23,15,25,34,17,18,11,0,3,79,72,154
20220312,12MAR2022:00:00:00,UFU VELEZ SARSFIELD,123,93,165,45,6,216,216,0,216,0,0,28,59,43,30,28,7,21,0,7,124,85,216
20220312,12MAR2022:00:00:00,UFU ZUBIZARRETA,106,81,115,60,12,187,187,0,187,0,0,14,28,34,42,29,23,17,0,6,87,94,187
20220313,13MAR2022:00:00:00,UFU ALVAREZ,174,118,228,32,32,292,292,0,292,0,32,43,57,50,46,30,7,27,0,3,181,108,292
20220313,13MAR2022:00:00:00,UFU ARGERICH,25,30,32,21,2,55,55,0,55,0,7,5,10,12,8,6,5,2,0,2,27,26,55
20220313,13MAR2022:00:00:00,UFU BORDA-MOYANO,32,36,28,36,4,68,68,0,68,0,0,13,13,13,17,2,4,6,0,3,46,19,68
20220313,13MAR2022:00:00:00,UFU DURAND,103,90,174,14,7,195,195,0,195,0,2,11,32,58,54,14,16,8,0,8,101,86,195
20220313,13MAR2022:00:00:00,UFU ELIZALDE,113,107,90,121,9,220,220,0,220,0,122,69,2,10,10,5,2,0,0,4,109,107,220
20220313,13MAR2022:00:00:00,UFU FERNANDEZ,83,64,120,14,13,147,147,0,147,0,0,14,28,39,34,18,6,8,0,3,87,57,147
20220313,13MAR2022:00:00:00,UFU FERRER,103,70,83,87,3,173,173,0,173,0,0,0,32,45,41,18,23,14,0,0,120,53,173
20220313,13MAR2022:00:00:00,UFU GRIERSON,55,49,56,36,12,104,104,0,104,0,0,9,27,18,29,11,10,0,0,0,73,31,104
20220313,13MAR2022:00:00:00,UFU GUTIERREZ,194,203,269,93,35,397,397,0,397,0,216,145,2,8,21,5,0,0,0,10,254,133,397
20220313,13MAR2022:00:00:00,UFU MUÑIZ,112,88,94,87,19,200,200,0,200,0,6,22,18,30,61,40,23,0,0,3,139,58,200
20220313,13MAR2022:00:00:00,UFU PENNA,56,47,66,37,0,103,103,0,103,0,2,9,25,29,20,16,2,0,0,1,76,26,103
20220313,13MAR2022:00:00:00,UFU PIROVANO,163,98,189,46,26,261,261,0,261,0,0,16,49,63,51,35,23,24,0,13,135,113,261
20220313,13MAR2022:00:00:00,UFU PIÑERO,63,87,106,27,17,150,150,0,150,0,3,14,46,37,27,10,8,5,0,4,109,37,150
20220313,13MAR2022:00:00:00,UFU RAMOS MEJIA,121,117,179,27,32,238,238,0,238,0,14,36,55,48,30,37,12,6,0,5,135,98,238
20220313,13MAR2022:00:00:00,UFU RIVADAVIA,174,127,232,41,28,301,301,0,301,0,0,19,92,59,60,23,41,7,0,7,159,134,301
20220313,13MAR2022:00:00:00,UFU SANTOJANNI,116,88,101,84,19,204,204,0,204,0,0,28,36,51,48,20,10,11,0,5,106,93,204
20220313,13MAR2022:00:00:00,UFU TORNU,109,96,179,19,7,205,205,0,205,0,23,29,23,40,43,21,16,10,0,4,128,73,205
20220313,13MAR2022:00:00:00,UFU VELEZ SARSFIELD,156,123,191,72,16,279,279,0,279,0,0,29,44,79,48,34,34,11,0,6,192,81,279
20220313,13MAR2022:00:00:00,UFU ZUBIZARRETA,92,86,101,77,0,178,178,0,178,0,1,17,30,54,38,15,16,7,0,3,95,80,178
20220314,14MAR2022:00:00:00,UFU ALVAREZ,281,231,405,62,45,512,512,0,512,0,61,74,103,91,67,66,27,23,0,8,291,213,512
20220314,14MAR2022:00:00:00,UFU ARGERICH,63,62,66,49,10,125,125,0,125,0,16,17,19,24,12,10,18,9,0,2,61,61,125
20220515,15MAY2022:00:00:00,UFU DURAND,262,201,428,11,104,543,543,0,543,0,80,24,61,106,107,93,50,22,0,145,181,217,543
20220515,15MAY2022:00:00:00,UFU GUTIERREZ,110,84,139,38,47,224,224,0,224,0,139,70,1,7,7,0,0,0,0,15,116,93,224
20220515,15MAY2022:00:00:00,UFU MUÑIZ,74,49,72,47,16,135,135,0,135,0,12,7,17,28,31,26,5,9,0,23,53,59,135
20220515,15MAY2022:00:00:00,UFU PIROVANO,266,165,341,60,83,484,484,0,484,0,53,33,55,107,99,76,43,18,0,115,182,187,484
20220515,15MAY2022:00:00:00,UFU PIÑERO,56,33,79,8,22,109,109,0,109,0,20,5,11,24,14,19,11,5,0,21,40,48,109
20220515,15MAY2022:00:00:00,UFU RAMOS MEJIA,198,145,297,28,91,416,416,0,416,0,98,33,45,61,84,35,37,23,0,71,159,186,416
20220515,15MAY2022:00:00:00,UFU RIVADAVIA,376,269,522,83,136,741,741,0,741,0,99,29,113,140,108,102,94,56,0,140,288,313,741
20220515,15MAY2022:00:00:00,UFU SANTOJANNI,168,133,193,86,78,357,357,0,357,0,56,37,27,74,66,43,36,18,0,68,127,162,357
20220515,15MAY2022:00:00:00,UFU TORNU,57,58,106,7,15,128,128,0,128,0,22,10,18,27,20,15,8,8,0,24,52,52,128
20220515,15MAY2022:00:00:00,UFU ZUBIZARRETA,248,170,348,63,84,495,495,0,495,0,78,22,45,93,100,91,45,21,0,123,154,218,495
20220516,16MAY2022:00:00:00,UFU ALVAREZ,293,200,395,61,39,495,495,0,495,0,2,41,90,137,81,73,48,23,0,113,230,152,495
20220516,16MAY2022:00:00:00,UFU ARGERICH,129,82,144,55,12,211,211,0,211,0,5,12,39,40,58,27,21,9,0,29,86,96,211
20220516,16MAY2022:00:00:00,UFU DURAND,383,254,554,40,45,639,639,0,639,0,5,34,141,155,149,77,58,20,0,145,300,194,639
20220516,16MAY2022:00:00:00,UFU GUTIERREZ,191,182,193,163,22,378,378,0,378,0,232,91,9,16,20,10,0,0,0,23,191,164,378
20220516,16MAY2022:00:00:00,UFU MUÑIZ,123,105,148,58,24,230,230,0,230,0,3,24,30,72,30,42,22,7,0,44,88,98,230
20220516,16MAY2022:00:00:00,UFU PENNA,67,48,75,32,10,117,117,0,117,0,2,2,25,31,26,12,14,5,0,18,63,36,117
20220516,16MAY2022:00:00:00,UFU PIROVANO,348,282,500,63,71,634,634,0,634,0,4,34,114,179,154,77,47,25,0,185,244,205,634
20220516,16MAY2022:00:00:00,UFU PIÑERO,140,72,188,9,15,212,212,0,212,0,0,7,29,38,53,45,31,9,0,42,103,67,212
20220516,16MAY2022:00:00:00,UFU RAMOS MEJIA,164,97,200,26,36,262,262,0,262,0,1,3,40,73,46,54,28,17,0,47,134,81,262
20220516,16MAY2022:00:00:00,UFU RIVADAVIA,545,304,637,112,104,853,853,0,853,0,4,27,182,225,153,136,82,44,0,150,401,301,853
20220516,16MAY2022:00:00:00,UFU SANTOJANNI,344,246,411,138,43,592,592,0,592,0,11,41,65,145,155,91,60,24,0,181,177,232,592
20220516,16MAY2022:00:00:00,UFU ZUBIZARRETA,247,184,315,62,57,434,434,0,434,0,3,21,57,116,101,68,47,21,0,123,145,166,434
20220517,17MAY2022:00:00:00,UFU ALVAREZ,296,215,421,41,56,518,518,0,518,0,7,29,82,147,104,67,48,34,0,124,219,175,518
20220517,17MAY2022:00:00:00,UFU ARGERICH,78,69,116,20,16,152,152,0,152,0,7,6,37,23,33,25,2,19,0,18,64,70,152
20220517,17MAY2022:00:00:00,UFU DURAND,328,262,490,41,72,603,603,0,603,0,13,44,111,170,103,83,46,33,0,125,285,193,603
20220517,17MAY2022:00:00:00,UFU GUTIERREZ,197,152,221,97,46,364,364,0,364,0,200,96,4,16,29,16,3,0,0,22,179,163,364
20220517,17MAY2022:00:00:00,UFU MUÑIZ,136,120,144,93,30,267,267,0,267,0,17,29,32,57,60,47,17,8,0,39,113,115,267
20220517,17MAY2022:00:00:00,UFU PENNA,62,38,79,15,7,101,101,0,101,0,3,8,24,20,20,18,5,3,0,25,39,37,101
20220517,17MAY2022:00:00:00,UFU PIROVANO,361,261,498,46,92,636,636,0,636,0,14,34,123,148,137,90,58,32,0,164,221,251,636
20220517,17MAY2022:00:00:00,UFU PIÑERO,128,99,186,21,28,235,235,0,235,0,9,16,52,52,47,24,25,10,0,38,123,74,235
20220517,17MAY2022:00:00:00,UFU RAMOS MEJIA,169,115,228,30,36,294,294,0,294,0,10,8,38,73,64,48,30,23,0,54,146,94,294
20220517,17MAY2022:00:00:00,UFU RIVADAVIA,496,298,584,128,122,834,834,0,834,0,40,39,155,199,146,137,76,42,0,153,360,318,834
20220517,17MAY2022:00:00:00,UFU SANTOJANNI,421,283,515,134,75,724,724,0,724,0,31,55,101,154,127,108,103,45,0,202,207,312,724
20220517,17MAY2022:00:00:00,UFU ZUBIZARRETA,202,111,207,73,48,328,328,0,328,0,15,19,43,81,60,62,17,31,0,89,118,121,328
20220518,18MAY2022:00:00:00,UFU ALVAREZ,243,169,362,21,30,413,413,0,413,0,1,34,27,86,126,58,46,35,0,104,187,122,413
20220518,18MAY2022:00:00:00,UFU DURAND,224,144,341,6,21,368,368,0,368,0,0,20,59,95,85,56,33,20,0,97,154,117,368
20220518,18MAY2022:00:00:00,UFU GUTIERREZ,60,44,80,19,6,105,105,0,105,0,53,46,2,0,1,2,1,0,0,6,58,41,105
20220518,18MAY2022:00:00:00,UFU MUÑIZ,66,49,73,25,19,117,117,0,117,0,6,3,20,25,18,27,12,6,0,23,47,47,117
20220518,18MAY2022:00:00:00,UFU PIROVANO,262,201,379,41,48,468,468,0,468,0,5,17,80,118,111,81,31,25,0,136,169,163,468
20220518,18MAY2022:00:00:00,UFU PIÑERO,48,30,58,13,8,79,79,0,79,0,1,5,7,9,19,17,13,8,0,18,40,21,79
20220518,18MAY2022:00:00:00,UFU RAMOS MEJIA,97,75,150,9,16,175,175,0,175,0,9,7,21,33,59,30,14,2,0,38,79,58,175
20220518,18MAY2022:00:00:00,UFU RIVADAVIA,309,219,438,52,41,531,531,0,531,0,3,28,118,98,93,86,68,37,0,140,223,168,531
20220518,18MAY2022:00:00:00,UFU SANTOJANNI,189,131,231,65,30,326,326,0,326,0,6,35,35,58,82,50,36,24,0,86,106,134,326
20220518,18MAY2022:00:00:00,UFU ZUBIZARRETA,185,158,263,57,26,346,346,0,346,0,3,25,28,62,82,76,47,23,0,95,135,116,346
20220519,19MAY2022:00:00:00,UFU ALVAREZ,387,263,542,49,63,654,654,0,654,0,4,40,125,148,122,111,65,39,0,147,292,215,654
20220519,19MAY2022:00:00:00,UFU ARGERICH,134,78,153,39,21,213,213,0,213,0,3,12,35,60,50,25,20,8,0,48,86,79,213
20220519,19MAY2022:00:00:00,UFU DURAND,444,298,665,36,45,746,746,0,746,0,4,38,183,190,146,90,61,34,0,189,327,230,746
20220519,19MAY2022:00:00:00,UFU GUTIERREZ,192,221,243,135,36,414,414,0,414,0,244,108,2,23,14,14,9,0,0,24,211,178,414
20220519,19MAY2022:00:00:00,UFU MUÑIZ,185,151,211,82,45,338,338,0,338,0,8,32,57,69,66,61,37,8,0,37,144,157,338
20220519,19MAY2022:00:00:00,UFU PENNA,73,49,80,35,9,124,124,0,124,0,2,7,18,31,32,21,10,3,0,29,57,38,124
20220519,19MAY2022:00:00:00,UFU PIROVANO,433,286,566,63,93,722,722,0,722,0,3,30,123,217,146,102,58,43,0,189,287,246,722
20220519,19MAY2022:00:00:00,UFU PIÑERO,164,99,208,30,25,263,263,0,263,0,0,12,37,59,50,42,33,30,0,41,137,85,263
20220519,19MAY2022:00:00:00,UFU RAMOS MEJIA,254,140,316,43,38,397,397,0,397,0,3,9,60,97,94,59,39,36,0,73,192,132,397
20220519,19MAY2022:00:00:00,UFU RIVADAVIA,779,411,910,147,142,1199,1199,0,1199,0,9,41,303,298,208,167,105,68,0,247,479,473,1199
20220519,19MAY2022:00:00:00,UFU SANTOJANNI,396,275,464,164,48,676,676,0,676,0,5,38,89,150,151,135,57,51,0,254,214,207,676
20220519,19MAY2022:00:00:00,UFU ZUBIZARRETA,189,125,216,65,33,314,314,0,314,0,0,23,45,66,65,69,30,16,0,43,47,224,314
20220520,20MAY2022:00:00:00,UFU ALVAREZ,358,224,492,54,92,638,638,0,638,0,56,39,95,108,112,106,66,56,0,152,259,227,638
20220520,20MAY2022:00:00:00,UFU ARGERICH,117,68,111,56,25,192,192,0,192,0,7,5,38,49,37,35,16,5,0,25,74,93,192
20220520,20MAY2022:00:00:00,UFU DURAND,455,256,638,37,110,785,785,0,785,0,74,30,102,215,159,92,64,49,0,183,312,290,785
20220520,20MAY2022:00:00:00,UFU GUTIERREZ,150,129,187,74,26,287,287,0,287,0,149,93,6,10,16,8,5,0,0,19,146,122,287
20220520,20MAY2022:00:00:00,UFU MUÑIZ,182,174,202,131,53,386,386,0,386,0,34,31,72,90,73,54,24,8,0,37,165,184,386
20220520,20MAY2022:00:00:00,UFU PENNA,87,52,91,31,19,141,141,0,141,0,5,5,28,33,18,31,12,9,0,37,53,51,141
20220520,20MAY2022:00:00:00,UFU PIROVANO,410,225,502,91,122,715,715,0,715,0,80,27,116,147,140,96,70,39,0,152,260,303,715
20220520,20MAY2022:00:00:00,UFU PIÑERO,165,123,244,31,16,291,291,0,291,0,3,25,40,42,57,42,46,36,0,54,137,100,291
20220314,14MAR2022:00:00:00,UFU BORDA-MOYANO,37,37,33,36,5,74,74,0,74,0,3,4,15,13,13,16,5,5,0,1,45,28,74
20220314,14MAR2022:00:00:00,UFU DURAND,170,136,277,21,8,306,306,0,306,0,0,33,57,89,62,40,21,4,0,14,163,129,306
20220314,14MAR2022:00:00:00,UFU ELIZALDE,142,124,82,181,3,266,266,0,266,0,153,83,11,12,7,0,0,0,0,1,137,128,266
20220314,14MAR2022:00:00:00,UFU FERNANDEZ,137,94,170,33,28,231,231,0,231,0,0,14,55,63,33,34,27,5,0,5,130,96,231
20220314,14MAR2022:00:00:00,UFU FERRER,141,85,95,105,26,226,226,0,226,0,0,4,63,71,47,31,10,0,0,2,164,60,226
20220314,14MAR2022:00:00:00,UFU GRIERSON,72,85,103,41,13,157,157,0,157,0,3,11,30,39,29,30,8,7,0,1,107,49,157
20220314,14MAR2022:00:00:00,UFU GUTIERREZ,315,266,381,152,48,581,581,0,581,0,320,193,12,25,19,12,0,0,0,4,389,188,581
20220314,14MAR2022:00:00:00,UFU MUÑIZ,140,172,177,127,8,312,312,0,312,0,12,23,57,82,56,54,25,3,0,1,217,93,312
20220314,14MAR2022:00:00:00,UFU PENNA,113,89,126,76,3,205,205,0,205,0,12,46,39,54,20,13,10,11,0,2,156,47,205
20220314,14MAR2022:00:00:00,UFU PIROVANO,214,171,266,49,70,385,385,0,385,0,0,21,110,101,62,49,24,18,0,12,213,160,385
20220314,14MAR2022:00:00:00,UFU PIÑERO,128,110,205,27,6,238,238,0,238,0,0,32,76,46,42,33,6,3,0,1,181,55,238
20220314,14MAR2022:00:00:00,UFU RAMOS MEJIA,227,184,248,131,32,411,411,0,411,0,3,19,91,100,80,56,43,19,0,1,245,165,411
20220314,14MAR2022:00:00:00,UFU RIVADAVIA,255,193,326,76,50,452,452,0,452,0,4,28,159,95,60,57,30,19,0,15,246,190,452
20220314,14MAR2022:00:00:00,UFU SANTOJANNI,182,155,197,118,22,337,337,0,337,0,4,46,80,67,57,34,36,13,0,6,194,137,337
20220314,14MAR2022:00:00:00,UFU TORNU,231,166,311,65,21,397,397,0,397,0,58,57,49,90,44,35,38,26,0,2,258,137,397
20220314,14MAR2022:00:00:00,UFU VELEZ SARSFIELD,240,235,345,108,22,475,475,0,475,0,0,48,112,109,105,60,16,25,0,11,309,155,475
20220314,14MAR2022:00:00:00,UFU ZUBIZARRETA,170,131,171,110,21,302,302,0,302,0,3,48,60,70,53,36,9,23,0,5,146,151,302
20220315,15MAR2022:00:00:00,UFU ALVAREZ,213,221,316,95,23,434,434,0,434,0,72,64,73,71,58,46,23,27,0,3,284,147,434
20220315,15MAR2022:00:00:00,UFU ARGERICH,51,41,48,40,4,92,92,0,92,0,6,8,28,24,8,12,4,2,0,1,48,42,92
20220315,15MAR2022:00:00:00,UFU BORDA-MOYANO,23,46,41,22,6,69,69,0,69,0,0,5,15,21,7,13,5,3,0,2,45,22,69
20220315,15MAR2022:00:00:00,UFU DURAND,151,138,241,33,15,289,289,0,289,0,0,29,61,85,60,24,17,13,0,11,159,119,289
20220315,15MAR2022:00:00:00,UFU ELIZALDE,105,139,69,166,9,244,244,0,244,0,127,94,7,5,9,2,0,0,0,1,123,120,244
20220315,15MAR2022:00:00:00,UFU FERNANDEZ,91,95,140,21,25,186,186,0,186,0,0,8,68,43,30,17,12,8,0,5,92,89,186
20220315,15MAR2022:00:00:00,UFU FERRER,141,120,116,129,16,261,261,0,261,0,0,0,49,111,38,42,12,9,0,11,190,60,261
20220315,15MAR2022:00:00:00,UFU GRIERSON,72,71,85,38,20,143,143,0,143,0,0,27,28,22,39,14,10,3,0,1,104,38,143
20220315,15MAR2022:00:00:00,UFU GUTIERREZ,290,265,390,131,34,555,555,0,555,0,334,176,5,19,13,2,6,0,0,1,401,153,555
20220315,15MAR2022:00:00:00,UFU MUÑIZ,140,183,164,124,35,323,323,0,323,0,4,21,66,81,66,47,23,15,0,6,227,90,323
20220315,15MAR2022:00:00:00,UFU PENNA,101,94,91,95,9,195,195,0,195,0,49,17,60,32,16,10,7,4,0,0,142,53,195
20220315,15MAR2022:00:00:00,UFU PIROVANO,163,153,235,38,43,316,316,0,316,0,0,24,53,100,65,38,22,14,0,10,183,123,316
20220315,15MAR2022:00:00:00,UFU PIÑERO,131,131,186,49,27,262,262,0,262,0,0,28,52,63,46,41,27,5,0,4,186,72,262
20220315,15MAR2022:00:00:00,UFU RAMOS MEJIA,190,160,246,66,38,350,350,0,350,0,0,9,108,73,59,48,27,26,0,12,208,130,350
20220315,15MAR2022:00:00:00,UFU RIVADAVIA,208,164,255,73,44,372,372,0,372,0,0,13,112,84,37,48,46,32,0,11,210,150,372
20220315,15MAR2022:00:00:00,UFU SANTOJANNI,158,124,176,79,27,282,282,0,282,0,0,59,42,64,53,30,17,17,0,9,153,120,282
20220315,15MAR2022:00:00:00,UFU TORNU,201,171,301,46,25,372,372,0,372,0,50,44,57,89,63,41,21,7,0,2,245,124,372
20220315,15MAR2022:00:00:00,UFU VELEZ SARSFIELD,196,147,262,54,27,343,343,0,343,0,0,31,72,95,68,36,16,25,0,6,248,89,343
20220315,15MAR2022:00:00:00,UFU ZUBIZARRETA,96,96,122,59,11,192,192,0,192,0,0,25,42,46,34,11,26,8,0,3,100,89,192
20220316,16MAR2022:00:00:00,UFU ALVAREZ,203,187,309,51,30,390,390,0,390,0,50,91,63,71,56,27,17,15,0,7,202,181,390
20220316,16MAR2022:00:00:00,UFU ARGERICH,72,62,73,56,5,134,134,0,134,0,33,13,28,24,10,8,8,10,0,5,62,67,134
20220316,16MAR2022:00:00:00,UFU BORDA-MOYANO,37,51,52,33,3,88,88,0,88,0,4,3,14,21,12,17,8,9,0,1,54,33,88
20220316,16MAR2022:00:00:00,UFU DURAND,154,95,217,24,9,250,250,0,250,0,1,18,63,68,32,22,32,14,0,9,145,96,250
20220316,16MAR2022:00:00:00,UFU ELIZALDE,97,108,58,145,2,205,205,0,205,0,120,69,4,8,3,1,0,0,0,0,108,97,205
20220316,16MAR2022:00:00:00,UFU FERNANDEZ,94,80,138,19,17,174,174,0,174,0,0,10,36,48,33,22,14,11,0,1,102,71,174
20220316,16MAR2022:00:00:00,UFU FERRER,87,81,84,66,18,168,168,0,168,0,0,0,42,54,32,15,20,5,0,4,121,43,168
20220316,16MAR2022:00:00:00,UFU GRIERSON,41,32,52,7,14,73,73,0,73,0,0,13,14,19,9,11,7,0,0,0,56,17,73
20220316,16MAR2022:00:00:00,UFU GUTIERREZ,273,227,363,114,24,501,501,0,501,0,272,166,9,18,34,2,0,0,0,4,349,147,501
20220316,16MAR2022:00:00:00,UFU MUÑIZ,153,125,131,121,26,278,278,0,278,0,9,26,39,60,76,45,15,8,0,6,196,75,278
20220316,16MAR2022:00:00:00,UFU PENNA,103,139,120,116,6,242,242,0,242,0,46,33,41,52,32,22,14,2,0,3,175,64,242
20220316,16MAR2022:00:00:00,UFU PIROVANO,194,181,279,51,46,376,376,0,376,0,1,29,106,89,65,37,33,16,0,14,210,152,376
20220316,16MAR2022:00:00:00,UFU PIÑERO,168,122,232,46,12,290,290,0,290,0,0,30,54,81,64,28,29,4,0,0,211,79,290
20220316,16MAR2022:00:00:00,UFU RAMOS MEJIA,178,122,227,47,26,300,300,0,300,0,6,7,82,76,43,28,34,24,0,7,154,139,300
20220316,16MAR2022:00:00:00,UFU RIVADAVIA,201,147,257,62,31,350,350,0,350,0,2,22,114,83,46,44,26,13,0,12,191,147,350
20220316,16MAR2022:00:00:00,UFU SANTOJANNI,158,119,176,79,22,277,277,0,277,0,6,35,63,62,47,25,20,19,0,11,157,109,277
20220316,16MAR2022:00:00:00,UFU TORNU,220,169,319,70,0,389,389,0,389,0,63,67,58,71,43,26,28,33,0,4,246,135,389
20220316,16MAR2022:00:00:00,UFU VELEZ SARSFIELD,189,148,252,48,38,338,338,0,338,0,1,27,81,93,66,21,41,8,0,3,230,105,338
20220316,16MAR2022:00:00:00,UFU ZUBIZARRETA,122,128,157,76,17,250,250,0,250,0,0,23,51,66,42,37,14,17,0,8,117,125,250
20220317,17MAR2022:00:00:00,UFU ALVAREZ,170,127,234,49,15,298,298,0,298,0,43,31,54,49,54,29,27,11,0,5,149,144,298
20220317,17MAR2022:00:00:00,UFU ARGERICH,41,51,57,33,2,92,92,0,92,0,2,6,25,25,18,6,4,6,0,0,48,44,92
20220317,17MAR2022:00:00:00,UFU BORDA-MOYANO,55,29,57,24,4,85,85,0,85,0,4,5,15,27,17,11,6,0,0,0,47,38,85
20220317,17MAR2022:00:00:00,UFU DURAND,177,123,264,22,15,301,301,0,301,0,1,25,74,77,48,22,39,15,0,10,154,137,301
20220317,17MAR2022:00:00:00,UFU ELIZALDE,134,114,61,182,5,248,248,0,248,0,162,63,8,8,2,3,1,1,0,1,112,135,248
20220317,17MAR2022:00:00:00,UFU FERNANDEZ,81,58,105,9,25,139,139,0,139,0,0,5,39,40,19,14,13,9,0,5,73,61,139
20220317,17MAR2022:00:00:00,UFU FERRER,106,77,97,83,3,183,183,0,183,0,0,9,63,47,37,14,10,3,0,0,130,53,183
20220317,17MAR2022:00:00:00,UFU GRIERSON,39,19,36,22,0,58,58,0,58,0,0,5,21,9,20,0,3,0,0,0,42,16,58
20220317,17MAR2022:00:00:00,UFU GUTIERREZ,183,189,260,97,15,372,372,0,372,0,216,128,5,6,14,2,0,1,0,1,246,125,372
20220317,17MAR2022:00:00:00,UFU MUÑIZ,115,102,99,102,17,218,218,0,218,0,2,21,55,38,45,29,20,8,0,2,143,72,218
20220520,20MAY2022:00:00:00,UFU RAMOS MEJIA,223,137,295,41,25,361,361,0,361,0,1,8,57,88,76,60,46,25,0,73,173,115,361
20220520,20MAY2022:00:00:00,UFU RIVADAVIA,710,392,848,148,203,1199,1199,0,1199,0,97,25,245,273,206,161,110,82,0,222,442,535,1199
20220520,20MAY2022:00:00:00,UFU SANTOJANNI,402,272,447,180,52,679,679,0,679,0,5,42,87,155,143,104,92,51,0,193,204,280,679
20220520,20MAY2022:00:00:00,UFU ZUBIZARRETA,225,161,281,86,57,424,424,0,424,0,38,20,49,87,68,81,54,27,0,105,161,158,424
20220521,21MAY2022:00:00:00,UFU ALVAREZ,336,269,512,71,160,743,743,0,743,0,138,45,98,140,113,100,70,39,0,150,260,333,743
20220521,21MAY2022:00:00:00,UFU ARGERICH,37,19,32,20,16,68,68,0,68,0,12,5,14,14,9,10,3,1,0,9,29,30,68
20220521,21MAY2022:00:00:00,UFU DURAND,368,256,563,41,180,784,784,0,784,0,160,34,102,146,134,103,61,44,0,164,280,340,784
20220521,21MAY2022:00:00:00,UFU GUTIERREZ,69,84,92,59,36,187,187,0,187,0,140,38,0,4,4,0,1,0,0,10,90,87,187
20220521,21MAY2022:00:00:00,UFU MUÑIZ,144,123,178,83,56,317,317,0,317,0,50,19,50,54,39,55,42,8,0,50,122,145,317
20220521,21MAY2022:00:00:00,UFU PIROVANO,345,223,471,69,181,721,721,0,721,0,153,20,73,122,110,110,79,54,0,154,245,322,721
20220521,21MAY2022:00:00:00,UFU PIÑERO,2,0,2,0,0,2,2,0,2,0,0,0,0,0,0,0,2,0,0,0,1,1,2
20220521,21MAY2022:00:00:00,UFU RAMOS MEJIA,200,146,294,27,114,435,435,0,435,0,117,46,40,53,66,41,45,27,0,65,147,219,435
20220521,21MAY2022:00:00:00,UFU RIVADAVIA,506,288,654,82,272,1008,1008,0,1008,0,214,26,141,188,148,126,80,85,0,187,363,458,1008
20220521,21MAY2022:00:00:00,UFU SANTOJANNI,299,183,317,145,124,586,586,0,586,0,104,40,50,85,108,98,67,34,0,129,172,285,586
20220521,21MAY2022:00:00:00,UFU TORNU,8,8,14,2,4,20,20,0,20,0,5,0,3,2,6,3,1,0,0,0,11,9,20
20220521,21MAY2022:00:00:00,UFU ZUBIZARRETA,266,176,343,89,135,567,567,0,567,0,125,19,59,73,88,102,59,42,0,115,200,252,567
20220522,22MAY2022:00:00:00,UFU ALVAREZ,343,241,516,48,107,671,671,0,671,0,87,39,65,123,128,100,76,53,0,135,271,265,671
20220522,22MAY2022:00:00:00,UFU ARGERICH,23,23,40,6,11,57,57,0,57,0,11,0,4,5,10,11,9,7,0,11,19,27,57
20220522,22MAY2022:00:00:00,UFU DURAND,366,239,556,25,121,702,702,0,702,0,97,37,80,145,120,117,70,36,0,154,271,277,702
20220522,22MAY2022:00:00:00,UFU GUTIERREZ,95,92,134,49,41,224,224,0,224,0,139,67,0,6,9,3,0,0,0,27,91,106,224
20220522,22MAY2022:00:00:00,UFU MUÑIZ,130,103,154,69,66,289,289,0,289,0,58,18,17,61,58,40,26,11,0,56,110,123,289
20220522,22MAY2022:00:00:00,UFU PIROVANO,304,204,417,62,100,579,579,0,579,0,71,19,70,115,116,82,60,46,0,147,210,222,579
20220522,22MAY2022:00:00:00,UFU PIÑERO,97,94,154,30,41,225,225,0,225,0,38,5,18,26,45,38,34,21,0,31,94,100,225
20220522,22MAY2022:00:00:00,UFU RAMOS MEJIA,197,131,285,21,84,390,390,0,390,0,69,15,37,78,76,41,49,25,0,71,166,152,390
20220522,22MAY2022:00:00:00,UFU RIVADAVIA,510,316,668,92,208,968,968,0,968,0,142,39,147,172,163,127,108,70,0,191,386,391,968
20220522,22MAY2022:00:00:00,UFU SANTOJANNI,260,175,316,100,92,508,508,0,508,0,73,40,40,93,100,83,52,27,0,123,179,206,508
20220522,22MAY2022:00:00:00,UFU ZUBIZARRETA,272,184,355,92,81,528,528,0,528,0,73,33,36,86,117,67,76,40,0,118,194,216,528
20220523,23MAY2022:00:00:00,UFU ALVAREZ,445,259,588,78,44,710,710,0,710,0,6,61,137,169,148,103,56,30,0,144,331,235,710
20220523,23MAY2022:00:00:00,UFU ARGERICH,140,84,166,47,11,224,224,0,224,0,3,11,36,49,63,23,30,9,0,40,89,95,224
20220523,23MAY2022:00:00:00,UFU DURAND,510,331,723,57,65,845,845,0,845,0,4,49,160,193,173,136,81,49,0,222,370,253,845
20220523,23MAY2022:00:00:00,UFU GUTIERREZ,210,141,225,107,23,355,355,0,355,0,185,103,5,23,24,11,2,2,0,20,184,151,355
20220523,23MAY2022:00:00:00,UFU MUÑIZ,228,180,239,142,31,412,412,0,412,0,8,31,80,117,61,70,36,9,0,74,161,177,412
20220523,23MAY2022:00:00:00,UFU PENNA,101,75,121,45,12,178,178,0,178,0,5,10,33,44,42,27,11,6,0,45,77,56,178
20220523,23MAY2022:00:00:00,UFU PIROVANO,411,276,516,97,80,693,693,0,693,0,6,35,120,197,135,96,56,48,0,171,283,239,693
20220523,23MAY2022:00:00:00,UFU PIÑERO,158,111,222,38,10,270,270,0,270,0,1,20,41,47,50,49,34,28,0,46,149,75,270
20220523,23MAY2022:00:00:00,UFU RAMOS MEJIA,209,150,294,42,27,363,363,0,363,0,4,3,57,63,99,48,49,40,0,59,184,120,363
20220523,23MAY2022:00:00:00,UFU RIVADAVIA,752,448,874,214,120,1208,1208,0,1208,0,8,69,240,291,225,178,128,69,0,211,582,415,1208
20220523,23MAY2022:00:00:00,UFU SANTOJANNI,339,298,452,151,37,640,640,0,640,0,3,36,90,137,141,105,78,50,0,200,198,241,640
20220523,23MAY2022:00:00:00,UFU ZUBIZARRETA,300,202,342,122,43,507,507,0,507,0,5,16,75,99,120,83,73,36,0,114,219,174,507
20220524,24MAY2022:00:00:00,UFU ALVAREZ,389,290,594,56,29,679,679,0,679,0,0,45,107,150,142,109,79,47,0,142,326,211,679
20220524,24MAY2022:00:00:00,UFU ARGERICH,143,91,185,45,5,235,235,0,235,0,6,18,46,32,60,37,24,12,0,39,95,101,235
20220524,24MAY2022:00:00:00,UFU DURAND,510,335,748,47,50,845,845,0,845,0,0,58,181,166,179,130,83,48,0,200,348,296,845
20220524,24MAY2022:00:00:00,UFU GUTIERREZ,171,180,196,136,19,351,351,0,351,0,192,115,10,14,14,6,0,0,0,17,188,146,351
20220524,24MAY2022:00:00:00,UFU MUÑIZ,205,154,227,106,27,360,360,0,360,0,8,25,48,86,67,67,38,21,0,54,163,143,360
20220524,24MAY2022:00:00:00,UFU PENNA,100,58,115,35,8,158,158,0,158,0,6,16,13,33,30,31,21,8,0,39,68,51,158
20220524,24MAY2022:00:00:00,UFU PIROVANO,361,253,479,83,52,614,614,0,614,0,0,40,120,180,110,82,58,24,0,159,250,205,614
20220524,24MAY2022:00:00:00,UFU PIÑERO,149,104,195,46,12,253,253,0,253,0,2,16,45,59,60,30,28,13,0,40,128,85,253
20220524,24MAY2022:00:00:00,UFU RAMOS MEJIA,215,131,276,40,32,348,348,0,348,0,2,7,55,80,87,58,37,22,0,63,178,107,348
20220524,24MAY2022:00:00:00,UFU RIVADAVIA,698,394,828,148,119,1095,1095,0,1095,0,5,35,275,258,209,130,103,80,0,211,480,402,1095
20220524,24MAY2022:00:00:00,UFU SANTOJANNI,407,324,498,188,47,733,733,0,733,0,2,57,133,158,163,92,85,43,0,204,254,275,733
20220524,24MAY2022:00:00:00,UFU ZUBIZARRETA,222,165,284,84,19,387,387,0,387,0,0,27,58,90,82,60,45,25,0,90,160,137,387
20220525,25MAY2022:00:00:00,UFU ALVAREZ,263,203,414,41,11,466,466,0,466,0,0,46,74,100,92,87,44,23,0,101,231,134,466
20220525,25MAY2022:00:00:00,UFU ARGERICH,37,18,41,12,2,55,55,0,55,0,0,3,1,11,8,18,9,5,0,16,18,21,55
20220525,25MAY2022:00:00:00,UFU DURAND,231,148,345,18,16,379,379,0,379,0,2,20,75,102,81,50,33,16,0,113,163,103,379
20220525,25MAY2022:00:00:00,UFU GUTIERREZ,50,45,65,24,6,95,95,0,95,0,58,25,2,4,3,3,0,0,0,13,51,31,95
20220525,25MAY2022:00:00:00,UFU MUÑIZ,123,113,150,79,7,236,236,0,236,0,3,14,44,57,64,38,10,6,0,61,98,77,236
20220525,25MAY2022:00:00:00,UFU PIROVANO,299,218,437,50,30,517,517,0,517,0,0,14,106,123,111,88,41,34,0,149,219,149,517
20220525,25MAY2022:00:00:00,UFU PIÑERO,99,68,139,18,10,167,167,0,167,0,0,17,36,34,26,28,11,15,0,35,84,48,167
20220525,25MAY2022:00:00:00,UFU RAMOS MEJIA,133,96,198,19,12,229,229,0,229,0,11,24,35,46,47,41,14,11,0,49,115,65,229
20220525,25MAY2022:00:00:00,UFU RIVADAVIA,383,261,524,68,52,644,644,0,644,0,0,24,149,133,127,102,58,51,0,167,286,191,644
20220525,25MAY2022:00:00:00,UFU SANTOJANNI,245,160,289,109,7,405,405,0,405,0,0,35,66,93,97,61,37,16,0,92,199,114,405
20220525,25MAY2022:00:00:00,UFU ZUBIZARRETA,219,144,289,69,5,363,363,0,363,0,0,21,65,89,73,55,46,14,0,92,165,106,363
20220526,26MAY2022:00:00:00,UFU ALVAREZ,318,207,452,45,28,525,525,0,525,0,0,47,111,110,97,84,47,29,0,93,266,166,525
20220526,26MAY2022:00:00:00,UFU ARGERICH,111,58,122,41,6,169,169,0,169,0,0,4,41,49,29,33,7,6,0,31,79,59,169
20220317,17MAR2022:00:00:00,UFU PENNA,75,57,87,42,3,132,132,0,132,0,17,6,30,31,22,12,12,2,0,0,99,33,132
20220317,17MAR2022:00:00:00,UFU PIROVANO,178,134,241,37,35,313,313,0,313,0,1,28,51,72,89,24,22,26,0,14,151,148,313
20220317,17MAR2022:00:00:00,UFU PIÑERO,116,112,188,24,16,228,228,0,228,0,0,34,75,43,28,28,13,7,0,3,168,56,228
20220317,17MAR2022:00:00:00,UFU RAMOS MEJIA,120,119,155,57,30,242,242,0,242,0,3,7,68,42,50,31,34,7,0,5,141,96,242
20220317,17MAR2022:00:00:00,UFU RIVADAVIA,172,149,230,67,24,321,321,0,321,0,0,8,119,71,46,39,19,19,0,6,162,153,321
20220317,17MAR2022:00:00:00,UFU SANTOJANNI,167,159,203,106,17,326,326,0,326,0,0,68,75,66,54,21,30,12,0,10,164,152,326
20220317,17MAR2022:00:00:00,UFU TORNU,156,123,224,37,18,279,279,0,279,0,30,55,43,47,42,28,20,14,0,8,162,109,279
20220317,17MAR2022:00:00:00,UFU VELEZ SARSFIELD,163,149,244,43,25,312,312,0,312,0,0,45,53,71,69,33,23,18,0,5,205,102,312
20220317,17MAR2022:00:00:00,UFU ZUBIZARRETA,101,79,121,40,19,180,180,0,180,0,0,24,30,46,23,30,16,11,0,3,93,84,180
20220318,18MAR2022:00:00:00,UFU ALVAREZ,111,115,178,36,12,226,226,0,226,0,18,38,42,45,39,15,20,9,0,8,146,72,226
20220318,18MAR2022:00:00:00,UFU ARGERICH,39,53,64,26,2,92,92,0,92,0,8,2,24,21,8,16,10,3,0,1,46,45,92
20220318,18MAR2022:00:00:00,UFU BORDA-MOYANO,35,29,38,15,11,64,64,0,64,0,0,0,13,11,13,18,8,1,0,4,35,25,64
20220318,18MAR2022:00:00:00,UFU DURAND,81,54,118,12,5,135,135,0,135,0,0,10,17,51,19,12,16,10,0,4,79,52,135
20220318,18MAR2022:00:00:00,UFU ELIZALDE,78,68,45,88,13,146,146,0,146,0,80,51,2,6,5,2,0,0,0,2,77,67,146
20220318,18MAR2022:00:00:00,UFU FERNANDEZ,40,65,70,17,18,105,105,0,105,0,0,6,33,27,12,17,4,6,0,1,61,43,105
20220318,18MAR2022:00:00:00,UFU FERRER,55,29,39,37,8,84,84,0,84,0,0,0,23,18,26,17,0,0,0,2,58,24,84
20220318,18MAR2022:00:00:00,UFU GRIERSON,13,17,21,9,0,30,30,0,30,0,0,0,9,8,8,2,2,1,0,1,18,11,30
20220318,18MAR2022:00:00:00,UFU GUTIERREZ,137,121,159,96,3,258,258,0,258,0,180,61,7,4,6,0,0,0,0,0,191,67,258
20220318,18MAR2022:00:00:00,UFU MUÑIZ,79,70,78,52,19,149,149,0,149,0,1,12,39,33,39,10,10,5,0,0,102,47,149
20220318,18MAR2022:00:00:00,UFU PENNA,65,51,68,46,2,116,116,0,116,0,15,26,36,16,17,3,2,1,0,3,83,30,116
20220318,18MAR2022:00:00:00,UFU PIROVANO,95,87,139,24,19,182,182,0,182,0,0,11,34,56,38,13,26,4,0,7,100,75,182
20220318,18MAR2022:00:00:00,UFU PIÑERO,85,71,110,33,13,156,156,0,156,0,0,19,49,43,23,19,3,0,0,7,110,39,156
20220318,18MAR2022:00:00:00,UFU RAMOS MEJIA,112,80,114,46,32,192,192,0,192,0,5,4,46,28,52,35,16,6,0,3,122,67,192
20220318,18MAR2022:00:00:00,UFU RIVADAVIA,110,92,149,42,11,202,202,0,202,0,0,10,74,48,17,10,25,18,0,6,116,80,202
20220318,18MAR2022:00:00:00,UFU SANTOJANNI,87,62,90,38,21,149,149,0,149,0,2,20,33,28,22,14,14,16,0,13,75,61,149
20220318,18MAR2022:00:00:00,UFU TORNU,116,72,164,21,3,188,188,0,188,0,20,15,45,52,33,12,7,4,0,7,115,62,188
20220318,18MAR2022:00:00:00,UFU VELEZ SARSFIELD,100,76,126,39,11,176,176,0,176,0,0,8,34,58,24,17,26,9,0,1,126,49,176
20220318,18MAR2022:00:00:00,UFU ZUBIZARRETA,70,71,67,61,13,141,141,0,141,0,0,15,28,40,13,16,20,9,0,3,68,70,141
20220319,19MAR2022:00:00:00,UFU ALVAREZ,123,102,160,49,16,225,225,0,225,0,19,32,48,43,23,33,14,13,0,1,146,78,225
20220319,19MAR2022:00:00:00,UFU ARGERICH,20,23,30,13,0,43,43,0,43,0,0,0,12,10,11,4,4,2,0,4,19,20,43
20220319,19MAR2022:00:00:00,UFU BORDA-MOYANO,37,40,45,31,1,77,77,0,77,0,0,6,8,17,21,10,11,4,0,1,48,28,77
20220319,19MAR2022:00:00:00,UFU DURAND,78,58,119,11,6,136,136,0,136,0,0,16,17,32,26,21,13,11,0,6,71,59,136
20220319,19MAR2022:00:00:00,UFU ELIZALDE,43,41,20,63,1,84,84,0,84,0,47,24,2,5,4,2,0,0,0,0,37,47,84
20220319,19MAR2022:00:00:00,UFU FERNANDEZ,35,37,63,4,5,72,72,0,72,0,0,4,16,18,15,3,13,3,0,2,42,28,72
20220319,19MAR2022:00:00:00,UFU FERRER,46,55,44,48,10,102,102,0,102,0,1,6,26,23,17,16,8,5,0,2,68,32,102
20220319,19MAR2022:00:00:00,UFU GRIERSON,37,24,35,20,6,61,61,0,61,0,0,7,12,12,16,9,3,2,0,0,44,17,61
20220319,19MAR2022:00:00:00,UFU GUTIERREZ,141,134,188,78,10,276,276,0,276,0,186,85,0,5,0,0,0,0,0,1,190,85,276
20220319,19MAR2022:00:00:00,UFU MUÑIZ,59,66,64,50,12,126,126,0,126,0,3,15,21,27,28,20,2,10,0,3,83,40,126
20220319,19MAR2022:00:00:00,UFU PENNA,26,16,18,24,0,42,42,0,42,0,0,5,21,2,14,0,0,0,0,0,30,12,42
20220319,19MAR2022:00:00:00,UFU PIROVANO,74,69,117,16,10,143,143,0,143,0,0,6,27,35,27,23,16,9,0,6,69,68,143
20220319,19MAR2022:00:00:00,UFU PIÑERO,71,29,81,19,0,100,100,0,100,0,0,4,23,22,13,13,15,10,0,3,71,26,100
20220319,19MAR2022:00:00:00,UFU RAMOS MEJIA,117,69,147,22,18,187,187,0,187,0,18,22,23,33,34,25,14,18,0,4,113,70,187
20220319,19MAR2022:00:00:00,UFU RIVADAVIA,111,105,131,23,63,217,217,0,217,0,1,10,66,46,22,38,14,20,0,4,116,97,217
20220319,19MAR2022:00:00:00,UFU SANTOJANNI,82,88,80,72,18,170,170,0,170,0,0,29,38,26,22,31,20,4,0,6,82,82,170
20220319,19MAR2022:00:00:00,UFU TORNU,29,23,35,4,13,52,52,0,52,0,7,7,9,11,11,2,0,5,0,2,25,25,52
20220319,19MAR2022:00:00:00,UFU VELEZ SARSFIELD,56,41,69,26,2,97,97,0,97,0,0,6,12,16,38,10,9,6,0,1,53,43,97
20220319,19MAR2022:00:00:00,UFU ZUBIZARRETA,67,63,67,57,6,130,130,0,130,0,0,15,29,32,21,12,12,9,0,7,64,59,130
20220320,20MAR2022:00:00:00,UFU ALVAREZ,90,58,114,28,6,148,148,0,148,0,28,21,12,30,23,17,13,4,0,1,106,41,148
20220320,20MAR2022:00:00:00,UFU ARGERICH,39,47,68,18,0,86,86,0,86,0,8,5,13,22,16,10,7,5,0,1,45,40,86
20220320,20MAR2022:00:00:00,UFU BORDA-MOYANO,19,22,18,21,2,41,41,0,41,0,0,9,10,1,5,9,3,4,0,0,31,10,41
20220320,20MAR2022:00:00:00,UFU DURAND,43,44,79,6,2,87,87,0,87,0,0,5,17,23,19,13,8,2,0,3,50,34,87
20220320,20MAR2022:00:00:00,UFU ELIZALDE,21,15,15,21,0,36,36,0,36,0,18,11,2,2,1,2,0,0,0,1,16,19,36
20220320,20MAR2022:00:00:00,UFU FERNANDEZ,31,50,63,13,5,81,81,0,81,0,0,5,24,22,14,7,6,3,0,1,47,33,81
20220320,20MAR2022:00:00:00,UFU FERRER,43,33,44,32,0,76,76,0,76,0,0,0,10,10,20,8,17,11,0,3,52,21,76
20220320,20MAR2022:00:00:00,UFU GRIERSON,40,40,58,22,0,80,80,0,80,0,0,6,13,18,9,16,13,5,0,0,58,22,80
20220320,20MAR2022:00:00:00,UFU GUTIERREZ,89,90,116,57,6,179,179,0,179,0,115,64,0,0,0,0,0,0,0,0,130,49,179
20220320,20MAR2022:00:00:00,UFU MUÑIZ,71,59,76,42,12,130,130,0,130,0,0,7,20,26,35,19,14,9,0,0,95,35,130
20220320,20MAR2022:00:00:00,UFU PENNA,40,26,39,21,6,66,66,0,66,0,0,7,18,23,7,5,5,1,0,0,46,20,66
20220320,20MAR2022:00:00:00,UFU PIROVANO,62,80,113,24,5,142,142,0,142,0,0,9,20,37,43,25,3,5,0,7,79,56,142
20220320,20MAR2022:00:00:00,UFU PIÑERO,23,32,38,11,6,55,55,0,55,0,0,3,15,9,6,11,8,3,0,3,36,16,55
20220320,20MAR2022:00:00:00,UFU RAMOS MEJIA,75,61,107,20,9,136,136,0,136,0,8,13,25,28,31,10,7,14,0,6,89,41,136
20220320,20MAR2022:00:00:00,UFU RIVADAVIA,102,64,111,16,39,166,166,0,166,0,0,6,56,27,12,28,20,17,0,4,99,63,166
20220320,20MAR2022:00:00:00,UFU SANTOJANNI,72,67,84,37,18,139,139,0,139,0,0,26,25,26,27,18,15,2,0,7,70,62,139
20220320,20MAR2022:00:00:00,UFU TORNU,76,59,121,9,5,135,135,0,135,0,1,16,17,31,28,17,10,15,0,5,90,40,135
20220320,20MAR2022:00:00:00,UFU VELEZ SARSFIELD,100,59,116,28,15,159,159,0,159,0,0,18,20,58,15,14,16,18,0,0,109,50,159
20220320,20MAR2022:00:00:00,UFU ZUBIZARRETA,40,46,58,25,3,86,86,0,86,0,0,13,10,12,15,12,12,12,0,3,46,37,86
20220321,21MAR2022:00:00:00,UFU ALVAREZ,241,138,299,62,22,383,383,0,383,0,80,40,60,64,71,27,25,16,0,4,239,140,383
20220526,26MAY2022:00:00:00,UFU DURAND,424,259,613,40,30,683,683,0,683,0,0,38,126,192,134,102,52,39,0,199,263,221,683
20220526,26MAY2022:00:00:00,UFU GUTIERREZ,128,106,143,83,8,234,234,0,234,0,110,78,4,19,17,6,0,0,0,14,153,67,234
20220526,26MAY2022:00:00:00,UFU MUÑIZ,126,97,137,70,16,223,223,0,223,0,8,15,34,65,35,36,18,12,0,37,109,77,223
20220526,26MAY2022:00:00:00,UFU PENNA,50,64,76,30,8,114,114,0,114,0,0,8,16,33,25,18,14,0,0,24,59,31,114
20220526,26MAY2022:00:00:00,UFU PIROVANO,326,207,418,85,30,533,533,0,533,0,0,35,113,159,88,65,43,30,0,162,202,169,533
20220526,26MAY2022:00:00:00,UFU PIÑERO,160,100,231,20,9,260,260,0,260,0,2,23,30,69,43,39,37,17,0,62,118,80,260
20220526,26MAY2022:00:00:00,UFU RAMOS MEJIA,199,123,267,34,21,322,322,0,322,0,0,4,42,97,63,43,41,32,0,70,156,96,322
20220526,26MAY2022:00:00:00,UFU RIVADAVIA,586,347,729,157,47,933,933,0,933,0,0,58,241,206,155,139,79,55,0,191,437,305,933
20220526,26MAY2022:00:00:00,UFU SANTOJANNI,187,149,242,79,15,336,336,0,336,0,0,31,55,45,74,65,35,31,0,78,159,98,336
20220526,26MAY2022:00:00:00,UFU ZUBIZARRETA,182,144,233,78,15,326,326,0,326,0,0,18,60,92,48,41,40,27,0,86,127,113,326
20220527,27MAY2022:00:00:00,UFU ALVAREZ,305,187,418,42,41,501,501,0,501,0,9,47,93,89,94,73,65,31,0,105,220,176,501
20220527,27MAY2022:00:00:00,UFU ARGERICH,103,62,103,49,21,173,173,0,173,0,8,3,34,35,43,26,12,12,0,36,54,83,173
20220527,27MAY2022:00:00:00,UFU DURAND,390,215,543,33,41,617,617,0,617,0,12,48,112,155,117,78,60,35,0,135,283,199,617
20220527,27MAY2022:00:00:00,UFU GUTIERREZ,94,100,115,70,19,204,204,0,204,0,139,40,2,4,10,6,3,0,0,6,118,80,204
20220527,27MAY2022:00:00:00,UFU MUÑIZ,152,116,135,111,35,281,281,0,281,0,23,15,46,75,58,39,16,9,0,36,115,130,281
20220527,27MAY2022:00:00:00,UFU PENNA,82,43,97,24,6,127,127,0,127,0,13,8,25,17,35,15,6,8,0,27,57,43,127
20220527,27MAY2022:00:00:00,UFU PIROVANO,322,229,424,66,93,583,583,0,583,0,32,27,130,122,114,72,52,34,0,141,233,209,583
20220527,27MAY2022:00:00:00,UFU PIÑERO,147,103,209,24,19,252,252,0,252,0,3,17,51,54,56,29,25,17,0,43,131,78,252
20220527,27MAY2022:00:00:00,UFU RAMOS MEJIA,181,104,233,36,26,295,295,0,295,0,10,3,57,67,61,48,32,17,0,42,167,86,295
20220527,27MAY2022:00:00:00,UFU RIVADAVIA,631,329,757,101,158,1016,1016,0,1016,0,56,42,225,259,126,128,103,77,0,174,453,389,1016
20220527,27MAY2022:00:00:00,UFU SANTOJANNI,399,220,409,172,55,636,636,0,636,0,27,54,93,124,134,89,79,36,0,228,224,184,636
20220527,27MAY2022:00:00:00,UFU ZUBIZARRETA,171,129,192,81,45,318,318,0,318,0,18,20,38,60,70,52,35,25,0,63,138,117,318
20220528,28MAY2022:00:00:00,UFU ALVAREZ,258,169,355,37,48,440,440,0,440,0,13,38,72,78,90,70,58,21,0,93,184,163,440
20220528,28MAY2022:00:00:00,UFU ARGERICH,34,18,36,14,3,53,53,0,53,0,1,2,6,11,16,13,4,0,0,7,24,22,53
20220528,28MAY2022:00:00:00,UFU DURAND,233,189,355,19,54,428,428,0,428,0,8,26,105,91,101,44,30,23,0,120,179,129,428
20220528,28MAY2022:00:00:00,UFU MUÑIZ,175,143,217,74,37,328,328,0,328,0,12,29,35,86,65,57,33,11,0,50,120,158,328
20220528,28MAY2022:00:00:00,UFU PIROVANO,349,212,438,62,84,584,584,0,584,0,23,21,92,138,107,109,51,43,0,137,224,223,584
20220528,28MAY2022:00:00:00,UFU PIÑERO,126,107,180,38,17,235,235,0,235,0,3,21,47,44,51,31,25,13,0,40,113,82,235
20220528,28MAY2022:00:00:00,UFU RAMOS MEJIA,208,135,279,32,45,356,356,0,356,0,23,31,50,71,67,55,43,16,0,80,152,124,356
20220528,28MAY2022:00:00:00,UFU RIVADAVIA,371,216,468,45,93,606,606,0,606,0,19,27,140,121,127,65,69,38,0,113,282,211,606
20220528,28MAY2022:00:00:00,UFU SANTOJANNI,231,180,273,107,64,444,444,0,444,0,35,32,61,80,79,76,53,28,0,103,172,168,444
20220528,28MAY2022:00:00:00,UFU ZUBIZARRETA,169,135,200,75,56,331,331,0,331,0,27,15,29,70,72,53,40,25,0,87,113,131,331
20220529,29MAY2022:00:00:00,UFU ALVAREZ,228,174,348,14,44,406,406,0,406,0,4,37,62,66,86,91,36,24,0,93,174,139,406
20220529,29MAY2022:00:00:00,UFU ARGERICH,31,14,29,11,7,47,47,0,47,0,2,0,6,5,16,9,7,2,0,12,15,20,47
20220529,29MAY2022:00:00:00,UFU DURAND,259,175,375,26,42,443,443,0,443,0,9,22,66,117,98,72,36,23,0,129,170,144,443
20220529,29MAY2022:00:00:00,UFU GUTIERREZ,83,54,103,19,20,142,142,0,142,0,81,52,0,6,3,0,0,0,0,14,56,72,142
20220529,29MAY2022:00:00:00,UFU MUÑIZ,140,110,139,92,27,258,258,0,258,0,10,24,21,67,57,52,19,8,0,41,94,123,258
20220529,29MAY2022:00:00:00,UFU PIROVANO,281,206,368,46,94,508,508,0,508,0,21,37,62,137,101,80,45,25,0,132,204,172,508
20220529,29MAY2022:00:00:00,UFU PIÑERO,92,64,119,21,18,158,158,0,158,0,2,7,31,38,23,37,7,13,0,33,65,60,158
20220529,29MAY2022:00:00:00,UFU RAMOS MEJIA,142,108,195,32,32,259,259,0,259,0,13,19,23,71,64,32,25,12,0,44,128,87,259
20220529,29MAY2022:00:00:00,UFU RIVADAVIA,377,251,483,75,106,664,664,0,664,0,41,20,115,157,136,113,58,24,0,160,269,235,664
20220529,29MAY2022:00:00:00,UFU SANTOJANNI,195,121,223,68,41,332,332,0,332,0,18,28,31,56,79,64,34,22,0,69,143,119,332
20220529,29MAY2022:00:00:00,UFU ZUBIZARRETA,215,133,251,70,43,364,364,0,364,0,16,13,53,68,53,86,53,22,0,90,144,130,364
20220530,30MAY2022:00:00:00,UFU ALVAREZ,263,204,405,30,103,538,538,0,538,0,72,45,59,106,126,69,44,17,0,90,226,221,538
20220530,30MAY2022:00:00:00,UFU ARGERICH,137,69,149,47,10,206,206,0,206,0,2,6,42,57,41,34,10,14,0,31,71,104,206
20220530,30MAY2022:00:00:00,UFU DURAND,345,210,462,57,135,654,654,0,654,0,99,20,120,147,113,81,59,15,0,125,270,259,654
20220530,30MAY2022:00:00:00,UFU GUTIERREZ,86,106,96,88,43,227,227,0,227,0,158,54,4,2,2,2,5,0,0,13,122,92,227
20220530,30MAY2022:00:00:00,UFU MUÑIZ,133,88,125,78,63,266,266,0,266,0,45,20,51,54,38,28,24,6,0,47,100,119,266
20220530,30MAY2022:00:00:00,UFU PENNA,61,39,60,35,31,126,126,0,126,0,26,9,19,27,23,9,9,4,0,15,57,54,126
20220530,30MAY2022:00:00:00,UFU PIROVANO,294,224,396,71,131,598,598,0,598,0,80,29,120,124,97,78,43,27,0,128,230,238,598
20220530,30MAY2022:00:00:00,UFU PIÑERO,115,77,162,26,56,244,244,0,244,0,52,5,26,54,46,35,18,8,0,42,98,104,244
20220530,30MAY2022:00:00:00,UFU RAMOS MEJIA,183,107,228,41,83,352,352,0,352,0,62,4,59,61,59,50,34,23,0,43,158,151,352
20220530,30MAY2022:00:00:00,UFU RIVADAVIA,544,292,635,125,214,974,974,0,974,0,138,33,215,188,126,125,88,61,0,152,433,388,974
20220530,30MAY2022:00:00:00,UFU SANTOJANNI,301,229,373,116,122,611,611,0,611,0,81,48,77,111,122,101,49,22,0,166,232,213,611
20220530,30MAY2022:00:00:00,UFU ZUBIZARRETA,144,105,188,48,54,290,290,0,290,0,41,18,37,61,59,36,26,12,0,65,106,119,290
20220531,31MAY2022:00:00:00,UFU ALVAREZ,270,160,349,51,33,433,433,0,433,0,3,30,80,101,81,62,54,22,0,77,207,149,433
20220531,31MAY2022:00:00:00,UFU ARGERICH,72,70,99,28,21,148,148,0,148,0,6,4,32,39,32,22,6,7,0,26,54,68,148
20220531,31MAY2022:00:00:00,UFU DURAND,297,218,445,26,55,526,526,0,526,0,11,25,103,138,102,59,53,35,0,128,227,171,526
20220531,31MAY2022:00:00:00,UFU GUTIERREZ,70,82,106,38,15,159,159,0,159,0,84,55,6,7,5,1,1,0,0,16,87,56,159
20220531,31MAY2022:00:00:00,UFU MUÑIZ,113,106,122,89,17,228,228,0,228,0,11,17,57,60,35,31,12,5,0,26,95,107,228
20220531,31MAY2022:00:00:00,UFU PENNA,43,28,43,21,10,74,74,0,74,0,7,3,19,19,10,10,2,4,0,14,37,23,74
20220531,31MAY2022:00:00:00,UFU PIROVANO,314,170,387,39,65,491,491,0,491,0,7,46,95,119,80,71,51,22,0,94,188,209,491
20220531,31MAY2022:00:00:00,UFU PIÑERO,125,101,178,34,17,229,229,0,229,0,3,14,38,53,48,44,18,11,0,31,128,70,229
20220321,21MAR2022:00:00:00,UFU ARGERICH,41,49,52,35,4,91,91,0,91,0,11,2,15,20,13,13,9,8,0,0,33,58,91
20220321,21MAR2022:00:00:00,UFU BORDA-MOYANO,36,38,32,37,5,74,74,0,74,0,0,3,14,21,14,16,6,0,0,1,34,37,74
20220321,21MAR2022:00:00:00,UFU DURAND,99,92,166,15,10,191,191,0,191,0,0,23,33,59,29,32,12,3,0,3,100,88,191
20220321,21MAR2022:00:00:00,UFU ELIZALDE,119,98,52,161,5,218,218,0,218,0,126,57,11,16,7,1,0,0,0,0,89,129,218
20220321,21MAR2022:00:00:00,UFU FERNANDEZ,69,67,95,15,27,137,137,0,137,0,1,6,32,33,25,21,15,4,0,2,70,65,137
20220321,21MAR2022:00:00:00,UFU FERRER,83,53,70,55,12,137,137,0,137,0,1,0,37,55,15,20,3,6,0,3,91,43,137
20220321,21MAR2022:00:00:00,UFU GRIERSON,29,19,35,10,3,48,48,0,48,0,0,5,2,17,5,12,5,2,0,0,35,13,48
20220321,21MAR2022:00:00:00,UFU GUTIERREZ,213,158,242,113,17,372,372,0,372,0,207,106,19,24,16,0,0,0,0,4,248,120,372
20220321,21MAR2022:00:00:00,UFU MUÑIZ,93,96,74,87,28,189,189,0,189,0,0,4,34,48,31,31,35,6,0,0,124,64,189
20220321,21MAR2022:00:00:00,UFU PENNA,77,61,80,56,5,141,141,0,141,0,10,11,30,31,21,10,14,14,0,1,94,46,141
20220321,21MAR2022:00:00:00,UFU PIROVANO,138,87,162,35,30,227,227,0,227,0,2,9,44,58,47,33,14,20,0,5,117,105,227
20220321,21MAR2022:00:00:00,UFU PIÑERO,69,81,113,28,10,151,151,0,151,0,1,9,38,30,45,10,18,0,0,0,111,39,151
20220321,21MAR2022:00:00:00,UFU RAMOS MEJIA,153,91,182,47,15,244,244,0,244,0,4,2,40,80,42,33,24,19,0,3,139,101,244
20220321,21MAR2022:00:00:00,UFU RIVADAVIA,167,133,219,59,27,305,305,0,305,0,5,15,84,80,40,41,19,21,0,5,162,137,305
20220321,21MAR2022:00:00:00,UFU SANTOJANNI,149,124,154,100,19,273,273,0,273,0,2,39,57,46,45,33,21,30,0,2,135,136,273
20220321,21MAR2022:00:00:00,UFU TORNU,123,99,189,21,12,222,222,0,222,0,23,42,25,54,28,36,10,4,0,4,125,92,222
20220321,21MAR2022:00:00:00,UFU VELEZ SARSFIELD,136,119,204,45,6,255,255,0,255,0,0,34,52,82,46,18,12,11,0,4,167,84,255
20220321,21MAR2022:00:00:00,UFU ZUBIZARRETA,98,65,92,52,19,163,163,0,163,0,0,10,23,35,36,26,20,13,0,14,75,74,163
20220322,22MAR2022:00:00:00,UFU ALVAREZ,101,93,159,30,5,194,194,0,194,0,0,26,52,39,38,18,13,8,0,8,102,84,194
20220322,22MAR2022:00:00:00,UFU ARGERICH,4,4,6,0,2,8,8,0,8,0,0,0,2,0,2,0,4,0,0,0,4,4,8
20220322,22MAR2022:00:00:00,UFU BORDA-MOYANO,33,29,43,14,5,62,62,0,62,0,2,2,16,14,11,9,6,2,0,0,36,26,62
20220322,22MAR2022:00:00:00,UFU DURAND,22,8,28,2,0,30,30,0,30,0,0,2,15,9,1,0,3,0,0,1,17,12,30
20220322,22MAR2022:00:00:00,UFU FERRER,31,34,28,29,8,65,65,0,65,0,0,1,18,16,16,2,10,2,0,1,31,33,65
20220322,22MAR2022:00:00:00,UFU GRIERSON,11,30,25,13,3,41,41,0,41,0,0,2,12,5,14,5,3,0,0,0,29,12,41
20220322,22MAR2022:00:00:00,UFU GUTIERREZ,51,42,65,18,10,93,93,0,93,0,52,38,2,0,1,0,0,0,0,1,61,31,93
20220322,22MAR2022:00:00:00,UFU MUÑIZ,60,84,78,61,7,146,146,0,146,0,4,5,23,39,41,22,10,2,0,3,86,57,146
20220322,22MAR2022:00:00:00,UFU PENNA,5,3,0,8,0,8,8,0,8,0,0,3,0,0,2,3,0,0,0,0,5,3,8
20220322,22MAR2022:00:00:00,UFU PIROVANO,160,106,209,18,39,266,266,0,266,0,0,22,78,79,33,28,8,18,0,13,131,122,266
20220322,22MAR2022:00:00:00,UFU PIÑERO,84,75,114,29,16,159,159,0,159,0,0,21,52,23,36,17,3,7,0,2,116,40,159
20220322,22MAR2022:00:00:00,UFU RAMOS MEJIA,87,89,121,40,16,177,177,0,177,0,1,2,64,46,23,18,13,10,0,1,100,76,177
20220322,22MAR2022:00:00:00,UFU RIVADAVIA,145,105,185,35,31,251,251,0,251,0,1,9,71,56,39,32,26,17,0,3,142,106,251
20220322,22MAR2022:00:00:00,UFU SANTOJANNI,82,81,111,41,11,163,163,0,163,0,0,24,27,45,29,7,21,10,0,5,77,81,163
20220322,22MAR2022:00:00:00,UFU TORNU,46,43,71,1,17,89,89,0,89,0,3,10,14,34,14,11,3,0,0,2,55,32,89
20220322,22MAR2022:00:00:00,UFU VELEZ SARSFIELD,129,110,197,31,13,241,241,0,241,0,2,13,46,40,51,43,31,15,0,1,164,76,241
20220322,22MAR2022:00:00:00,UFU ZUBIZARRETA,72,76,99,40,9,148,148,0,148,0,0,24,36,33,17,22,8,8,0,4,71,73,148
20220323,23MAR2022:00:00:00,UFU ALVAREZ,143,91,191,24,19,234,234,0,234,0,36,26,45,43,38,21,19,6,0,4,116,114,234
20220323,23MAR2022:00:00:00,UFU ARGERICH,52,45,59,34,4,97,97,0,97,0,8,15,23,22,15,3,9,2,0,1,45,51,97
20220323,23MAR2022:00:00:00,UFU BORDA-MOYANO,23,22,29,10,6,45,45,0,45,0,0,0,6,10,10,9,4,6,0,0,24,21,45
20220323,23MAR2022:00:00:00,UFU DURAND,155,140,249,37,10,296,296,0,296,0,1,30,70,67,53,32,32,11,0,13,180,103,296
20220323,23MAR2022:00:00:00,UFU ELIZALDE,77,70,62,81,4,147,147,0,147,0,86,38,8,8,6,1,0,0,0,1,62,84,147
20220323,23MAR2022:00:00:00,UFU FERNANDEZ,127,69,137,31,31,199,199,0,199,0,3,17,61,43,31,19,15,10,0,0,103,96,199
20220323,23MAR2022:00:00:00,UFU FERRER,55,58,47,57,9,113,113,0,113,0,0,3,36,27,30,2,12,3,0,0,76,37,113
20220323,23MAR2022:00:00:00,UFU GRIERSON,15,18,28,5,0,33,33,0,33,0,0,4,6,12,3,2,0,6,0,0,24,9,33
20220323,23MAR2022:00:00:00,UFU GUTIERREZ,174,192,223,124,19,366,366,0,366,0,233,98,6,9,9,6,5,0,0,4,243,119,366
20220323,23MAR2022:00:00:00,UFU MUÑIZ,109,115,113,94,17,224,224,0,224,0,7,14,58,50,27,39,16,13,0,2,152,70,224
20220323,23MAR2022:00:00:00,UFU PENNA,80,68,78,67,3,148,148,0,148,0,10,36,32,30,11,20,9,0,0,1,107,40,148
20220323,23MAR2022:00:00:00,UFU PIROVANO,178,122,239,32,32,303,303,0,303,0,3,20,109,77,52,21,12,9,0,12,151,140,303
20220323,23MAR2022:00:00:00,UFU PIÑERO,101,60,133,16,12,161,161,0,161,0,0,14,44,51,21,8,14,9,0,4,108,48,161
20220323,23MAR2022:00:00:00,UFU RAMOS MEJIA,99,89,128,39,21,188,188,0,188,0,0,5,59,44,29,20,15,16,0,3,99,86,188
20220323,23MAR2022:00:00:00,UFU RIVADAVIA,207,135,243,71,34,348,348,0,348,0,6,9,141,83,35,33,24,17,0,7,178,163,348
20220323,23MAR2022:00:00:00,UFU SANTOJANNI,100,125,146,67,13,226,226,0,226,0,3,32,40,44,31,29,24,23,0,5,115,106,226
20220323,23MAR2022:00:00:00,UFU TORNU,92,92,146,18,20,184,184,0,184,0,10,27,44,43,24,20,8,8,0,2,115,67,184
20220323,23MAR2022:00:00:00,UFU VELEZ SARSFIELD,163,179,244,77,21,342,342,0,342,0,0,29,95,72,52,41,31,22,0,2,222,118,342
20220323,23MAR2022:00:00:00,UFU ZUBIZARRETA,98,74,120,44,9,173,173,0,173,0,1,16,53,43,17,16,18,9,0,5,81,87,173
20220324,24MAR2022:00:00:00,UFU ALVAREZ,60,79,119,12,9,140,140,0,140,0,11,15,32,30,13,11,16,12,0,7,72,61,140
20220324,24MAR2022:00:00:00,UFU ARGERICH,36,24,37,22,1,60,60,0,60,0,1,4,18,13,14,7,3,0,0,0,33,27,60
20220324,24MAR2022:00:00:00,UFU BORDA-MOYANO,35,30,43,22,0,65,65,0,65,0,0,3,13,10,14,9,12,4,0,4,33,28,65
20220324,24MAR2022:00:00:00,UFU DURAND,71,68,124,8,7,139,139,0,139,0,0,20,38,36,16,15,9,5,0,4,71,64,139
20220324,24MAR2022:00:00:00,UFU ELIZALDE,39,37,13,59,5,77,77,0,77,0,49,16,2,4,3,3,0,0,0,0,33,44,77
20220324,24MAR2022:00:00:00,UFU FERNANDEZ,50,47,85,7,6,98,98,0,98,0,1,3,34,35,6,12,2,5,0,3,58,37,98
20220324,24MAR2022:00:00:00,UFU GRIERSON,36,14,28,22,0,50,50,0,50,0,2,6,16,5,10,0,6,5,0,0,36,14,50
20220324,24MAR2022:00:00:00,UFU GUTIERREZ,114,79,147,40,8,195,195,0,195,0,129,58,0,6,2,0,0,0,0,2,138,54,195
20220324,24MAR2022:00:00:00,UFU MUÑIZ,46,98,64,64,20,148,148,0,148,0,7,8,38,20,19,29,19,8,0,0,100,48,148
20220324,24MAR2022:00:00:00,UFU PENNA,30,23,26,24,4,54,54,0,54,0,4,6,10,6,12,8,8,0,0,0,37,17,54
20220324,24MAR2022:00:00:00,UFU PIROVANO,92,78,145,15,11,171,171,0,171,0,1,17,35,31,50,11,16,10,0,8,84,79,171
20220324,24MAR2022:00:00:00,UFU PIÑERO,32,26,37,15,6,58,58,0,58,0,0,4,10,12,4,15,8,5,0,2,46,10,58
20220324,24MAR2022:00:00:00,UFU RAMOS MEJIA,89,56,101,34,10,145,145,0,145,0,3,10,48,25,22,16,13,8,0,8,90,47,145
20220531,31MAY2022:00:00:00,UFU RAMOS MEJIA,124,117,191,29,27,247,247,0,247,0,6,5,42,67,50,34,31,12,0,37,126,84,247
20220531,31MAY2022:00:00:00,UFU RIVADAVIA,514,313,625,93,129,847,847,0,847,0,23,24,196,229,127,114,79,55,0,163,361,323,847
20220531,31MAY2022:00:00:00,UFU SANTOJANNI,346,225,432,105,43,580,580,0,580,0,12,47,98,126,135,81,54,27,0,164,216,200,580
20220531,31MAY2022:00:00:00,UFU ZUBIZARRETA,160,119,185,67,34,286,286,0,286,0,7,17,40,66,61,45,27,23,0,69,114,103,286
20220601,01JUN2022:00:00:00,UFU ALVAREZ,235,145,314,31,39,384,384,0,384,0,4,27,77,78,86,42,45,25,0,58,197,129,384
20220601,01JUN2022:00:00:00,UFU ARGERICH,110,85,131,54,13,198,198,0,198,0,4,13,43,34,37,44,14,9,0,26,80,92,198
20220601,01JUN2022:00:00:00,UFU DURAND,316,169,421,40,25,486,486,0,486,0,1,30,82,153,101,57,34,28,0,122,213,151,486
20220601,01JUN2022:00:00:00,UFU GUTIERREZ,107,62,96,61,14,171,171,0,171,0,102,54,0,9,6,0,0,0,0,8,114,49,171
20220601,01JUN2022:00:00:00,UFU MUÑIZ,132,94,123,74,30,227,227,0,227,0,7,17,36,70,32,49,12,4,0,20,97,110,227
20220601,01JUN2022:00:00:00,UFU PENNA,42,29,45,20,6,71,71,0,71,0,4,5,23,23,5,7,2,2,0,10,36,25,71
20220601,01JUN2022:00:00:00,UFU PIROVANO,300,195,384,44,70,498,498,0,498,0,3,35,117,131,90,56,39,27,0,113,211,174,498
20220601,01JUN2022:00:00:00,UFU PIÑERO,145,88,197,23,14,234,234,0,234,0,1,21,53,46,53,41,14,5,0,44,122,68,234
20220601,01JUN2022:00:00:00,UFU RAMOS MEJIA,202,101,239,36,29,304,304,0,304,0,1,3,50,77,66,54,37,16,0,48,170,86,304
20220601,01JUN2022:00:00:00,UFU RIVADAVIA,579,314,669,122,110,901,901,0,901,0,8,30,233,218,163,102,111,36,0,159,381,361,901
20220601,01JUN2022:00:00:00,UFU SANTOJANNI,304,229,380,119,36,535,535,0,535,0,2,47,81,96,113,91,60,45,0,138,233,163,535
20220601,01JUN2022:00:00:00,UFU ZUBIZARRETA,165,95,175,58,30,263,263,0,263,0,3,16,43,63,48,44,24,22,0,60,111,92,263
20220602,02JUN2022:00:00:00,UFU ALVAREZ,266,190,358,62,39,459,459,0,459,0,3,36,88,103,86,57,68,18,0,72,228,159,459
20220602,02JUN2022:00:00:00,UFU ARGERICH,76,65,98,30,15,143,143,0,143,0,4,3,30,22,33,26,17,8,0,17,57,69,143
20220602,02JUN2022:00:00:00,UFU DURAND,315,192,455,24,29,508,508,0,508,0,1,29,111,129,102,66,41,29,0,103,251,154,508
20220602,02JUN2022:00:00:00,UFU GUTIERREZ,108,100,133,68,10,211,211,0,211,0,136,54,2,7,7,4,1,0,0,27,112,72,211
20220602,02JUN2022:00:00:00,UFU MUÑIZ,118,129,137,50,63,250,250,0,250,0,9,10,58,73,41,42,14,3,0,39,96,115,250
20220602,02JUN2022:00:00:00,UFU PENNA,49,40,61,24,5,90,90,0,90,0,1,8,13,22,17,17,10,2,0,23,37,30,90
20220602,02JUN2022:00:00:00,UFU PIROVANO,317,234,430,55,68,553,553,0,553,0,2,24,101,168,119,73,33,33,0,105,229,219,553
20220602,02JUN2022:00:00:00,UFU PIÑERO,118,76,177,11,6,194,194,0,194,0,0,25,32,38,29,41,21,8,0,36,101,57,194
20220602,02JUN2022:00:00:00,UFU RAMOS MEJIA,216,137,276,49,29,354,354,0,354,0,1,12,79,81,67,45,44,25,0,68,175,111,354
20220602,02JUN2022:00:00:00,UFU RIVADAVIA,543,270,630,94,97,821,821,0,821,0,8,25,191,181,155,125,68,68,0,151,389,281,821
20220602,02JUN2022:00:00:00,UFU SANTOJANNI,276,222,386,80,32,498,498,0,498,0,1,40,62,129,107,69,65,25,0,189,187,122,498
20220602,02JUN2022:00:00:00,UFU ZUBIZARRETA,169,117,193,63,31,287,287,0,287,0,1,23,37,64,69,41,28,24,0,64,120,103,287
20220603,03JUN2022:00:00:00,UFU ALVAREZ,227,169,309,42,47,398,398,0,398,0,2,25,66,106,76,47,47,29,0,60,196,142,398
20220603,03JUN2022:00:00:00,UFU ARGERICH,73,67,92,36,12,140,140,0,140,0,0,12,29,37,28,13,16,5,0,20,54,66,140
20220603,03JUN2022:00:00:00,UFU DURAND,278,181,392,38,30,460,460,0,460,0,1,22,88,127,96,63,53,10,0,99,219,142,460
20220603,03JUN2022:00:00:00,UFU GUTIERREZ,95,99,142,42,11,195,195,0,195,0,99,73,1,6,12,4,0,0,0,11,101,83,195
20220603,03JUN2022:00:00:00,UFU MUÑIZ,114,90,100,64,43,207,207,0,207,0,4,14,46,39,35,41,23,5,0,21,90,96,207
20220603,03JUN2022:00:00:00,UFU PENNA,32,34,45,17,5,67,67,0,67,0,3,6,17,15,11,11,3,1,0,13,35,19,67
20220603,03JUN2022:00:00:00,UFU PIROVANO,279,161,354,37,51,442,442,0,442,0,2,21,75,95,97,79,48,25,0,89,188,165,442
20220603,03JUN2022:00:00:00,UFU PIÑERO,104,72,144,14,19,177,177,0,177,0,2,12,32,33,44,25,17,12,0,35,89,53,177
20220603,03JUN2022:00:00:00,UFU RAMOS MEJIA,152,123,240,17,21,278,278,0,278,0,3,10,45,64,70,31,34,21,0,45,141,92,278
20220603,03JUN2022:00:00:00,UFU RIVADAVIA,456,287,561,83,100,744,744,0,744,0,1,21,176,166,155,98,82,45,0,134,322,288,744
20220603,03JUN2022:00:00:00,UFU SANTOJANNI,270,167,287,107,43,437,437,0,437,0,6,29,76,111,57,74,52,32,0,122,182,133,437
20220603,03JUN2022:00:00:00,UFU ZUBIZARRETA,135,89,155,49,21,225,225,0,225,0,1,19,30,56,40,34,32,13,0,53,98,74,225
20220604,04JUN2022:00:00:00,UFU ALVAREZ,165,113,245,18,17,280,280,0,280,0,2,14,41,39,62,51,39,32,0,54,137,89,280
20220604,04JUN2022:00:00:00,UFU ARGERICH,25,14,27,11,1,39,39,0,39,0,0,1,2,11,11,11,3,0,0,9,18,12,39
20220604,04JUN2022:00:00:00,UFU DURAND,180,133,286,10,18,314,314,0,314,0,1,15,54,80,59,36,55,14,0,79,136,99,314
20220604,04JUN2022:00:00:00,UFU GUTIERREZ,49,45,66,26,2,94,94,0,94,0,64,27,0,1,0,2,0,0,0,6,39,49,94
20220604,04JUN2022:00:00:00,UFU MUÑIZ,149,101,169,38,47,254,254,0,254,0,10,11,50,46,59,42,27,9,0,41,89,124,254
20220604,04JUN2022:00:00:00,UFU PIROVANO,282,185,368,49,52,469,469,0,469,0,2,29,74,118,92,85,42,27,0,110,170,189,469
20220604,04JUN2022:00:00:00,UFU PIÑERO,69,48,91,15,14,120,120,0,120,0,4,9,16,26,17,18,20,10,0,23,60,37,120
20220604,04JUN2022:00:00:00,UFU RAMOS MEJIA,111,100,185,17,9,211,211,0,211,0,9,19,33,41,39,37,22,11,0,36,105,70,211
20220604,04JUN2022:00:00:00,UFU RIVADAVIA,269,157,293,26,117,436,436,0,436,0,10,16,116,88,73,46,36,51,0,95,202,139,436
20220604,04JUN2022:00:00:00,UFU SANTOJANNI,172,131,193,89,26,308,308,0,308,0,6,19,40,75,57,47,47,17,0,73,135,100,308
20220604,04JUN2022:00:00:00,UFU ZUBIZARRETA,167,99,196,53,19,268,268,0,268,0,2,17,33,41,63,54,32,26,0,60,121,87,268
20220605,05JUN2022:00:00:00,UFU ALVAREZ,193,112,252,27,30,309,309,0,309,0,4,28,33,59,61,68,29,27,0,57,149,103,309
20220605,05JUN2022:00:00:00,UFU DURAND,207,155,321,26,15,362,362,0,362,0,0,11,61,106,81,39,49,15,0,97,158,107,362
20220605,05JUN2022:00:00:00,UFU GUTIERREZ,50,54,71,24,9,104,104,0,104,0,76,24,0,0,2,2,0,0,0,10,41,53,104
20220605,05JUN2022:00:00:00,UFU MUÑIZ,76,59,69,48,20,137,137,0,137,0,5,5,24,21,29,31,15,7,0,30,51,56,137
20220605,05JUN2022:00:00:00,UFU PIROVANO,230,138,287,44,41,372,372,0,372,0,6,7,58,94,89,56,38,24,0,106,146,120,372
20220605,05JUN2022:00:00:00,UFU PIÑERO,61,34,73,13,10,96,96,0,96,0,1,5,20,20,23,20,4,3,0,18,55,23,96
20220605,05JUN2022:00:00:00,UFU RAMOS MEJIA,114,82,158,21,19,198,198,0,198,0,11,26,19,45,41,25,19,12,0,35,102,61,198
20220605,05JUN2022:00:00:00,UFU RIVADAVIA,366,258,452,70,107,629,629,0,629,0,5,26,112,125,118,106,80,57,0,133,224,272,629
20220605,05JUN2022:00:00:00,UFU SANTOJANNI,149,113,167,62,34,263,263,0,263,0,1,22,31,75,55,35,25,19,0,69,104,90,263
20220605,05JUN2022:00:00:00,UFU ZUBIZARRETA,156,97,200,41,14,255,255,0,255,0,2,16,43,54,44,47,31,18,0,71,104,80,255
20220606,06JUN2022:00:00:00,UFU ALVAREZ,230,144,297,58,21,376,376,0,376,0,2,34,69,87,78,46,45,15,0,69,195,112,376
20220606,06JUN2022:00:00:00,UFU ARGERICH,103,67,117,43,10,170,170,0,170,0,0,13,22,38,42,34,10,11,0,21,65,84,170
20220606,06JUN2022:00:00:00,UFU DURAND,336,209,456,45,45,546,546,0,546,0,1,36,94,161,111,75,41,27,0,135,247,164,546
20220128,28JAN2022:00:00:00,UFU RAMOS MEJIA,278,232,366,84,62,512,512,0,512,0,5,25,115,108,107,73,49,30,0,140,137,235,512
20220128,28JAN2022:00:00:00,UFU RIVADAVIA,338,229,390,103,77,570,570,0,570,0,3,14,139,122,109,99,57,27,0,147,166,256,570
20220128,28JAN2022:00:00:00,UFU SANTOJANNI,261,234,277,171,49,497,497,0,497,0,5,18,103,128,95,74,43,31,0,122,133,242,497
20220128,28JAN2022:00:00:00,UFU TORNU,233,169,359,22,22,403,403,0,403,0,8,21,61,123,95,39,25,31,0,88,142,173,403
20220128,28JAN2022:00:00:00,UFU VELEZ SARSFIELD,220,218,331,82,25,438,438,0,438,0,0,20,92,106,87,51,53,29,0,94,195,149,438
20220128,28JAN2022:00:00:00,UFU ZUBIZARRETA,185,143,227,78,27,332,332,0,332,0,4,15,63,67,74,50,22,37,0,73,89,170,332
20220129,29JAN2022:00:00:00,UFU ALVAREZ,231,149,308,50,23,381,381,0,381,0,16,23,70,51,73,61,54,33,0,84,121,176,381
20220129,29JAN2022:00:00:00,UFU ARGERICH,43,27,39,30,1,70,70,0,70,0,1,0,13,19,8,14,5,10,0,24,15,31,70
20220129,29JAN2022:00:00:00,UFU BORDA-MOYANO,100,118,126,79,13,218,218,0,218,0,0,24,36,59,35,37,21,6,0,39,111,68,218
20220129,29JAN2022:00:00:00,UFU DURAND,290,236,458,30,39,527,527,0,527,0,1,18,88,142,102,81,57,38,0,172,134,221,527
20220129,29JAN2022:00:00:00,UFU ELIZALDE,112,80,73,112,8,193,193,0,193,0,118,26,4,18,17,8,0,2,0,24,82,87,193
20220129,29JAN2022:00:00:00,UFU FERNANDEZ,195,173,289,43,38,370,370,0,370,0,4,12,63,114,60,40,49,28,0,73,137,160,370
20220129,29JAN2022:00:00:00,UFU FERRER,163,137,159,121,20,300,300,0,300,0,2,3,59,77,81,55,17,6,0,68,142,90,300
20220129,29JAN2022:00:00:00,UFU GRIERSON,100,92,109,56,29,194,194,0,194,0,2,16,42,54,34,23,11,12,0,24,111,59,194
20220129,29JAN2022:00:00:00,UFU GUTIERREZ,121,102,133,71,20,224,224,0,224,0,104,66,9,17,13,9,6,0,0,35,74,110,224
20220129,29JAN2022:00:00:00,UFU MUÑIZ,90,139,119,91,20,230,230,0,230,0,1,11,47,64,56,28,13,10,0,51,89,90,230
20220129,29JAN2022:00:00:00,UFU PENNA,151,167,170,128,21,319,319,0,319,0,25,30,71,85,41,31,21,15,0,54,166,98,319
20220129,29JAN2022:00:00:00,UFU PIROVANO,238,235,349,80,45,474,474,0,474,0,1,23,106,115,90,59,50,30,0,152,127,195,474
20220129,29JAN2022:00:00:00,UFU PIÑERO,113,125,177,44,17,238,238,0,238,0,0,23,48,61,45,37,12,12,0,38,126,71,238
20220129,29JAN2022:00:00:00,UFU RAMOS MEJIA,171,145,226,60,30,316,316,0,316,0,6,16,61,72,65,36,34,26,0,89,87,140,316
20220129,29JAN2022:00:00:00,UFU RIVADAVIA,303,257,364,129,69,562,562,0,562,0,2,21,122,162,96,91,48,20,0,117,219,225,562
20220129,29JAN2022:00:00:00,UFU SANTOJANNI,206,174,224,119,37,380,380,0,380,0,0,11,72,106,65,62,36,28,0,118,92,170,380
20220129,29JAN2022:00:00:00,UFU TORNU,187,172,318,28,13,359,359,0,359,0,11,18,57,96,63,58,20,36,0,75,155,129,359
20220129,29JAN2022:00:00:00,UFU VELEZ SARSFIELD,269,199,312,103,54,469,469,0,469,0,1,14,99,83,92,68,81,31,0,111,184,174,469
20220129,29JAN2022:00:00:00,UFU ZUBIZARRETA,274,240,337,156,21,514,514,0,514,0,0,17,69,112,116,69,60,71,0,137,144,233,514
20220130,30JAN2022:00:00:00,UFU ALVAREZ,164,154,273,24,23,320,320,0,320,0,14,16,57,41,59,58,50,25,0,61,119,140,320
20220130,30JAN2022:00:00:00,UFU ARGERICH,55,36,47,42,2,91,91,0,91,0,2,0,16,30,14,5,14,10,0,13,34,44,91
20220130,30JAN2022:00:00:00,UFU BORDA-MOYANO,87,54,78,54,12,144,144,0,144,0,3,5,30,32,36,19,15,4,0,28,73,43,144
20220130,30JAN2022:00:00:00,UFU DURAND,316,225,452,31,58,541,541,0,541,0,2,27,70,121,114,98,61,48,0,146,148,247,541
20220130,30JAN2022:00:00:00,UFU ELIZALDE,93,77,46,121,6,173,173,0,173,0,88,39,4,20,19,3,0,0,0,29,58,86,173
20220130,30JAN2022:00:00:00,UFU FERNANDEZ,170,160,246,51,38,335,335,0,335,0,5,21,60,81,55,52,35,26,0,84,104,146,335
20220130,30JAN2022:00:00:00,UFU FERRER,133,125,136,115,11,262,262,0,262,0,4,2,73,65,50,28,37,3,0,46,120,96,262
20220130,30JAN2022:00:00:00,UFU GRIERSON,97,84,105,56,21,182,182,0,182,0,1,5,44,45,31,38,9,9,0,29,104,49,182
20220130,30JAN2022:00:00:00,UFU GUTIERREZ,132,119,191,51,9,251,251,0,251,0,127,82,6,16,12,8,0,0,0,55,66,130,251
20220130,30JAN2022:00:00:00,UFU MUÑIZ,120,162,133,132,22,287,287,0,287,0,5,26,92,72,41,24,16,11,0,55,144,88,287
20220130,30JAN2022:00:00:00,UFU PENNA,107,95,110,85,10,205,205,0,205,0,28,8,51,30,33,37,13,5,0,35,109,61,205
20220130,30JAN2022:00:00:00,UFU PIROVANO,261,230,368,53,73,494,494,0,494,0,7,25,81,134,102,58,45,42,0,159,114,221,494
20220130,30JAN2022:00:00:00,UFU PIÑERO,140,124,205,50,9,264,264,0,264,0,0,8,63,46,62,33,43,9,0,38,147,78,264
20220130,30JAN2022:00:00:00,UFU RAMOS MEJIA,161,162,252,42,31,325,325,0,325,0,9,19,64,81,49,59,26,18,0,91,87,147,325
20220130,30JAN2022:00:00:00,UFU RIVADAVIA,238,194,306,53,78,437,437,0,437,0,5,15,96,109,75,57,42,38,0,113,137,185,437
20220130,30JAN2022:00:00:00,UFU SANTOJANNI,192,189,200,146,39,385,385,0,385,0,6,23,58,85,70,68,54,21,0,103,93,189,385
20220130,30JAN2022:00:00:00,UFU TORNU,195,148,280,33,33,346,346,0,346,0,6,32,37,85,65,59,31,31,0,78,131,137,346
20220130,30JAN2022:00:00:00,UFU VELEZ SARSFIELD,254,247,387,100,16,503,503,0,503,0,2,33,91,110,100,75,63,29,0,116,213,174,503
20220130,30JAN2022:00:00:00,UFU ZUBIZARRETA,259,183,263,164,18,445,445,0,445,0,3,21,69,94,90,79,65,24,0,153,104,188,445
20220131,31JAN2022:00:00:00,UFU ALVAREZ,347,283,490,84,57,631,631,0,631,0,33,44,135,149,104,65,53,48,0,106,280,245,631
20220131,31JAN2022:00:00:00,UFU ARGERICH,98,61,87,66,6,159,159,0,159,0,9,12,27,30,34,23,15,9,0,41,46,71,159
20220131,31JAN2022:00:00:00,UFU BORDA-MOYANO,105,160,155,80,31,266,266,0,266,0,1,9,41,50,61,57,33,14,0,58,99,109,266
20220131,31JAN2022:00:00:00,UFU DURAND,314,270,465,54,65,584,584,0,584,0,0,29,138,160,114,68,37,38,0,198,151,235,584
20220131,31JAN2022:00:00:00,UFU ELIZALDE,130,111,69,149,24,242,242,0,242,0,132,61,14,15,15,3,2,0,0,34,100,108,242
20220131,31JAN2022:00:00:00,UFU FERNANDEZ,191,143,215,40,80,335,335,0,335,0,1,23,63,66,74,47,26,35,0,68,132,135,335
20220131,31JAN2022:00:00:00,UFU FERRER,145,133,145,108,25,278,278,0,278,0,0,3,72,76,40,42,27,18,0,74,110,94,278
20220131,31JAN2022:00:00:00,UFU GRIERSON,88,112,92,86,23,201,201,0,201,0,1,8,70,54,31,19,13,5,0,27,113,61,201
20220131,31JAN2022:00:00:00,UFU GUTIERREZ,131,88,122,63,34,219,219,0,219,0,102,45,11,37,14,5,5,0,0,23,120,76,219
20220131,31JAN2022:00:00:00,UFU MUÑIZ,190,179,166,163,41,370,370,0,370,0,4,10,73,110,72,56,31,14,0,74,170,126,370
20220131,31JAN2022:00:00:00,UFU PENNA,150,147,156,125,16,297,297,0,297,0,22,14,73,81,38,35,19,15,0,47,162,88,297
20220131,31JAN2022:00:00:00,UFU PIROVANO,301,245,384,67,97,548,548,0,548,0,2,46,116,139,117,66,42,20,0,168,150,228,548
20220131,31JAN2022:00:00:00,UFU PIÑERO,203,222,346,68,11,425,425,0,425,0,0,15,121,79,89,76,31,14,0,55,247,121,425
20220131,31JAN2022:00:00:00,UFU RAMOS MEJIA,297,256,395,122,37,554,554,0,554,0,3,37,108,124,97,88,68,29,0,112,193,247,554
20220131,31JAN2022:00:00:00,UFU RIVADAVIA,339,260,401,116,83,600,600,0,600,0,1,18,149,157,114,86,39,36,0,147,203,248,600
20220131,31JAN2022:00:00:00,UFU SANTOJANNI,313,221,291,180,63,534,534,0,534,0,3,34,116,122,108,77,45,29,0,124,153,257,534
20220131,31JAN2022:00:00:00,UFU TORNU,220,223,388,36,20,444,444,0,444,0,22,49,78,92,92,43,41,27,0,101,194,149,444
20220131,31JAN2022:00:00:00,UFU VELEZ SARSFIELD,291,262,424,88,41,553,553,0,553,0,0,21,123,114,115,88,56,36,0,121,232,200,553
20220131,31JAN2022:00:00:00,UFU ZUBIZARRETA,265,187,275,140,40,455,455,0,455,0,3,37,114,96,76,76,31,22,0,95,133,227,455
20220201,01FEB2022:00:00:00,UFU ALVAREZ,253,221,388,53,34,475,475,0,475,0,20,39,84,105,94,62,36,35,0,87,220,168,475
20220324,24MAR2022:00:00:00,UFU RIVADAVIA,116,90,127,39,41,207,207,0,207,0,1,7,64,49,34,24,13,15,0,2,108,97,207
20220324,24MAR2022:00:00:00,UFU SANTOJANNI,67,55,77,24,22,123,123,0,123,0,1,13,14,47,25,8,14,1,0,2,62,59,123
20220324,24MAR2022:00:00:00,UFU TORNU,77,52,103,11,15,129,129,0,129,0,3,22,26,31,16,18,6,7,0,2,77,50,129
20220324,24MAR2022:00:00:00,UFU VELEZ SARSFIELD,105,73,132,35,11,178,178,0,178,0,0,17,36,41,47,20,11,6,0,3,116,59,178
20220324,24MAR2022:00:00:00,UFU ZUBIZARRETA,56,58,86,22,6,114,114,0,114,0,0,18,16,27,21,12,10,10,0,2,59,53,114
20220325,25MAR2022:00:00:00,UFU ALVAREZ,126,128,208,29,17,254,254,0,254,0,16,24,48,59,48,33,23,3,0,5,168,81,254
20220325,25MAR2022:00:00:00,UFU ARGERICH,22,22,26,9,9,44,44,0,44,0,0,3,15,7,6,5,2,6,0,1,21,22,44
20220325,25MAR2022:00:00:00,UFU BORDA-MOYANO,36,23,32,24,3,59,59,0,59,0,0,0,12,18,16,8,4,1,0,0,35,24,59
20220325,25MAR2022:00:00:00,UFU DURAND,68,68,118,14,4,136,136,0,136,0,0,5,34,44,20,13,18,2,0,9,74,53,136
20220325,25MAR2022:00:00:00,UFU ELIZALDE,44,27,8,60,3,71,71,0,71,0,40,16,6,4,2,2,1,0,0,0,36,35,71
20220325,25MAR2022:00:00:00,UFU FERNANDEZ,82,45,100,12,15,127,127,0,127,0,2,2,36,27,25,18,9,8,0,4,71,52,127
20220325,25MAR2022:00:00:00,UFU FERRER,52,41,56,32,5,93,93,0,93,0,0,0,18,33,22,6,12,2,0,1,66,26,93
20220325,25MAR2022:00:00:00,UFU GRIERSON,11,5,14,2,0,16,16,0,16,0,0,1,5,4,2,4,0,0,0,1,11,4,16
20220325,25MAR2022:00:00:00,UFU GUTIERREZ,130,98,159,66,3,228,228,0,228,0,160,39,6,12,8,3,0,0,0,1,169,58,228
20220325,25MAR2022:00:00:00,UFU MUÑIZ,67,72,70,57,12,139,139,0,139,0,5,14,35,21,22,22,20,0,0,1,99,39,139
20220325,25MAR2022:00:00:00,UFU PENNA,50,36,51,30,5,86,86,0,86,0,2,11,20,19,14,9,3,8,0,1,60,25,86
20220325,25MAR2022:00:00:00,UFU PIROVANO,129,89,151,29,38,218,218,0,218,0,0,15,62,55,32,23,12,19,0,12,115,91,218
20220325,25MAR2022:00:00:00,UFU PIÑERO,46,56,91,8,3,102,102,0,102,0,0,10,21,31,20,9,5,6,0,2,76,24,102
20220325,25MAR2022:00:00:00,UFU RAMOS MEJIA,81,54,102,21,12,135,135,0,135,0,0,0,28,40,36,15,8,8,0,2,72,60,135
20220325,25MAR2022:00:00:00,UFU RIVADAVIA,115,82,149,33,15,197,197,0,197,0,0,6,57,56,26,27,14,11,0,9,101,87,197
20220325,25MAR2022:00:00:00,UFU SANTOJANNI,59,64,71,45,7,123,123,0,123,0,0,8,25,26,13,26,12,13,0,8,68,47,123
20220325,25MAR2022:00:00:00,UFU TORNU,67,63,107,16,7,130,130,0,130,0,16,16,21,41,17,9,10,0,0,0,87,43,130
20220325,25MAR2022:00:00:00,UFU VELEZ SARSFIELD,83,62,107,27,11,145,145,0,145,0,0,6,37,34,34,19,15,0,0,7,91,47,145
20220325,25MAR2022:00:00:00,UFU ZUBIZARRETA,50,56,79,22,5,106,106,0,106,0,0,13,19,28,18,8,6,14,0,5,59,42,106
20220326,26MAR2022:00:00:00,UFU ALVAREZ,95,87,144,30,8,182,182,0,182,0,21,10,35,21,36,27,27,5,0,5,114,63,182
20220326,26MAR2022:00:00:00,UFU ARGERICH,16,16,17,15,0,32,32,0,32,0,0,0,12,9,6,3,2,0,0,1,16,15,32
20220326,26MAR2022:00:00:00,UFU BORDA-MOYANO,31,20,37,14,1,52,52,0,52,0,1,6,5,11,5,13,11,0,0,1,35,16,52
20220326,26MAR2022:00:00:00,UFU DURAND,79,52,123,8,0,131,131,0,131,0,0,19,29,35,28,12,6,2,0,3,66,62,131
20220326,26MAR2022:00:00:00,UFU ELIZALDE,36,17,25,24,4,53,53,0,53,0,23,18,4,5,1,0,2,0,0,0,21,32,53
20220326,26MAR2022:00:00:00,UFU FERNANDEZ,49,44,77,10,8,95,95,0,95,0,2,4,23,23,9,15,12,7,0,2,58,35,95
20220326,26MAR2022:00:00:00,UFU FERRER,32,38,17,50,8,75,75,0,75,0,5,0,20,16,28,3,0,3,0,0,50,25,75
20220326,26MAR2022:00:00:00,UFU GRIERSON,19,18,25,6,6,37,37,0,37,0,0,0,14,5,6,8,2,2,0,0,27,10,37
20220326,26MAR2022:00:00:00,UFU GUTIERREZ,121,92,133,72,8,213,213,0,213,0,152,58,3,0,0,0,0,0,0,0,150,63,213
20220326,26MAR2022:00:00:00,UFU MUÑIZ,55,65,49,45,27,121,121,0,121,0,1,16,26,37,12,19,8,2,0,3,82,36,121
20220326,26MAR2022:00:00:00,UFU PENNA,38,17,31,21,3,55,55,0,55,0,0,5,8,20,5,6,9,2,0,1,39,15,55
20220326,26MAR2022:00:00:00,UFU PIROVANO,81,96,134,26,17,177,177,0,177,0,0,18,39,43,24,20,17,16,0,8,87,82,177
20220326,26MAR2022:00:00:00,UFU PIÑERO,48,26,58,10,6,74,74,0,74,0,0,8,13,18,6,6,8,15,0,0,53,21,74
20220326,26MAR2022:00:00:00,UFU RAMOS MEJIA,82,70,107,26,20,153,153,0,153,0,5,8,48,27,13,11,23,18,0,3,106,44,153
20220326,26MAR2022:00:00:00,UFU RIVADAVIA,113,80,124,21,52,197,197,0,197,0,4,2,55,47,33,26,23,7,0,4,101,91,197
20220326,26MAR2022:00:00:00,UFU SANTOJANNI,61,39,71,20,9,100,100,0,100,0,0,15,23,11,28,12,3,8,0,4,47,49,100
20220326,26MAR2022:00:00:00,UFU TORNU,39,51,77,7,6,90,90,0,90,0,3,12,8,27,20,13,3,4,0,2,40,48,90
20220326,26MAR2022:00:00:00,UFU VELEZ SARSFIELD,81,67,108,20,20,148,148,0,148,0,0,13,24,40,34,18,13,6,0,2,98,48,148
20220326,26MAR2022:00:00:00,UFU ZUBIZARRETA,78,55,86,43,4,133,133,0,133,0,0,26,24,22,23,22,10,6,0,4,63,66,133
20220327,27MAR2022:00:00:00,UFU ALVAREZ,82,57,117,12,10,139,139,0,139,0,20,13,34,21,23,15,8,5,0,3,81,55,139
20220327,27MAR2022:00:00:00,UFU ARGERICH,21,32,35,15,3,53,53,0,53,0,1,3,5,10,13,11,6,4,0,2,29,22,53
20220327,27MAR2022:00:00:00,UFU BORDA-MOYANO,11,31,20,17,5,42,42,0,42,0,0,0,15,4,11,9,3,0,0,0,27,15,42
20220327,27MAR2022:00:00:00,UFU DURAND,44,29,68,3,2,73,73,0,73,0,0,4,25,14,12,10,3,5,0,6,38,29,73
20220327,27MAR2022:00:00:00,UFU ELIZALDE,30,21,15,36,0,51,51,0,51,0,28,12,2,7,2,0,0,0,0,0,24,27,51
20220327,27MAR2022:00:00:00,UFU FERNANDEZ,61,35,76,15,5,96,96,0,96,0,0,1,27,18,25,12,11,2,0,2,59,35,96
20220327,27MAR2022:00:00:00,UFU MUÑIZ,81,68,81,52,16,149,149,0,149,0,0,11,25,24,51,29,8,1,0,5,104,40,149
20220327,27MAR2022:00:00:00,UFU PENNA,18,31,33,16,0,49,49,0,49,0,0,2,17,12,7,5,6,0,0,0,36,13,49
20220327,27MAR2022:00:00:00,UFU PIROVANO,74,68,108,13,21,142,142,0,142,0,0,9,23,35,40,12,14,9,0,11,69,62,142
20220327,27MAR2022:00:00:00,UFU PIÑERO,36,25,49,8,4,61,61,0,61,0,0,3,10,15,19,6,6,2,0,5,40,16,61
20220327,27MAR2022:00:00:00,UFU RAMOS MEJIA,117,80,165,24,8,197,197,0,197,0,9,19,35,36,45,26,15,12,0,4,131,62,197
20220327,27MAR2022:00:00:00,UFU RIVADAVIA,89,65,116,19,19,154,154,0,154,0,0,8,23,49,26,16,24,8,0,8,81,65,154
20220327,27MAR2022:00:00:00,UFU SANTOJANNI,57,46,54,44,5,103,103,0,103,0,0,12,28,24,21,9,5,4,0,3,56,44,103
20220327,27MAR2022:00:00:00,UFU TORNU,48,66,95,8,11,114,114,0,114,0,7,19,14,33,24,4,5,8,0,2,76,36,114
20220327,27MAR2022:00:00:00,UFU VELEZ SARSFIELD,88,80,133,35,0,168,168,0,168,0,0,8,26,19,58,29,9,19,0,4,112,52,168
20220327,27MAR2022:00:00:00,UFU ZUBIZARRETA,67,50,83,28,6,117,117,0,117,0,0,23,10,26,34,12,12,0,0,2,55,60,117
20220328,28MAR2022:00:00:00,UFU ALVAREZ,203,157,290,43,27,360,360,0,360,0,42,33,93,82,35,31,27,17,0,7,233,120,360
20220328,28MAR2022:00:00:00,UFU ARGERICH,25,27,36,12,6,54,54,0,54,0,3,8,7,15,5,4,10,2,0,0,24,30,54
20220328,28MAR2022:00:00:00,UFU BORDA-MOYANO,18,20,16,17,7,40,40,0,40,0,2,3,0,16,11,4,2,2,0,0,25,15,40
20220328,28MAR2022:00:00:00,UFU DURAND,86,43,115,10,4,129,129,0,129,0,0,6,20,39,31,17,14,2,0,6,59,64,129
20220328,28MAR2022:00:00:00,UFU ELIZALDE,95,90,45,132,8,185,185,0,185,0,98,57,5,16,7,2,0,0,0,0,78,107,185
20220328,28MAR2022:00:00:00,UFU FERNANDEZ,56,69,95,17,14,126,126,0,126,0,1,6,28,35,18,17,7,14,0,3,75,48,126
20220606,06JUN2022:00:00:00,UFU GUTIERREZ,108,100,135,67,6,208,208,0,208,0,115,59,3,7,13,9,2,0,0,22,112,74,208
20220606,06JUN2022:00:00:00,UFU MUÑIZ,147,112,129,71,63,263,263,0,263,0,14,17,42,72,45,45,19,9,0,40,103,120,263
20220606,06JUN2022:00:00:00,UFU PENNA,58,44,72,26,4,102,102,0,102,0,5,5,18,31,15,17,6,5,0,20,53,29,102
20220606,06JUN2022:00:00:00,UFU PIROVANO,330,198,403,44,84,531,531,0,531,0,3,27,117,152,95,67,35,35,0,126,204,201,531
20220606,06JUN2022:00:00:00,UFU PIÑERO,130,74,167,18,19,204,204,0,204,0,0,14,41,47,41,20,33,8,0,26,117,61,204
20220606,06JUN2022:00:00:00,UFU RAMOS MEJIA,184,137,228,71,22,321,321,0,321,0,0,2,70,79,64,57,31,18,0,47,180,93,321
20220606,06JUN2022:00:00:00,UFU RIVADAVIA,616,323,669,147,132,948,948,0,948,0,9,58,194,272,103,151,101,60,0,143,396,409,948
20220606,06JUN2022:00:00:00,UFU SANTOJANNI,286,191,320,127,33,480,480,0,480,0,3,19,77,104,107,91,50,29,0,131,214,135,480
20220606,06JUN2022:00:00:00,UFU ZUBIZARRETA,175,110,195,59,34,288,288,0,288,0,3,24,55,59,47,52,32,16,0,77,124,87,288
20220607,07JUN2022:00:00:00,UFU ALVAREZ,260,177,359,42,38,439,439,0,439,0,2,33,82,98,100,54,41,29,0,90,210,139,439
20220607,07JUN2022:00:00:00,UFU ARGERICH,89,67,110,36,10,156,156,0,156,0,0,4,34,49,30,26,11,2,0,27,59,70,156
20220607,07JUN2022:00:00:00,UFU DURAND,321,186,453,31,26,510,510,0,510,0,3,26,92,149,106,52,56,26,0,120,235,155,510
20220607,07JUN2022:00:00:00,UFU GUTIERREZ,83,83,89,56,22,167,167,0,167,0,91,56,6,4,4,4,2,0,0,10,108,49,167
20220607,07JUN2022:00:00:00,UFU MUÑIZ,118,109,144,49,37,230,230,0,230,0,3,20,30,63,57,32,16,9,0,42,87,101,230
20220607,07JUN2022:00:00:00,UFU PENNA,38,40,47,27,4,78,78,0,78,0,0,14,20,15,17,4,7,1,0,15,41,22,78
20220607,07JUN2022:00:00:00,UFU PIROVANO,263,174,312,43,84,439,439,0,439,0,2,27,86,129,86,51,37,21,0,86,176,177,439
20220607,07JUN2022:00:00:00,UFU PIÑERO,115,72,161,16,12,189,189,0,189,0,2,13,28,43,48,28,16,11,0,35,92,62,189
20220607,07JUN2022:00:00:00,UFU RAMOS MEJIA,111,76,150,19,19,188,188,0,188,0,3,7,35,32,32,35,32,12,0,29,102,57,188
20220607,07JUN2022:00:00:00,UFU RIVADAVIA,464,269,548,80,110,738,738,0,738,0,5,20,188,154,129,115,76,51,0,126,329,281,738
20220607,07JUN2022:00:00:00,UFU SANTOJANNI,302,180,335,112,36,483,483,0,483,0,1,39,66,95,103,95,53,31,0,137,228,118,483
20220607,07JUN2022:00:00:00,UFU ZUBIZARRETA,140,112,171,52,30,253,253,0,253,0,1,13,55,54,55,28,22,25,0,53,107,93,253
20220608,08JUN2022:00:00:00,UFU ALVAREZ,266,152,353,38,29,420,420,0,420,0,2,32,94,102,94,52,34,10,0,75,205,140,420
20220608,08JUN2022:00:00:00,UFU ARGERICH,96,57,92,43,20,155,155,0,155,0,2,7,37,36,25,26,14,8,0,24,62,69,155
20220608,08JUN2022:00:00:00,UFU DURAND,323,197,453,26,42,521,521,0,521,0,2,32,90,169,107,53,46,22,0,136,221,164,521
20220608,08JUN2022:00:00:00,UFU GUTIERREZ,81,90,106,50,15,171,171,0,171,0,107,50,4,4,2,0,2,2,0,9,97,65,171
20220608,08JUN2022:00:00:00,UFU MUÑIZ,127,143,135,69,69,273,273,0,273,0,3,16,64,55,57,42,27,9,0,32,114,127,273
20220608,08JUN2022:00:00:00,UFU PENNA,46,41,73,7,8,88,88,0,88,0,3,3,20,22,15,18,7,0,0,14,42,32,88
20220608,08JUN2022:00:00:00,UFU PIROVANO,326,223,423,71,58,552,552,0,552,0,3,30,101,153,115,82,51,17,0,114,215,223,552
20220608,08JUN2022:00:00:00,UFU PIÑERO,94,75,144,15,10,169,169,0,169,0,0,6,35,28,33,31,25,11,0,27,92,50,169
20220608,08JUN2022:00:00:00,UFU RAMOS MEJIA,170,108,224,30,25,279,279,0,279,0,1,6,43,72,53,61,36,7,0,46,152,81,279
20220608,08JUN2022:00:00:00,UFU RIVADAVIA,563,351,682,122,114,918,918,0,918,0,5,35,226,198,160,138,98,58,0,162,383,373,918
20220608,08JUN2022:00:00:00,UFU SANTOJANNI,242,179,304,78,39,421,421,0,421,0,0,36,60,103,92,64,38,28,0,112,199,110,421
20220608,08JUN2022:00:00:00,UFU ZUBIZARRETA,151,119,203,52,17,272,272,0,272,0,2,30,37,71,49,46,15,22,0,53,130,89,272
20220609,09JUN2022:00:00:00,UFU ALVAREZ,212,141,295,29,31,355,355,0,355,0,3,16,74,91,79,42,31,19,0,62,179,114,355
20220609,09JUN2022:00:00:00,UFU ARGERICH,80,49,88,31,12,131,131,0,131,0,2,7,25,33,23,19,14,8,0,21,53,57,131
20220609,09JUN2022:00:00:00,UFU DURAND,274,175,388,25,39,452,452,0,452,0,4,27,93,109,95,64,41,19,0,97,222,133,452
20220609,09JUN2022:00:00:00,UFU GUTIERREZ,80,89,95,63,12,170,170,0,170,0,98,52,5,10,2,2,1,0,0,6,105,58,170
20220609,09JUN2022:00:00:00,UFU MUÑIZ,97,99,113,47,38,198,198,0,198,0,6,7,35,55,42,30,20,3,0,23,90,85,198
20220609,09JUN2022:00:00:00,UFU PENNA,56,32,52,33,5,90,90,0,90,0,7,4,11,26,13,11,14,4,0,12,52,26,90
20220609,09JUN2022:00:00:00,UFU PIROVANO,253,184,349,36,54,439,439,0,439,0,2,26,100,88,64,81,50,28,0,121,162,156,439
20220609,09JUN2022:00:00:00,UFU PIÑERO,85,70,128,19,8,155,155,0,155,0,1,7,34,31,43,20,16,3,0,27,81,47,155
20220609,09JUN2022:00:00:00,UFU RAMOS MEJIA,165,114,223,32,26,281,281,0,281,0,2,3,61,53,65,55,27,15,0,33,160,88,281
20220609,09JUN2022:00:00:00,UFU RIVADAVIA,472,266,564,87,98,749,749,0,749,0,11,29,175,170,114,109,83,58,0,136,337,276,749
20220609,09JUN2022:00:00:00,UFU SANTOJANNI,228,173,298,68,35,401,401,0,401,0,0,28,64,78,111,57,42,21,0,150,156,94,401
20220609,09JUN2022:00:00:00,UFU ZUBIZARRETA,132,95,149,58,22,229,229,0,229,0,2,7,33,57,54,45,23,8,0,56,89,84,229
20220610,10JUN2022:00:00:00,UFU ALVAREZ,187,110,260,19,19,298,298,0,298,0,1,16,57,64,70,36,32,22,0,51,166,81,298
20220610,10JUN2022:00:00:00,UFU ARGERICH,62,29,71,16,4,91,91,0,91,0,0,2,19,20,26,12,6,6,0,19,34,38,91
20220610,10JUN2022:00:00:00,UFU DURAND,258,170,362,34,34,430,430,0,430,0,2,34,99,96,75,51,52,21,0,101,199,130,430
20220610,10JUN2022:00:00:00,UFU GUTIERREZ,84,80,95,46,24,165,165,0,165,0,99,40,2,10,12,0,2,0,0,7,99,59,165
20220610,10JUN2022:00:00:00,UFU MUÑIZ,91,82,110,50,16,176,176,0,176,0,3,14,24,45,35,31,15,9,0,27,68,81,176
20220610,10JUN2022:00:00:00,UFU PENNA,38,34,51,17,5,73,73,0,73,0,1,0,13,24,7,25,1,2,0,11,24,38,73
20220610,10JUN2022:00:00:00,UFU PIROVANO,234,157,286,47,61,394,394,0,394,0,3,18,74,106,61,53,57,22,0,81,151,162,394
20220610,10JUN2022:00:00:00,UFU PIÑERO,58,56,104,3,7,114,114,0,114,0,0,17,26,23,14,18,14,2,0,18,65,31,114
20220610,10JUN2022:00:00:00,UFU RAMOS MEJIA,147,88,173,43,20,236,236,0,236,0,1,5,36,56,63,43,23,9,0,34,131,71,236
20220610,10JUN2022:00:00:00,UFU RIVADAVIA,354,173,392,87,57,536,536,0,536,0,9,14,137,129,80,77,51,39,0,95,256,185,536
20220610,10JUN2022:00:00:00,UFU SANTOJANNI,231,132,258,80,25,363,363,0,363,0,1,33,37,93,76,45,45,33,0,116,160,87,363
20220610,10JUN2022:00:00:00,UFU ZUBIZARRETA,119,82,143,41,18,202,202,0,202,0,1,5,28,54,43,31,18,22,0,44,88,70,202
20220611,11JUN2022:00:00:00,UFU ALVAREZ,176,111,242,26,23,291,291,0,291,0,4,23,37,76,62,45,31,13,0,50,141,100,291
20220611,11JUN2022:00:00:00,UFU ARGERICH,10,9,12,7,0,19,19,0,19,0,0,3,0,4,3,2,4,3,0,3,9,7,19
20220611,11JUN2022:00:00:00,UFU DURAND,164,110,249,12,14,275,275,0,275,0,1,15,52,63,63,31,32,18,0,55,140,80,275
20220611,11JUN2022:00:00:00,UFU GUTIERREZ,48,42,59,23,8,90,90,0,90,0,57,30,0,0,0,1,2,0,0,6,35,49,90
20220611,11JUN2022:00:00:00,UFU MUÑIZ,106,77,97,64,24,185,185,0,185,0,4,14,20,49,30,39,21,8,0,26,77,82,185
20220611,11JUN2022:00:00:00,UFU PIROVANO,198,170,272,51,45,368,368,0,368,0,0,18,44,99,93,41,48,25,0,62,158,148,368
20220611,11JUN2022:00:00:00,UFU PIÑERO,51,45,73,11,12,96,96,0,96,0,0,8,10,13,35,23,5,2,0,16,50,30,96
20220611,11JUN2022:00:00:00,UFU RAMOS MEJIA,116,72,169,9,11,189,189,0,189,0,7,18,26,38,28,40,21,11,0,39,96,54,189
20220201,01FEB2022:00:00:00,UFU ARGERICH,58,70,74,51,3,128,128,0,128,0,10,12,23,27,29,14,5,8,0,34,37,56,128
20220201,01FEB2022:00:00:00,UFU BORDA-MOYANO,116,137,146,93,14,253,253,0,253,0,2,6,56,45,58,47,19,20,0,44,98,111,253
20220201,01FEB2022:00:00:00,UFU DURAND,303,230,418,62,53,533,533,0,533,0,0,41,114,119,94,84,65,16,0,151,174,207,533
20220201,01FEB2022:00:00:00,UFU ELIZALDE,114,80,51,138,6,195,195,0,195,0,102,45,8,16,16,6,0,2,0,28,80,87,195
20220201,01FEB2022:00:00:00,UFU FERNANDEZ,229,198,267,80,80,427,427,0,427,0,0,19,102,98,58,60,45,45,0,85,139,201,427
20220201,01FEB2022:00:00:00,UFU FERRER,158,164,146,132,44,322,322,0,322,0,0,10,74,92,47,57,33,9,0,53,174,95,322
20220201,01FEB2022:00:00:00,UFU GRIERSON,50,59,70,32,7,109,109,0,109,0,0,5,32,34,15,16,3,4,0,21,56,32,109
20220201,01FEB2022:00:00:00,UFU GUTIERREZ,99,66,106,32,27,165,165,0,165,0,73,45,2,17,18,8,2,0,0,27,64,74,165
20220201,01FEB2022:00:00:00,UFU MUÑIZ,143,168,157,113,41,311,311,0,311,0,3,18,75,70,69,43,17,16,0,58,164,89,311
20220201,01FEB2022:00:00:00,UFU PENNA,152,125,134,130,13,277,277,0,277,0,18,11,84,65,43,34,19,3,0,25,183,69,277
20220201,01FEB2022:00:00:00,UFU PIROVANO,264,195,317,56,87,460,460,0,460,0,1,24,88,134,95,45,47,26,0,142,127,191,460
20220201,01FEB2022:00:00:00,UFU PIÑERO,188,148,243,61,32,336,336,0,336,0,0,15,96,82,74,42,16,11,0,40,202,91,336
20220201,01FEB2022:00:00:00,UFU RAMOS MEJIA,213,182,291,89,15,395,395,0,395,0,5,27,78,92,72,70,31,20,0,79,141,174,395
20220201,01FEB2022:00:00:00,UFU RIVADAVIA,288,176,322,92,50,464,464,0,464,0,0,18,133,114,76,70,29,24,0,99,180,185,464
20220201,01FEB2022:00:00:00,UFU SANTOJANNI,211,143,199,114,42,355,355,0,355,0,3,32,74,57,82,56,31,20,0,88,112,155,355
20220201,01FEB2022:00:00:00,UFU TORNU,227,197,355,44,25,424,424,0,424,0,12,42,79,92,95,56,22,26,0,81,218,122,424
20220201,01FEB2022:00:00:00,UFU VELEZ SARSFIELD,221,246,373,57,38,468,468,0,468,0,1,20,103,82,105,85,45,27,0,96,218,154,468
20220201,01FEB2022:00:00:00,UFU ZUBIZARRETA,179,159,226,92,24,342,342,0,342,0,4,9,87,76,83,41,28,14,0,83,98,161,342
20220202,02FEB2022:00:00:00,UFU ALVAREZ,229,187,326,65,59,450,450,0,450,0,59,37,96,95,73,43,32,15,0,70,190,190,450
20220202,02FEB2022:00:00:00,UFU ARGERICH,88,71,92,67,14,173,173,0,173,0,35,9,35,45,19,17,6,7,0,29,53,91,173
20220202,02FEB2022:00:00:00,UFU BORDA-MOYANO,83,123,141,61,12,214,214,0,214,0,12,9,37,43,38,44,26,5,0,35,75,104,214
20220202,02FEB2022:00:00:00,UFU DURAND,238,196,368,28,65,461,461,0,461,0,27,21,107,121,68,53,35,29,0,140,91,230,461
20220202,02FEB2022:00:00:00,UFU ELIZALDE,106,100,65,137,24,226,226,0,226,0,136,43,18,13,11,1,4,0,0,28,83,115,226
20220202,02FEB2022:00:00:00,UFU FERNANDEZ,188,167,242,69,75,386,386,0,386,0,32,13,85,94,56,42,36,28,0,65,149,172,386
20220202,02FEB2022:00:00:00,UFU FERRER,154,132,134,146,31,311,311,0,311,0,25,5,86,84,50,31,16,14,0,53,137,121,311
20220202,02FEB2022:00:00:00,UFU GRIERSON,71,64,84,43,14,141,141,0,141,0,6,17,34,21,31,23,9,0,0,23,59,59,141
20220202,02FEB2022:00:00:00,UFU GUTIERREZ,100,48,85,44,28,157,157,0,157,0,70,38,11,18,9,4,7,0,0,25,53,79,157
20220202,02FEB2022:00:00:00,UFU MUÑIZ,162,160,148,116,77,341,341,0,341,0,19,31,79,73,57,55,14,13,0,40,176,125,341
20220202,02FEB2022:00:00:00,UFU PENNA,104,129,96,123,39,258,258,0,258,0,55,16,51,53,32,34,9,8,0,29,141,88,258
20220202,02FEB2022:00:00:00,UFU PIROVANO,271,222,384,50,98,532,532,0,532,0,39,17,106,144,74,68,45,39,0,139,147,246,532
20220202,02FEB2022:00:00:00,UFU PIÑERO,166,138,256,44,30,330,330,0,330,0,26,21,93,75,60,31,17,7,0,31,194,104,330
20220202,02FEB2022:00:00:00,UFU RAMOS MEJIA,238,176,301,91,47,439,439,0,439,0,26,28,95,78,84,66,43,19,0,91,143,204,439
20220202,02FEB2022:00:00:00,UFU RIVADAVIA,257,193,309,79,97,485,485,0,485,0,35,20,110,125,69,63,38,25,0,116,144,223,485
20220202,02FEB2022:00:00:00,UFU SANTOJANNI,254,189,267,126,88,481,481,0,481,0,47,22,115,100,65,67,43,22,0,152,125,204,481
20220202,02FEB2022:00:00:00,UFU TORNU,197,190,327,47,37,411,411,0,411,0,31,32,66,91,76,50,37,28,0,89,169,152,411
20220202,02FEB2022:00:00:00,UFU VELEZ SARSFIELD,186,184,287,60,41,388,388,0,388,0,18,24,84,63,86,45,43,25,0,62,182,144,388
20220202,02FEB2022:00:00:00,UFU ZUBIZARRETA,167,133,223,58,42,323,323,0,323,0,23,14,45,81,62,27,38,33,0,63,109,151,323
20220203,03FEB2022:00:00:00,UFU ALVAREZ,188,181,270,53,48,371,371,0,371,0,18,9,87,82,68,37,37,33,0,56,132,183,371
20220203,03FEB2022:00:00:00,UFU ARGERICH,63,50,53,51,11,115,115,0,115,0,9,9,26,22,17,14,8,10,0,31,31,51,115
20220203,03FEB2022:00:00:00,UFU BORDA-MOYANO,55,66,71,41,11,123,123,0,123,0,3,9,15,25,40,16,13,2,0,27,49,47,123
20220203,03FEB2022:00:00:00,UFU DURAND,275,208,353,49,86,488,488,0,488,0,5,12,125,170,65,47,41,23,0,124,155,209,488
20220203,03FEB2022:00:00:00,UFU ELIZALDE,123,96,53,132,39,224,224,0,224,0,128,48,17,19,7,5,0,0,0,16,100,108,224
20220203,03FEB2022:00:00:00,UFU FERNANDEZ,123,100,137,41,49,227,227,0,227,0,4,12,60,44,36,43,16,12,0,47,87,93,227
20220203,03FEB2022:00:00:00,UFU FERRER,121,149,122,106,45,273,273,0,273,0,3,8,65,72,68,35,17,5,0,41,147,85,273
20220203,03FEB2022:00:00:00,UFU GRIERSON,70,89,102,40,20,162,162,0,162,0,3,9,45,45,30,11,19,0,0,18,98,46,162
20220203,03FEB2022:00:00:00,UFU GUTIERREZ,71,60,74,33,24,131,131,0,131,0,66,34,0,10,10,10,1,0,0,17,57,57,131
20220203,03FEB2022:00:00:00,UFU MUÑIZ,120,154,132,90,53,275,275,0,275,0,1,15,72,57,56,48,11,15,0,43,144,87,275
20220203,03FEB2022:00:00:00,UFU PENNA,89,90,113,49,20,182,182,0,182,0,13,15,37,40,19,32,15,11,0,31,100,51,182
20220203,03FEB2022:00:00:00,UFU PIROVANO,224,178,281,41,87,409,409,0,409,0,7,28,78,116,69,54,39,18,0,109,126,174,409
20220203,03FEB2022:00:00:00,UFU PIÑERO,176,112,199,49,46,294,294,0,294,0,6,18,91,53,40,49,22,15,0,39,169,81,294
20220203,03FEB2022:00:00:00,UFU RAMOS MEJIA,182,153,231,52,53,336,336,0,336,0,3,13,53,86,73,47,42,19,0,64,122,150,336
20220203,03FEB2022:00:00:00,UFU RIVADAVIA,192,147,223,44,85,352,352,0,352,0,13,14,84,99,50,42,32,18,0,86,118,148,352
20220203,03FEB2022:00:00:00,UFU SANTOJANNI,181,216,197,106,103,406,406,0,406,0,11,29,103,92,84,42,24,21,0,124,131,151,406
20220203,03FEB2022:00:00:00,UFU TORNU,166,107,208,35,32,275,275,0,275,0,7,21,72,56,50,28,10,31,0,47,142,86,275
20220203,03FEB2022:00:00:00,UFU VELEZ SARSFIELD,211,199,289,69,54,412,412,0,412,0,2,28,102,81,89,68,26,16,0,62,208,142,412
20220203,03FEB2022:00:00:00,UFU ZUBIZARRETA,174,135,205,74,35,314,314,0,314,0,5,30,65,74,44,47,39,10,0,78,86,150,314
20220204,04FEB2022:00:00:00,UFU ALVAREZ,199,140,260,54,25,339,339,0,339,0,10,19,80,74,47,52,41,16,0,64,136,139,339
20220204,04FEB2022:00:00:00,UFU ARGERICH,49,33,58,22,2,82,82,0,82,0,3,6,13,13,17,22,2,6,0,18,29,33,82
20220204,04FEB2022:00:00:00,UFU BORDA-MOYANO,80,50,67,47,16,130,130,0,130,0,0,10,33,21,22,25,14,5,0,26,51,53,130
20220204,04FEB2022:00:00:00,UFU DURAND,273,192,398,45,22,465,465,0,465,0,0,31,86,121,95,58,50,24,0,110,156,199,465
20220204,04FEB2022:00:00:00,UFU ELIZALDE,87,75,43,113,6,162,162,0,162,0,87,37,7,8,9,11,2,1,0,17,71,74,162
20220204,04FEB2022:00:00:00,UFU FERNANDEZ,134,84,161,20,38,219,219,0,219,0,1,0,40,51,24,45,40,18,0,49,74,96,219
20220204,04FEB2022:00:00:00,UFU FERRER,120,114,99,69,66,234,234,0,234,0,0,15,65,56,41,25,20,12,0,46,115,73,234
20220204,04FEB2022:00:00:00,UFU GRIERSON,118,109,130,82,16,228,228,0,228,0,1,18,70,50,37,28,15,9,0,25,138,65,228
20220328,28MAR2022:00:00:00,UFU FERRER,51,18,36,23,10,69,69,0,69,0,0,0,20,16,18,11,4,0,0,5,39,25,69
20220328,28MAR2022:00:00:00,UFU GRIERSON,26,32,35,19,5,59,59,0,59,0,1,3,25,9,16,0,4,1,0,0,38,21,59
20220328,28MAR2022:00:00:00,UFU GUTIERREZ,167,188,244,96,16,356,356,0,356,0,236,99,8,9,2,2,0,0,0,3,242,111,356
20220328,28MAR2022:00:00:00,UFU MUÑIZ,86,126,101,92,21,214,214,0,214,0,6,20,55,47,35,27,15,9,0,2,139,73,214
20220328,28MAR2022:00:00:00,UFU PENNA,75,30,75,26,4,105,105,0,105,0,0,5,22,29,17,16,8,8,0,3,60,42,105
20220328,28MAR2022:00:00:00,UFU PIROVANO,178,122,219,41,40,300,300,0,300,0,0,23,55,70,60,41,25,26,0,17,151,132,300
20220328,28MAR2022:00:00:00,UFU PIÑERO,60,76,103,24,10,137,137,0,137,0,1,11,29,25,34,17,10,10,0,2,98,36,137
20220328,28MAR2022:00:00:00,UFU RAMOS MEJIA,130,97,180,26,22,228,228,0,228,0,1,2,56,56,53,28,13,19,0,4,155,69,228
20220328,28MAR2022:00:00:00,UFU RIVADAVIA,168,129,212,51,37,300,300,0,300,0,3,12,99,52,46,29,26,33,0,9,152,138,300
20220328,28MAR2022:00:00:00,UFU SANTOJANNI,95,85,115,57,8,180,180,0,180,0,0,22,27,43,32,28,14,14,0,9,80,91,180
20220328,28MAR2022:00:00:00,UFU TORNU,118,81,149,44,6,199,199,0,199,0,14,44,25,42,33,24,8,9,0,4,111,83,199
20220328,28MAR2022:00:00:00,UFU VELEZ SARSFIELD,127,132,177,57,26,260,260,0,260,0,1,42,43,55,43,39,17,20,0,4,175,81,260
20220328,28MAR2022:00:00:00,UFU ZUBIZARRETA,83,65,100,36,12,148,148,0,148,0,0,33,36,33,19,4,11,12,0,4,70,74,148
20220329,29MAR2022:00:00:00,UFU ALVAREZ,159,114,200,29,44,273,273,0,273,0,22,49,73,46,25,18,29,11,0,3,163,107,273
20220329,29MAR2022:00:00:00,UFU ARGERICH,55,46,50,38,13,101,101,0,101,0,10,5,29,27,9,9,9,3,0,3,44,54,101
20220329,29MAR2022:00:00:00,UFU BORDA-MOYANO,20,16,15,17,4,36,36,0,36,0,0,2,6,11,2,6,6,3,0,0,17,19,36
20220329,29MAR2022:00:00:00,UFU DURAND,108,84,160,18,14,192,192,0,192,0,0,30,46,55,20,13,20,8,0,2,94,96,192
20220329,29MAR2022:00:00:00,UFU ELIZALDE,57,60,42,71,4,117,117,0,117,0,69,30,7,6,4,0,1,0,0,0,51,66,117
20220329,29MAR2022:00:00:00,UFU FERNANDEZ,63,63,99,14,13,126,126,0,126,0,0,16,36,36,19,10,3,6,0,6,67,53,126
20220329,29MAR2022:00:00:00,UFU FERRER,49,24,46,24,3,73,73,0,73,0,0,0,21,21,6,13,9,3,0,4,44,25,73
20220329,29MAR2022:00:00:00,UFU GRIERSON,25,17,25,17,2,44,44,0,44,0,2,7,15,18,0,2,0,0,0,0,36,8,44
20220329,29MAR2022:00:00:00,UFU GUTIERREZ,161,171,227,80,25,332,332,0,332,0,186,110,7,12,12,3,2,0,0,5,211,116,332
20220329,29MAR2022:00:00:00,UFU MUÑIZ,82,81,61,77,27,165,165,0,165,0,4,7,26,33,39,32,15,9,0,5,111,49,165
20220329,29MAR2022:00:00:00,UFU PENNA,38,20,41,12,5,58,58,0,58,0,0,1,20,11,18,6,0,2,0,2,37,19,58
20220329,29MAR2022:00:00:00,UFU PIROVANO,169,134,221,28,54,303,303,0,303,0,0,12,75,87,57,40,20,12,0,22,137,144,303
20220329,29MAR2022:00:00:00,UFU PIÑERO,79,68,108,30,11,149,149,0,149,0,2,22,22,40,32,18,7,6,0,0,107,42,149
20220329,29MAR2022:00:00:00,UFU RAMOS MEJIA,126,102,177,41,10,228,228,0,228,0,0,4,68,62,27,32,19,16,0,13,135,79,228
20220329,29MAR2022:00:00:00,UFU RIVADAVIA,155,101,189,41,29,259,259,0,259,0,3,8,94,52,32,33,29,8,0,12,121,124,259
20220329,29MAR2022:00:00:00,UFU SANTOJANNI,132,93,129,88,8,225,225,0,225,0,0,39,46,31,49,32,12,16,0,7,107,111,225
20220329,29MAR2022:00:00:00,UFU TORNU,136,102,182,40,16,238,238,0,238,0,22,38,57,48,22,23,21,7,0,2,146,88,238
20220329,29MAR2022:00:00:00,UFU VELEZ SARSFIELD,99,105,131,47,26,204,204,0,204,0,0,19,48,56,27,36,18,0,0,3,143,58,204
20220329,29MAR2022:00:00:00,UFU ZUBIZARRETA,76,59,89,36,12,137,137,0,137,0,2,14,27,20,26,24,15,9,0,7,65,65,137
20220330,30MAR2022:00:00:00,UFU ALVAREZ,135,131,211,38,17,266,266,0,266,0,21,44,35,39,59,10,40,18,0,5,165,96,266
20220330,30MAR2022:00:00:00,UFU ARGERICH,27,30,25,28,4,57,57,0,57,0,1,5,17,16,12,4,2,0,0,2,27,28,57
20220330,30MAR2022:00:00:00,UFU BORDA-MOYANO,22,31,26,25,4,55,55,0,55,0,2,1,22,9,10,7,2,2,0,1,28,26,55
20220330,30MAR2022:00:00:00,UFU DURAND,99,60,138,12,9,159,159,0,159,0,0,20,39,36,23,25,9,7,0,4,74,81,159
20220330,30MAR2022:00:00:00,UFU ELIZALDE,88,52,40,97,6,143,143,0,143,0,88,26,11,10,7,1,0,0,0,1,56,86,143
20220330,30MAR2022:00:00:00,UFU FERNANDEZ,36,46,67,9,6,82,82,0,82,0,0,10,34,19,5,8,6,0,0,3,43,35,82
20220330,30MAR2022:00:00:00,UFU FERRER,44,42,36,45,5,86,86,0,86,0,0,3,14,41,8,5,10,5,0,8,54,24,86
20220330,30MAR2022:00:00:00,UFU GRIERSON,27,14,31,6,4,41,41,0,41,0,0,3,8,10,10,3,7,0,0,0,32,9,41
20220330,30MAR2022:00:00:00,UFU GUTIERREZ,165,186,219,95,37,351,351,0,351,0,238,85,0,3,16,7,2,0,0,5,233,113,351
20220330,30MAR2022:00:00:00,UFU MUÑIZ,86,43,57,67,5,129,129,0,129,0,3,8,19,36,39,14,8,2,0,1,88,40,129
20220330,30MAR2022:00:00:00,UFU PENNA,22,28,32,17,2,51,51,0,51,0,1,10,10,7,7,11,5,0,0,0,33,18,51
20220330,30MAR2022:00:00:00,UFU PIROVANO,135,110,179,23,44,246,246,0,246,0,1,27,37,76,34,38,29,4,0,13,118,114,246
20220330,30MAR2022:00:00:00,UFU PIÑERO,55,39,81,8,5,94,94,0,94,0,0,9,15,32,4,14,9,11,0,3,61,30,94
20220330,30MAR2022:00:00:00,UFU RAMOS MEJIA,117,89,137,53,16,206,206,0,206,0,0,1,59,50,22,36,15,23,0,7,101,98,206
20220330,30MAR2022:00:00:00,UFU RIVADAVIA,143,96,191,32,19,242,242,0,242,0,3,10,78,56,45,16,13,21,0,8,129,104,242
20220330,30MAR2022:00:00:00,UFU SANTOJANNI,100,87,120,63,5,188,188,0,188,0,1,32,42,28,36,26,13,10,0,7,91,90,188
20220330,30MAR2022:00:00:00,UFU TORNU,92,61,122,15,16,153,153,0,153,0,5,19,35,33,23,17,11,10,0,0,93,58,153
20220330,30MAR2022:00:00:00,UFU VELEZ SARSFIELD,128,90,171,31,16,218,218,0,218,0,0,29,41,35,55,18,21,19,0,5,145,68,218
20220330,30MAR2022:00:00:00,UFU ZUBIZARRETA,53,55,79,19,10,108,108,0,108,0,0,13,23,28,22,12,4,6,0,6,53,49,108
20220331,31MAR2022:00:00:00,UFU ALVAREZ,92,90,148,18,16,182,182,0,182,0,21,30,28,27,39,14,14,9,0,5,116,61,182
20220331,31MAR2022:00:00:00,UFU ARGERICH,43,35,47,27,4,78,78,0,78,0,3,4,32,14,9,2,7,7,0,4,33,40,78
20220331,31MAR2022:00:00:00,UFU BORDA-MOYANO,30,8,28,6,4,38,38,0,38,0,0,1,12,8,8,8,1,0,0,1,23,14,38
20220331,31MAR2022:00:00:00,UFU DURAND,102,44,127,14,7,148,148,0,148,0,2,10,40,41,22,14,11,8,0,8,65,75,148
20220331,31MAR2022:00:00:00,UFU ELIZALDE,31,19,19,29,2,50,50,0,50,0,31,4,3,7,1,3,1,0,0,0,24,26,50
20220331,31MAR2022:00:00:00,UFU FERNANDEZ,79,47,92,9,26,127,127,0,127,0,1,4,37,26,20,22,9,8,0,4,68,55,127
20220331,31MAR2022:00:00:00,UFU FERRER,40,8,35,5,8,48,48,0,48,0,0,0,15,5,13,6,6,3,0,0,34,14,48
20220331,31MAR2022:00:00:00,UFU GRIERSON,4,8,12,0,0,12,12,0,12,0,0,0,4,0,0,3,5,0,0,0,9,3,12
20220331,31MAR2022:00:00:00,UFU GUTIERREZ,119,156,155,105,15,275,275,0,275,0,182,82,3,3,2,3,0,0,0,5,177,93,275
20220331,31MAR2022:00:00:00,UFU MUÑIZ,63,78,66,64,13,143,143,0,143,0,2,16,12,36,29,25,17,6,0,3,91,49,143
20220331,31MAR2022:00:00:00,UFU PENNA,37,31,44,24,1,69,69,0,69,0,1,3,20,19,5,9,9,3,0,2,44,23,69
20220331,31MAR2022:00:00:00,UFU PIROVANO,133,100,183,20,31,234,234,0,234,0,1,19,52,42,56,18,21,25,0,10,117,107,234
20220331,31MAR2022:00:00:00,UFU PIÑERO,65,48,95,10,8,113,113,0,113,0,0,9,34,28,25,5,9,3,0,2,81,30,113
20220331,31MAR2022:00:00:00,UFU RAMOS MEJIA,95,53,114,27,8,149,149,0,149,0,1,0,43,40,24,22,6,13,0,1,96,50,149
20220331,31MAR2022:00:00:00,UFU RIVADAVIA,114,68,153,14,17,184,184,0,184,0,4,2,81,34,26,14,15,8,0,7,89,88,184
20220331,31MAR2022:00:00:00,UFU SANTOJANNI,82,59,96,28,19,143,143,0,143,0,2,14,18,34,27,30,13,5,0,14,58,71,143
20220611,11JUN2022:00:00:00,UFU RIVADAVIA,250,146,305,41,52,398,398,0,398,0,2,20,108,77,68,69,38,16,0,70,198,130,398
20220611,11JUN2022:00:00:00,UFU SANTOJANNI,162,106,170,70,31,271,271,0,271,0,4,28,42,58,54,43,25,17,0,41,132,98,271
20220611,11JUN2022:00:00:00,UFU ZUBIZARRETA,178,122,236,53,14,303,303,0,303,0,3,15,26,72,66,57,42,22,0,59,135,109,303
20220612,12JUN2022:00:00:00,UFU ALVAREZ,170,110,232,25,24,281,281,0,281,0,1,12,28,63,69,44,48,16,0,49,142,90,281
20220612,12JUN2022:00:00:00,UFU ARGERICH,29,19,34,12,2,48,48,0,48,0,0,2,4,4,11,7,16,4,0,6,20,22,48
20220612,12JUN2022:00:00:00,UFU DURAND,192,123,289,18,10,317,317,0,317,0,2,15,40,88,71,45,29,27,0,89,130,98,317
20220612,12JUN2022:00:00:00,UFU GUTIERREZ,53,60,79,33,1,113,113,0,113,0,69,40,0,4,0,0,0,0,0,11,42,60,113
20220612,12JUN2022:00:00:00,UFU MUÑIZ,81,49,94,31,5,130,130,0,130,0,0,4,15,29,37,22,15,8,0,22,48,60,130
20220612,12JUN2022:00:00:00,UFU PIROVANO,233,149,298,34,54,386,386,0,386,0,5,19,45,99,85,60,33,40,0,104,137,145,386
20220612,12JUN2022:00:00:00,UFU PIÑERO,55,34,71,12,6,89,89,0,89,0,0,12,14,16,16,13,12,6,0,7,52,30,89
20220612,12JUN2022:00:00:00,UFU RAMOS MEJIA,123,84,161,32,14,207,207,0,207,0,11,21,23,54,46,20,13,19,0,25,114,68,207
20220612,12JUN2022:00:00:00,UFU RIVADAVIA,282,160,343,53,49,445,445,0,445,0,3,23,70,102,73,71,63,40,0,73,210,161,445
20220612,12JUN2022:00:00:00,UFU SANTOJANNI,125,87,150,48,15,213,213,0,213,0,1,13,30,50,55,39,13,12,0,52,85,76,213
20220612,12JUN2022:00:00:00,UFU ZUBIZARRETA,161,104,203,46,17,266,266,0,266,0,1,25,30,64,47,53,27,19,0,64,113,89,266
20220613,13JUN2022:00:00:00,UFU ALVAREZ,241,143,311,53,24,388,388,0,388,0,4,29,64,103,67,62,40,19,0,62,203,123,388
20220613,13JUN2022:00:00:00,UFU ARGERICH,90,64,100,38,20,158,158,0,158,0,4,2,16,43,28,40,8,17,0,14,63,81,158
20220613,13JUN2022:00:00:00,UFU DURAND,307,173,423,32,26,481,481,0,481,0,1,35,79,127,113,43,50,33,0,104,244,133,481
20220613,13JUN2022:00:00:00,UFU GUTIERREZ,89,85,105,52,17,174,174,0,174,0,104,41,6,6,7,5,3,2,0,9,111,54,174
20220613,13JUN2022:00:00:00,UFU MUÑIZ,118,96,143,53,19,215,215,0,215,0,3,16,41,58,33,40,15,9,0,29,89,97,215
20220613,13JUN2022:00:00:00,UFU PENNA,55,33,66,19,5,90,90,0,90,0,4,5,18,25,13,15,8,2,0,15,49,26,90
20220613,13JUN2022:00:00:00,UFU PIROVANO,280,157,340,55,43,438,438,0,438,0,1,19,72,112,86,63,51,34,0,91,195,152,438
20220613,13JUN2022:00:00:00,UFU PIÑERO,103,72,146,19,11,176,176,0,176,0,1,12,17,52,36,24,20,14,0,28,96,52,176
20220613,13JUN2022:00:00:00,UFU RAMOS MEJIA,175,100,177,65,39,281,281,0,281,0,6,3,52,66,48,60,32,14,0,39,163,79,281
20220613,13JUN2022:00:00:00,UFU RIVADAVIA,399,229,472,92,68,632,632,0,632,0,4,27,154,136,132,88,52,39,0,120,302,210,632
20220613,13JUN2022:00:00:00,UFU SANTOJANNI,216,192,292,104,14,410,410,0,410,0,2,26,62,104,84,65,42,25,0,127,182,101,410
20220613,13JUN2022:00:00:00,UFU ZUBIZARRETA,146,81,141,63,26,230,230,0,230,0,3,21,25,49,57,35,28,12,0,46,105,79,230
20220614,14JUN2022:00:00:00,UFU ALVAREZ,262,142,321,47,40,408,408,0,408,0,4,32,83,76,82,55,56,20,0,76,203,128,408
20220614,14JUN2022:00:00:00,UFU ARGERICH,95,59,105,33,17,155,155,0,155,0,2,9,37,32,32,21,9,13,0,24,67,64,155
20220614,14JUN2022:00:00:00,UFU DURAND,278,178,397,39,24,460,460,0,460,0,4,31,89,108,106,59,42,21,0,98,221,141,460
20220614,14JUN2022:00:00:00,UFU GUTIERREZ,122,53,115,53,7,175,175,0,175,0,109,45,1,8,1,7,3,1,0,13,96,66,175
20220614,14JUN2022:00:00:00,UFU MUÑIZ,114,108,111,89,24,224,224,0,224,0,4,28,37,42,47,35,23,8,0,25,101,98,224
20220614,14JUN2022:00:00:00,UFU PENNA,46,32,52,20,6,78,78,0,78,0,0,8,9,20,18,17,4,2,0,7,46,25,78
20220614,14JUN2022:00:00:00,UFU PIROVANO,240,187,328,49,50,427,427,0,427,0,0,21,86,126,75,56,38,25,0,81,173,173,427
20220614,14JUN2022:00:00:00,UFU PIÑERO,105,59,136,22,7,165,165,0,165,0,1,6,24,30,38,43,18,5,0,29,86,50,165
20220614,14JUN2022:00:00:00,UFU RAMOS MEJIA,157,109,200,35,32,267,267,0,267,0,1,3,59,76,43,50,24,11,0,34,148,85,267
20220614,14JUN2022:00:00:00,UFU RIVADAVIA,382,231,438,105,79,622,622,0,622,0,10,23,136,164,99,83,61,46,0,102,289,231,622
20220614,14JUN2022:00:00:00,UFU SANTOJANNI,255,160,275,117,25,417,417,0,417,0,2,46,64,91,96,65,37,16,0,121,184,111,417
20220614,14JUN2022:00:00:00,UFU ZUBIZARRETA,137,105,169,59,16,244,244,0,244,0,2,12,28,63,49,40,20,30,0,59,99,86,244
20220615,15JUN2022:00:00:00,UFU ALVAREZ,215,134,291,35,25,351,351,0,351,0,2,24,52,71,60,71,48,23,0,62,177,112,351
20220615,15JUN2022:00:00:00,UFU ARGERICH,73,46,80,30,9,119,119,0,119,0,0,8,15,28,18,31,12,7,0,17,43,58,119
20220615,15JUN2022:00:00:00,UFU DURAND,303,195,460,19,21,500,500,0,500,0,2,18,106,157,84,71,37,25,0,123,231,146,500
20220615,15JUN2022:00:00:00,UFU GUTIERREZ,80,79,101,50,8,159,159,0,159,0,98,31,5,12,6,5,1,1,0,9,96,54,159
20220615,15JUN2022:00:00:00,UFU MUÑIZ,129,134,133,111,22,266,266,0,266,0,6,15,38,83,52,36,21,15,0,38,107,121,266
20220615,15JUN2022:00:00:00,UFU PENNA,45,15,37,21,3,61,61,0,61,0,1,1,9,14,18,12,4,2,0,10,28,23,61
20220615,15JUN2022:00:00:00,UFU PIROVANO,270,199,360,49,62,471,471,0,471,0,2,20,104,109,103,66,41,26,0,108,180,183,471
20220615,15JUN2022:00:00:00,UFU PIÑERO,122,79,184,5,15,204,204,0,204,0,3,19,36,50,37,35,15,9,0,35,107,62,204
20220615,15JUN2022:00:00:00,UFU RAMOS MEJIA,177,118,231,36,32,299,299,0,299,0,4,7,64,75,74,28,25,22,0,35,169,95,299
20220615,15JUN2022:00:00:00,UFU RIVADAVIA,421,255,488,105,89,682,682,0,682,0,6,22,174,158,110,92,67,53,0,110,312,260,682
20220615,15JUN2022:00:00:00,UFU SANTOJANNI,211,159,252,92,27,371,371,0,371,0,1,31,72,70,64,61,38,34,0,106,163,102,371
20220615,15JUN2022:00:00:00,UFU ZUBIZARRETA,134,107,173,52,16,241,241,0,241,0,0,12,40,49,48,52,26,14,0,43,113,85,241
20220616,16JUN2022:00:00:00,UFU ALVAREZ,232,113,282,34,30,346,346,0,346,0,1,16,80,74,74,46,23,32,0,60,180,106,346
20220616,16JUN2022:00:00:00,UFU ARGERICH,55,25,51,23,6,80,80,0,80,0,0,5,18,16,10,18,8,5,0,13,29,37,80
20220616,16JUN2022:00:00:00,UFU DURAND,242,139,334,24,24,382,382,0,382,0,2,17,79,109,67,56,30,22,0,76,202,104,382
20220616,16JUN2022:00:00:00,UFU GUTIERREZ,77,66,86,52,7,145,145,0,145,0,92,36,6,5,0,3,3,0,0,6,77,62,145
20220616,16JUN2022:00:00:00,UFU MUÑIZ,91,81,104,45,27,176,176,0,176,0,4,15,34,51,30,16,20,6,0,25,69,82,176
20220616,16JUN2022:00:00:00,UFU PENNA,35,20,42,12,3,57,57,0,57,0,2,1,18,7,11,7,10,1,0,13,24,20,57
20220616,16JUN2022:00:00:00,UFU PIROVANO,226,160,286,41,62,389,389,0,389,0,3,23,62,119,61,58,36,27,0,84,155,150,389
20220616,16JUN2022:00:00:00,UFU PIÑERO,105,68,136,8,30,174,174,0,174,0,1,13,39,26,20,40,30,5,0,23,92,59,174
20220616,16JUN2022:00:00:00,UFU RAMOS MEJIA,172,77,198,27,24,249,249,0,249,0,0,6,41,53,44,54,33,18,0,41,127,81,249
20220616,16JUN2022:00:00:00,UFU RIVADAVIA,392,224,463,92,62,617,617,0,617,0,1,19,150,152,93,76,65,61,0,107,304,206,617
20220616,16JUN2022:00:00:00,UFU SANTOJANNI,200,177,248,83,47,378,378,0,378,0,1,30,68,81,64,50,46,38,0,140,138,99,378
20220616,16JUN2022:00:00:00,UFU ZUBIZARRETA,83,68,119,28,7,154,154,0,154,0,3,6,13,37,29,32,17,17,0,30,62,62,154
20220617,17JUN2022:00:00:00,UFU ALVAREZ,133,118,222,13,16,251,251,0,251,0,0,13,41,60,42,41,39,15,0,55,116,80,251
20220617,17JUN2022:00:00:00,UFU ARGERICH,22,21,27,16,1,44,44,0,44,0,1,0,5,13,4,9,9,3,0,7,17,20,44
20220617,17JUN2022:00:00:00,UFU DURAND,153,132,246,21,18,285,285,0,285,0,2,10,45,83,50,45,34,16,0,75,126,84,285
20220204,04FEB2022:00:00:00,UFU GUTIERREZ,100,57,106,37,15,158,158,0,158,0,79,31,7,19,7,8,7,0,0,9,104,45,158
20220204,04FEB2022:00:00:00,UFU MUÑIZ,159,127,144,108,35,287,287,0,287,0,1,23,43,55,59,61,31,14,0,43,159,85,287
20220204,04FEB2022:00:00:00,UFU PENNA,107,83,110,76,4,190,190,0,190,0,22,16,45,19,37,27,20,4,0,20,123,47,190
20220204,04FEB2022:00:00:00,UFU PIROVANO,224,173,259,77,61,397,397,0,397,0,0,24,91,98,69,49,45,21,0,104,132,161,397
20220204,04FEB2022:00:00:00,UFU PIÑERO,157,124,233,24,24,281,281,0,281,0,0,32,66,71,42,37,24,9,0,25,176,77,281
20220204,04FEB2022:00:00:00,UFU RAMOS MEJIA,184,146,211,75,44,330,330,0,330,0,6,20,73,86,55,44,34,12,0,70,118,142,330
20220204,04FEB2022:00:00:00,UFU RIVADAVIA,168,144,225,57,30,312,312,0,312,0,0,16,67,72,48,66,25,18,0,79,102,131,312
20220204,04FEB2022:00:00:00,UFU SANTOJANNI,185,141,189,88,49,326,326,0,326,0,2,17,50,77,55,45,44,36,0,104,104,118,326
20220204,04FEB2022:00:00:00,UFU TORNU,86,93,149,13,17,179,179,0,179,0,6,8,36,33,43,14,23,16,0,40,86,53,179
20220204,04FEB2022:00:00:00,UFU VELEZ SARSFIELD,223,149,268,71,34,373,373,0,373,0,1,43,59,76,84,60,35,15,0,76,179,118,373
20220204,04FEB2022:00:00:00,UFU ZUBIZARRETA,163,145,191,94,23,308,308,0,308,0,0,35,72,52,52,49,31,17,0,65,96,147,308
20220205,05FEB2022:00:00:00,UFU ALVAREZ,109,90,142,47,10,199,199,0,199,0,0,13,50,56,27,24,7,22,0,29,83,87,199
20220205,05FEB2022:00:00:00,UFU ARGERICH,41,61,60,42,0,102,102,0,102,0,4,2,21,22,31,11,5,6,0,26,32,44,102
20220205,05FEB2022:00:00:00,UFU BORDA-MOYANO,41,62,48,52,3,103,103,0,103,0,0,15,25,30,15,8,8,2,0,11,66,26,103
20220205,05FEB2022:00:00:00,UFU DURAND,207,152,300,41,19,360,360,0,360,0,1,2,67,82,78,68,33,29,0,79,114,167,360
20220205,05FEB2022:00:00:00,UFU ELIZALDE,79,82,51,109,1,161,161,0,161,0,94,34,12,6,12,3,0,0,0,14,79,68,161
20220205,05FEB2022:00:00:00,UFU FERNANDEZ,87,61,116,21,11,148,148,0,148,0,0,6,25,28,20,39,17,13,0,24,64,60,148
20220205,05FEB2022:00:00:00,UFU FERRER,79,80,86,70,3,159,159,0,159,0,0,0,38,38,46,17,10,10,0,32,82,45,159
20220205,05FEB2022:00:00:00,UFU GRIERSON,127,78,121,63,21,205,205,0,205,0,0,17,57,47,33,35,14,2,0,24,123,58,205
20220205,05FEB2022:00:00:00,UFU GUTIERREZ,78,62,94,39,7,140,140,0,140,0,75,34,5,13,7,2,2,2,0,15,56,68,140
20220205,05FEB2022:00:00:00,UFU MUÑIZ,106,109,97,100,19,216,216,0,216,0,1,22,48,42,56,26,18,3,0,26,128,62,216
20220205,05FEB2022:00:00:00,UFU PENNA,101,57,81,72,5,158,158,0,158,0,9,11,51,13,31,28,4,11,0,21,86,51,158
20220205,05FEB2022:00:00:00,UFU PIROVANO,139,91,174,28,28,230,230,0,230,0,0,9,47,71,35,32,18,18,0,65,70,95,230
20220205,05FEB2022:00:00:00,UFU PIÑERO,93,92,128,46,11,185,185,0,185,0,0,11,69,27,31,17,27,3,0,19,111,55,185
20220205,05FEB2022:00:00:00,UFU RAMOS MEJIA,108,71,140,23,18,181,181,0,181,0,9,17,38,37,41,17,13,9,0,24,80,77,181
20220205,05FEB2022:00:00:00,UFU RIVADAVIA,160,144,222,51,33,306,306,0,306,0,2,6,86,85,47,32,29,19,0,49,136,121,306
20220205,05FEB2022:00:00:00,UFU SANTOJANNI,160,140,167,116,18,301,301,0,301,0,1,26,62,62,60,45,23,22,0,70,94,137,301
20220205,05FEB2022:00:00:00,UFU TORNU,80,96,137,14,25,176,176,0,176,0,0,21,26,45,29,30,14,11,0,39,75,62,176
20220205,05FEB2022:00:00:00,UFU VELEZ SARSFIELD,173,112,218,47,20,285,285,0,285,0,0,17,44,65,48,50,42,19,0,62,133,90,285
20220205,05FEB2022:00:00:00,UFU ZUBIZARRETA,148,126,190,78,6,274,274,0,274,0,0,14,41,62,47,51,30,29,0,53,90,131,274
20220206,06FEB2022:00:00:00,UFU ALVAREZ,145,133,242,25,11,278,278,0,278,0,8,23,41,68,42,34,30,32,0,35,139,102,278
20220206,06FEB2022:00:00:00,UFU ARGERICH,30,28,34,24,0,58,58,0,58,0,2,0,2,16,13,15,8,2,0,11,23,24,58
20220206,06FEB2022:00:00:00,UFU BORDA-MOYANO,57,47,56,44,4,104,104,0,104,0,0,0,10,25,31,27,7,4,0,14,61,29,104
20220206,06FEB2022:00:00:00,UFU DURAND,186,142,286,13,29,328,328,0,328,0,6,18,39,90,54,61,42,18,0,87,108,133,328
20220206,06FEB2022:00:00:00,UFU ELIZALDE,52,63,48,55,12,115,115,0,115,0,60,23,13,14,3,2,0,0,0,12,49,54,115
20220206,06FEB2022:00:00:00,UFU FERNANDEZ,88,64,125,17,10,152,152,0,152,0,0,7,33,31,23,27,18,13,0,34,53,65,152
20220206,06FEB2022:00:00:00,UFU FERRER,68,60,64,58,6,128,128,0,128,0,0,0,31,36,24,15,10,12,0,28,67,33,128
20220206,06FEB2022:00:00:00,UFU GRIERSON,76,69,75,60,10,145,145,0,145,0,0,0,18,37,35,49,6,0,0,15,92,38,145
20220206,06FEB2022:00:00:00,UFU GUTIERREZ,81,98,101,63,15,179,179,0,179,0,88,43,17,13,12,4,2,0,0,27,70,80,179
20220206,06FEB2022:00:00:00,UFU MUÑIZ,74,77,83,56,12,151,151,0,151,0,0,13,28,27,31,33,13,6,0,18,77,56,151
20220206,06FEB2022:00:00:00,UFU PENNA,76,59,91,38,6,135,135,0,135,0,11,14,28,35,21,14,7,5,0,16,77,42,135
20220206,06FEB2022:00:00:00,UFU PIROVANO,120,106,183,27,16,226,226,0,226,0,6,10,25,57,51,43,22,12,0,49,81,96,226
20220206,06FEB2022:00:00:00,UFU PIÑERO,72,54,98,22,6,126,126,0,126,0,0,10,27,12,37,21,16,3,0,16,75,35,126
20220206,06FEB2022:00:00:00,UFU RAMOS MEJIA,111,80,133,23,35,191,191,0,191,0,6,15,28,44,40,20,23,15,0,35,73,83,191
20220206,06FEB2022:00:00:00,UFU RIVADAVIA,157,85,145,48,50,243,243,0,243,0,1,3,42,57,43,56,22,19,0,32,113,98,243
20220206,06FEB2022:00:00:00,UFU SANTOJANNI,137,92,113,103,13,229,229,0,229,0,0,5,44,54,52,43,19,12,0,75,58,96,229
20220206,06FEB2022:00:00:00,UFU TORNU,84,71,136,13,6,155,155,0,155,0,12,12,19,34,44,18,12,4,0,25,76,52,155
20220206,06FEB2022:00:00:00,UFU VELEZ SARSFIELD,125,137,192,45,25,262,262,0,262,0,0,16,32,53,55,61,18,27,0,47,129,86,262
20220206,06FEB2022:00:00:00,UFU ZUBIZARRETA,120,121,170,66,6,242,242,0,242,0,1,10,42,41,59,50,20,19,0,53,71,118,242
20220207,07FEB2022:00:00:00,UFU ALVAREZ,227,159,288,80,18,386,386,0,386,0,20,43,94,60,80,36,29,24,0,47,184,155,386
20220207,07FEB2022:00:00:00,UFU ARGERICH,50,29,46,30,3,79,79,0,79,0,5,5,12,16,10,15,4,12,0,20,26,33,79
20220207,07FEB2022:00:00:00,UFU BORDA-MOYANO,64,79,85,41,18,144,144,0,144,0,5,2,35,19,21,39,14,9,0,18,66,60,144
20220207,07FEB2022:00:00:00,UFU DURAND,248,167,344,59,12,415,415,0,415,0,0,30,91,79,73,65,53,24,0,93,138,184,415
20220207,07FEB2022:00:00:00,UFU ELIZALDE,117,88,50,144,13,207,207,0,207,0,119,46,17,12,9,2,2,0,0,18,100,89,207
20220207,07FEB2022:00:00:00,UFU FERNANDEZ,121,109,142,58,30,230,230,0,230,0,0,6,43,74,38,33,21,15,0,36,94,100,230
20220207,07FEB2022:00:00:00,UFU FERRER,128,94,82,107,33,222,222,0,222,0,1,4,80,43,54,19,20,1,0,34,115,73,222
20220207,07FEB2022:00:00:00,UFU GRIERSON,78,102,121,53,7,181,181,0,181,0,1,19,42,44,46,18,7,4,0,11,124,46,181
20220207,07FEB2022:00:00:00,UFU GUTIERREZ,92,110,105,67,31,203,203,0,203,0,99,54,14,16,19,1,0,0,0,24,80,99,203
20220207,07FEB2022:00:00:00,UFU MUÑIZ,143,120,123,102,39,264,264,0,264,0,1,10,50,68,71,34,15,15,0,28,154,81,264
20220207,07FEB2022:00:00:00,UFU PENNA,142,146,139,143,6,288,288,0,288,0,34,28,70,59,42,13,30,12,0,21,190,77,288
20220207,07FEB2022:00:00:00,UFU PIROVANO,171,109,217,35,29,281,281,0,281,0,1,6,63,67,60,32,34,18,0,46,123,112,281
20220207,07FEB2022:00:00:00,UFU PIÑERO,178,111,224,44,21,289,289,0,289,0,0,12,79,67,44,50,25,12,0,21,183,85,289
20220207,07FEB2022:00:00:00,UFU RAMOS MEJIA,197,141,239,61,38,338,338,0,338,0,0,11,60,80,56,52,49,30,0,49,143,145,338
20220207,07FEB2022:00:00:00,UFU RIVADAVIA,194,131,231,62,33,326,326,0,326,0,1,9,85,84,56,54,26,11,0,48,134,143,326
20220207,07FEB2022:00:00:00,UFU SANTOJANNI,195,209,198,149,57,404,404,0,404,0,3,40,92,81,83,53,29,23,0,99,149,156,404
20220331,31MAR2022:00:00:00,UFU TORNU,87,70,139,15,3,157,157,0,157,0,17,18,27,29,30,27,4,5,0,5,79,73,157
20220331,31MAR2022:00:00:00,UFU VELEZ SARSFIELD,117,70,148,18,21,187,187,0,187,0,0,32,44,44,25,16,14,12,0,2,123,62,187
20220331,31MAR2022:00:00:00,UFU ZUBIZARRETA,59,47,83,15,8,106,106,0,106,0,0,18,17,19,17,19,10,6,0,6,49,51,106
20220401,01APR2022:00:00:00,UFU ALVAREZ,85,87,130,39,3,172,172,0,172,0,5,15,35,47,23,30,3,14,0,6,101,65,172
20220401,01APR2022:00:00:00,UFU ARGERICH,22,32,39,13,2,54,54,0,54,0,10,7,9,6,2,9,5,6,0,2,23,29,54
20220401,01APR2022:00:00:00,UFU DURAND,68,64,116,10,6,132,132,0,132,0,0,9,34,31,24,20,8,6,0,5,61,66,132
20220401,01APR2022:00:00:00,UFU FERNANDEZ,45,25,58,6,6,70,70,0,70,0,2,4,23,9,12,6,8,6,0,2,38,30,70
20220401,01APR2022:00:00:00,UFU GUTIERREZ,124,108,133,81,19,233,233,0,233,0,153,59,9,12,0,0,0,0,0,1,165,67,233
20220401,01APR2022:00:00:00,UFU MUÑIZ,52,64,61,39,22,122,122,0,122,0,8,7,11,30,30,22,11,3,0,1,69,52,122
20220401,01APR2022:00:00:00,UFU PENNA,37,17,31,15,8,54,54,0,54,0,0,6,3,7,11,13,14,0,0,1,38,15,54
20220401,01APR2022:00:00:00,UFU PIROVANO,113,81,143,25,26,194,194,0,194,0,0,10,40,47,39,23,15,20,0,8,99,87,194
20220401,01APR2022:00:00:00,UFU PIÑERO,58,52,91,12,7,110,110,0,110,0,0,13,27,20,19,18,11,2,0,1,81,27,110
20220401,01APR2022:00:00:00,UFU RAMOS MEJIA,91,63,107,28,19,154,154,0,154,0,0,1,51,21,30,22,10,19,0,6,96,52,154
20220401,01APR2022:00:00:00,UFU RIVADAVIA,120,57,124,27,27,178,178,0,178,0,1,2,59,49,18,23,18,8,0,5,94,79,178
20220401,01APR2022:00:00:00,UFU SANTOJANNI,69,54,71,40,12,123,123,0,123,0,0,11,24,20,31,12,13,12,0,0,65,58,123
20220401,01APR2022:00:00:00,UFU TORNU,70,28,92,3,3,98,98,0,98,0,9,20,11,17,15,14,5,7,0,6,43,49,98
20220401,01APR2022:00:00:00,UFU VELEZ SARSFIELD,88,61,125,15,9,149,149,0,149,0,0,17,33,35,28,20,14,2,0,1,95,53,149
20220401,01APR2022:00:00:00,UFU ZUBIZARRETA,62,34,76,14,6,96,96,0,96,0,0,21,16,15,23,11,10,0,0,2,46,48,96
20220402,02APR2022:00:00:00,UFU ALVAREZ,53,43,65,14,17,96,96,0,96,0,7,16,19,14,6,13,11,10,0,3,47,46,96
20220402,02APR2022:00:00:00,UFU ARGERICH,20,17,26,11,0,37,37,0,37,0,1,3,7,9,7,2,6,2,0,4,20,13,37
20220402,02APR2022:00:00:00,UFU DURAND,52,24,66,6,4,76,76,0,76,0,0,6,18,22,13,9,6,2,0,8,32,36,76
20220402,02APR2022:00:00:00,UFU FERNANDEZ,18,11,25,2,2,29,29,0,29,0,0,4,2,9,4,6,4,0,0,3,13,13,29
20220402,02APR2022:00:00:00,UFU GUTIERREZ,86,77,107,49,8,164,164,0,164,0,89,71,0,4,0,0,0,0,0,1,109,54,164
20220402,02APR2022:00:00:00,UFU MUÑIZ,43,69,64,25,25,114,114,0,114,0,2,14,25,23,15,17,15,3,0,1,69,44,114
20220402,02APR2022:00:00:00,UFU PENNA,18,28,35,11,1,47,47,0,47,0,1,3,18,9,5,8,3,0,0,1,29,17,47
20220402,02APR2022:00:00:00,UFU PIROVANO,78,61,103,14,22,139,139,0,139,0,0,9,29,31,29,29,9,3,0,10,67,62,139
20220402,02APR2022:00:00:00,UFU PIÑERO,34,31,44,8,13,65,65,0,65,0,0,3,24,4,17,14,0,3,0,0,46,19,65
20220402,02APR2022:00:00:00,UFU RAMOS MEJIA,73,34,88,12,7,107,107,0,107,0,5,6,16,27,23,20,4,6,0,3,66,38,107
20220402,02APR2022:00:00:00,UFU RIVADAVIA,81,66,97,33,18,148,148,0,148,0,1,23,38,41,15,16,4,10,0,5,73,69,148
20220402,02APR2022:00:00:00,UFU SANTOJANNI,26,25,29,14,8,51,51,0,51,0,0,7,8,6,11,14,2,3,0,4,22,25,51
20220402,02APR2022:00:00:00,UFU TORNU,32,8,35,4,1,40,40,0,40,0,2,4,7,2,9,7,9,0,0,1,19,20,40
20220402,02APR2022:00:00:00,UFU VELEZ SARSFIELD,77,53,104,23,3,130,130,0,130,0,0,23,30,27,35,8,7,0,0,9,78,43,130
20220402,02APR2022:00:00:00,UFU ZUBIZARRETA,43,34,56,17,6,79,79,0,79,0,2,9,12,18,11,13,6,8,0,7,36,36,79
20220403,03APR2022:00:00:00,UFU ALVAREZ,57,55,90,12,10,112,112,0,112,0,21,20,12,24,15,12,6,2,0,3,55,54,112
20220403,03APR2022:00:00:00,UFU ARGERICH,23,26,31,14,4,49,49,0,49,0,0,4,9,9,8,9,2,8,0,0,28,21,49
20220403,03APR2022:00:00:00,UFU DURAND,53,23,68,4,4,76,76,0,76,0,0,4,11,19,26,7,2,7,0,7,35,34,76
20220403,03APR2022:00:00:00,UFU FERNANDEZ,42,38,77,3,0,80,80,0,80,0,0,10,28,18,8,7,7,2,0,2,39,39,80
20220403,03APR2022:00:00:00,UFU GUTIERREZ,79,77,110,34,12,156,156,0,156,0,101,42,6,2,3,2,0,0,0,4,99,53,156
20220403,03APR2022:00:00:00,UFU MUÑIZ,71,60,78,43,11,132,132,0,132,0,1,7,28,32,32,21,6,5,0,3,91,38,132
20220403,03APR2022:00:00:00,UFU PENNA,21,13,29,3,2,34,34,0,34,0,0,6,9,8,2,7,2,0,0,0,28,6,34
20220403,03APR2022:00:00:00,UFU PIROVANO,87,64,130,14,7,151,151,0,151,0,0,16,28,38,28,22,16,3,0,12,75,64,151
20220403,03APR2022:00:00:00,UFU PIÑERO,26,18,37,5,2,44,44,0,44,0,0,8,12,5,5,12,2,0,0,0,34,10,44
20220403,03APR2022:00:00:00,UFU RAMOS MEJIA,77,63,115,15,10,140,140,0,140,0,5,8,26,21,29,29,15,7,0,8,81,50,140
20220403,03APR2022:00:00:00,UFU RIVADAVIA,82,74,119,22,16,157,157,0,157,0,1,3,33,31,27,27,17,18,0,10,75,72,157
20220403,03APR2022:00:00:00,UFU SANTOJANNI,59,30,52,31,7,90,90,0,90,0,1,15,19,13,14,10,13,5,0,3,43,44,90
20220403,03APR2022:00:00:00,UFU TORNU,42,44,81,2,3,86,86,0,86,0,0,15,13,12,18,17,8,3,0,3,49,34,86
20220403,03APR2022:00:00:00,UFU VELEZ SARSFIELD,67,52,85,29,5,119,119,0,119,0,0,6,26,31,24,11,18,3,0,4,76,39,119
20220403,03APR2022:00:00:00,UFU ZUBIZARRETA,44,35,53,24,2,79,79,0,79,0,0,12,6,9,26,10,10,6,0,6,37,36,79
20220404,04APR2022:00:00:00,UFU ALVAREZ,155,126,227,34,20,281,281,0,281,0,49,32,22,58,46,25,26,23,0,10,151,120,281
20220404,04APR2022:00:00:00,UFU ARGERICH,37,40,40,24,14,78,78,0,78,0,4,8,22,11,10,6,6,11,0,1,37,40,78
20220404,04APR2022:00:00:00,UFU BORDA-MOYANO,7,0,5,2,0,7,7,0,7,0,0,0,0,5,0,0,2,0,0,0,4,3,7
20220404,04APR2022:00:00:00,UFU DURAND,74,57,107,16,8,131,131,0,131,0,0,8,28,41,19,15,18,2,0,5,62,64,131
20220404,04APR2022:00:00:00,UFU FERNANDEZ,48,43,67,8,17,92,92,0,92,0,1,5,24,18,17,12,6,9,0,2,52,38,92
20220404,04APR2022:00:00:00,UFU GUTIERREZ,185,172,201,137,21,359,359,0,359,0,242,82,6,8,18,3,0,0,0,5,241,113,359
20220404,04APR2022:00:00:00,UFU MUÑIZ,72,78,83,43,24,150,150,0,150,0,0,12,35,34,32,15,20,2,0,4,86,60,150
20220404,04APR2022:00:00:00,UFU PENNA,37,30,41,24,3,68,68,0,68,0,3,10,22,16,0,4,8,5,0,1,53,14,68
20220404,04APR2022:00:00:00,UFU PIROVANO,121,62,145,20,19,184,184,0,184,0,1,12,27,46,32,37,15,14,0,7,94,83,184
20220404,04APR2022:00:00:00,UFU PIÑERO,81,52,102,24,8,134,134,0,134,0,1,14,32,18,40,12,14,3,0,0,98,36,134
20220404,04APR2022:00:00:00,UFU RAMOS MEJIA,112,85,127,37,34,198,198,0,198,0,3,3,45,50,50,23,15,9,0,3,135,60,198
20220404,04APR2022:00:00:00,UFU RIVADAVIA,150,78,157,50,21,228,228,0,228,0,0,16,68,38,49,21,13,23,0,4,121,101,228
20220404,04APR2022:00:00:00,UFU SANTOJANNI,114,78,125,57,10,192,192,0,192,0,2,15,24,39,43,31,22,16,0,7,88,97,192
20220404,04APR2022:00:00:00,UFU TORNU,101,65,138,19,9,166,166,0,166,0,6,17,43,25,31,27,9,8,0,2,97,67,166
20220404,04APR2022:00:00:00,UFU VELEZ SARSFIELD,114,77,151,25,18,194,194,0,194,0,3,29,35,19,47,35,12,14,0,10,121,63,194
20220404,04APR2022:00:00:00,UFU ZUBIZARRETA,98,68,128,30,8,166,166,0,166,0,0,20,20,30,46,25,17,8,0,17,67,82,166
20220405,05APR2022:00:00:00,UFU ALVAREZ,131,89,185,21,14,220,220,0,220,0,11,33,31,38,42,35,14,16,0,8,127,85,220
20220405,05APR2022:00:00:00,UFU ARGERICH,33,30,45,12,6,63,63,0,63,0,10,11,7,18,9,3,1,4,0,4,28,31,63
20220405,05APR2022:00:00:00,UFU DURAND,86,73,129,22,8,159,159,0,159,0,0,20,37,38,17,21,14,12,0,13,66,80,159
20220405,05APR2022:00:00:00,UFU FERNANDEZ,37,27,44,13,7,64,64,0,64,0,0,1,18,14,9,14,6,2,0,1,36,27,64
20220617,17JUN2022:00:00:00,UFU GUTIERREZ,0,10,8,2,0,10,10,0,10,0,6,4,0,0,0,0,0,0,0,1,3,6,10
20220617,17JUN2022:00:00:00,UFU MUÑIZ,102,68,108,43,21,172,172,0,172,0,6,11,40,31,28,30,17,9,0,20,71,81,172
20220617,17JUN2022:00:00:00,UFU PIROVANO,204,150,261,38,59,358,358,0,358,0,4,16,70,87,74,43,38,26,0,63,157,138,358
20220617,17JUN2022:00:00:00,UFU PIÑERO,63,39,72,17,14,103,103,0,103,0,1,8,15,19,23,20,12,5,0,22,52,29,103
20220617,17JUN2022:00:00:00,UFU RAMOS MEJIA,104,73,146,15,16,177,177,0,177,0,9,22,23,44,29,22,21,7,0,35,87,55,177
20220617,17JUN2022:00:00:00,UFU RIVADAVIA,226,136,301,25,39,365,365,0,365,0,3,14,89,71,39,51,60,38,0,80,160,125,365
20220617,17JUN2022:00:00:00,UFU SANTOJANNI,170,112,174,73,37,284,284,0,284,0,2,15,50,61,57,38,33,28,0,56,124,104,284
20220617,17JUN2022:00:00:00,UFU ZUBIZARRETA,97,56,107,34,13,154,154,0,154,0,1,11,24,34,20,27,15,22,0,29,58,67,154
20220618,18JUN2022:00:00:00,UFU ALVAREZ,143,70,184,13,17,214,214,0,214,0,1,15,36,52,35,20,30,25,0,34,115,65,214
20220618,18JUN2022:00:00:00,UFU DURAND,135,92,202,8,18,228,228,0,228,0,1,9,38,63,48,33,26,10,0,58,104,66,228
20220618,18JUN2022:00:00:00,UFU GUTIERREZ,8,5,5,8,0,13,13,0,13,0,7,5,0,1,0,0,0,0,0,3,6,4,13
20220618,18JUN2022:00:00:00,UFU MUÑIZ,101,77,108,36,34,178,178,0,178,0,4,16,24,46,34,30,18,6,0,23,71,84,178
20220618,18JUN2022:00:00:00,UFU PIROVANO,170,112,223,26,33,282,282,0,282,0,0,10,41,87,61,27,35,21,0,56,112,114,282
20220618,18JUN2022:00:00:00,UFU PIÑERO,53,31,67,9,8,84,84,0,84,0,0,4,8,17,24,12,12,7,0,17,46,21,84
20220618,18JUN2022:00:00:00,UFU RAMOS MEJIA,67,52,106,6,8,120,120,0,120,0,2,5,11,24,36,23,11,8,0,26,55,39,120
20220618,18JUN2022:00:00:00,UFU RIVADAVIA,194,157,269,35,51,355,355,0,355,0,4,15,92,75,49,58,30,32,0,70,162,123,355
20220618,18JUN2022:00:00:00,UFU SANTOJANNI,130,87,132,51,36,219,219,0,219,0,2,17,26,49,60,31,23,11,0,43,96,80,219
20220618,18JUN2022:00:00:00,UFU ZUBIZARRETA,126,83,161,32,20,213,213,0,213,0,4,15,24,23,38,45,36,28,0,41,85,87,213
20220619,19JUN2022:00:00:00,UFU ALVAREZ,92,59,135,11,8,154,154,0,154,0,3,10,25,32,30,35,10,9,0,26,82,46,154
20220619,19JUN2022:00:00:00,UFU ARGERICH,6,8,10,4,0,14,14,0,14,0,0,0,2,4,0,2,4,2,0,7,4,3,14
20220619,19JUN2022:00:00:00,UFU DURAND,80,68,130,5,14,149,149,0,149,0,1,3,21,48,25,24,15,12,0,39,69,41,149
20220619,19JUN2022:00:00:00,UFU GUTIERREZ,10,3,8,3,3,14,14,0,14,0,10,4,0,0,0,0,0,0,0,1,7,6,14
20220619,19JUN2022:00:00:00,UFU MUÑIZ,45,29,48,17,10,75,75,0,75,0,1,11,3,15,15,23,2,5,0,13,26,36,75
20220619,19JUN2022:00:00:00,UFU PIROVANO,155,81,190,16,33,239,239,0,239,0,3,7,36,69,52,31,26,15,0,54,91,94,239
20220619,19JUN2022:00:00:00,UFU PIÑERO,15,14,21,6,2,29,29,0,29,0,0,1,3,8,3,7,5,2,0,4,16,9,29
20220619,19JUN2022:00:00:00,UFU RAMOS MEJIA,59,38,84,4,9,97,97,0,97,0,4,3,10,26,19,10,16,9,0,20,46,31,97
20220619,19JUN2022:00:00:00,UFU RIVADAVIA,171,84,199,25,31,255,255,0,255,0,0,10,47,58,28,56,35,21,0,43,122,90,255
20220619,19JUN2022:00:00:00,UFU SANTOJANNI,68,46,84,23,9,116,116,0,116,0,2,4,18,17,26,22,14,13,0,27,49,40,116
20220619,19JUN2022:00:00:00,UFU ZUBIZARRETA,107,82,145,39,8,192,192,0,192,0,3,8,20,38,40,41,31,11,0,48,66,78,192
20220620,20JUN2022:00:00:00,UFU ALVAREZ,169,89,227,12,21,260,260,0,260,0,2,25,33,31,51,45,46,27,0,37,142,81,260
20220620,20JUN2022:00:00:00,UFU ARGERICH,28,14,31,8,6,45,45,0,45,0,3,3,7,16,2,2,6,6,0,10,12,23,45
20220620,20JUN2022:00:00:00,UFU DURAND,173,123,277,12,7,296,296,0,296,0,0,3,47,88,66,42,34,16,0,78,122,96,296
20220620,20JUN2022:00:00:00,UFU GUTIERREZ,5,0,1,4,0,5,5,0,5,0,2,1,0,2,0,0,0,0,0,1,1,3,5
20220620,20JUN2022:00:00:00,UFU MUÑIZ,81,68,107,35,8,150,150,0,150,0,1,10,24,29,36,31,13,6,0,6,61,83,150
20220620,20JUN2022:00:00:00,UFU PIROVANO,203,116,254,35,32,321,321,0,321,0,2,8,55,89,48,45,48,26,0,83,121,117,321
20220620,20JUN2022:00:00:00,UFU PIÑERO,36,31,51,9,9,69,69,0,69,0,2,2,13,18,15,13,6,0,0,11,32,26,69
20220620,20JUN2022:00:00:00,UFU RAMOS MEJIA,79,67,123,11,16,150,150,0,150,0,9,6,24,24,31,30,22,4,0,22,80,48,150
20220620,20JUN2022:00:00:00,UFU RIVADAVIA,244,148,313,38,45,396,396,0,396,0,4,12,104,80,56,71,35,34,0,79,185,132,396
20220620,20JUN2022:00:00:00,UFU SANTOJANNI,136,99,131,60,44,235,235,0,235,0,0,19,30,51,49,47,17,22,0,41,101,93,235
20220620,20JUN2022:00:00:00,UFU ZUBIZARRETA,112,83,151,29,16,196,196,0,196,0,1,13,24,43,35,43,21,16,0,37,70,89,196
20220621,21JUN2022:00:00:00,UFU ALVAREZ,206,135,276,39,29,344,344,0,344,0,3,16,64,84,53,59,35,30,0,56,181,107,344
20220621,21JUN2022:00:00:00,UFU ARGERICH,76,51,82,39,8,129,129,0,129,0,2,2,17,25,36,16,27,4,0,17,64,48,129
20220621,21JUN2022:00:00:00,UFU DURAND,226,127,313,22,18,353,353,0,353,0,0,14,64,113,63,44,41,14,0,92,164,97,353
20220621,21JUN2022:00:00:00,UFU GUTIERREZ,48,33,58,23,0,81,81,0,81,0,51,22,3,2,2,1,0,0,0,3,54,24,81
20220621,21JUN2022:00:00:00,UFU MUÑIZ,109,86,101,60,37,198,198,0,198,0,3,19,40,37,24,46,18,11,0,24,88,86,198
20220621,21JUN2022:00:00:00,UFU PENNA,42,22,48,16,0,64,64,0,64,0,0,1,16,17,19,8,3,0,0,12,34,18,64
20220621,21JUN2022:00:00:00,UFU PIROVANO,268,210,366,48,69,483,483,0,483,0,5,21,124,131,65,48,52,37,0,79,196,208,483
20220621,21JUN2022:00:00:00,UFU PIÑERO,77,48,94,25,6,125,125,0,125,0,0,0,18,32,30,26,15,4,0,24,61,40,125
20220621,21JUN2022:00:00:00,UFU RAMOS MEJIA,107,83,148,23,21,192,192,0,192,0,2,0,39,44,35,24,37,11,0,33,102,57,192
20220621,21JUN2022:00:00:00,UFU RIVADAVIA,399,218,454,100,63,617,617,0,617,0,0,21,151,143,126,77,70,29,0,94,288,235,617
20220622,22JUN2022:00:00:00,UFU ALVAREZ,158,144,238,38,30,306,306,0,306,0,4,18,81,77,54,25,30,17,0,41,170,95,306
20220622,22JUN2022:00:00:00,UFU ARGERICH,56,24,54,22,7,83,83,0,83,0,3,5,21,10,6,26,9,3,0,8,38,37,83
20220622,22JUN2022:00:00:00,UFU DURAND,194,132,281,29,18,328,328,0,328,0,2,17,61,85,76,41,30,16,0,63,165,100,328
20220622,22JUN2022:00:00:00,UFU GUTIERREZ,42,27,43,26,0,69,69,0,69,0,41,18,4,0,4,0,2,0,0,0,43,26,69
20220622,22JUN2022:00:00:00,UFU MUÑIZ,94,75,80,65,26,171,171,0,171,0,2,6,53,40,31,26,7,6,0,23,67,81,171
20220622,22JUN2022:00:00:00,UFU PENNA,41,28,39,18,14,71,71,0,71,0,2,7,22,20,6,5,7,2,0,10,40,21,71
20220622,22JUN2022:00:00:00,UFU PIROVANO,236,179,321,49,46,416,416,0,416,0,1,18,91,110,97,45,36,18,0,82,151,183,416
20220622,22JUN2022:00:00:00,UFU PIÑERO,70,64,116,8,10,134,134,0,134,0,0,7,29,36,23,26,7,6,0,32,57,45,134
20220622,22JUN2022:00:00:00,UFU RAMOS MEJIA,120,99,180,20,20,220,220,0,220,0,1,2,53,61,45,28,19,11,0,27,127,66,220
20220622,22JUN2022:00:00:00,UFU RIVADAVIA,292,186,342,83,53,478,478,0,478,0,1,13,132,130,63,76,34,29,0,86,250,142,478
20220623,23JUN2022:00:00:00,UFU ALVAREZ,178,104,214,40,30,284,284,0,284,0,2,6,64,81,51,31,34,15,0,41,145,98,284
20220623,23JUN2022:00:00:00,UFU ARGERICH,59,32,59,28,4,91,91,0,91,0,1,4,17,26,18,17,5,3,0,13,50,28,91
20220623,23JUN2022:00:00:00,UFU DURAND,192,132,285,29,11,325,325,0,325,0,1,10,69,92,63,45,22,23,0,71,156,98,325
20220623,23JUN2022:00:00:00,UFU GUTIERREZ,62,33,42,47,7,96,96,0,96,0,62,32,0,0,0,2,0,0,0,4,57,35,96
20220623,23JUN2022:00:00:00,UFU MUÑIZ,91,100,122,54,16,192,192,0,192,0,3,12,41,57,22,39,12,6,0,27,81,84,192
20220623,23JUN2022:00:00:00,UFU PENNA,36,17,38,15,0,53,53,0,53,0,2,5,13,13,4,7,3,6,0,10,24,19,53
20220623,23JUN2022:00:00:00,UFU PIROVANO,236,167,310,33,62,405,405,0,405,0,2,22,110,110,78,34,26,23,0,82,154,169,405
20220207,07FEB2022:00:00:00,UFU TORNU,115,90,174,19,12,205,205,0,205,0,14,22,42,41,32,16,22,16,0,25,105,73,205
20220207,07FEB2022:00:00:00,UFU VELEZ SARSFIELD,150,158,226,62,21,309,309,0,309,0,1,15,76,71,58,48,21,19,0,47,158,104,309
20220207,07FEB2022:00:00:00,UFU ZUBIZARRETA,146,120,168,89,9,266,266,0,266,0,0,18,47,63,55,41,24,18,0,49,94,122,266
20220208,08FEB2022:00:00:00,UFU ALVAREZ,156,115,215,36,43,294,294,0,294,0,31,6,62,69,50,36,19,21,0,39,122,133,294
20220208,08FEB2022:00:00:00,UFU ARGERICH,57,38,55,40,6,101,101,0,101,0,10,2,31,20,12,7,11,8,0,20,31,49,101
20220208,08FEB2022:00:00:00,UFU BORDA-MOYANO,45,91,72,59,10,141,141,0,141,0,7,13,29,29,21,27,12,3,0,12,62,67,141
20220208,08FEB2022:00:00:00,UFU DURAND,200,165,311,35,42,388,388,0,388,0,23,23,89,77,63,42,45,26,0,79,136,173,388
20220208,08FEB2022:00:00:00,UFU ELIZALDE,95,97,53,139,14,206,206,0,206,0,124,49,5,13,13,1,1,0,0,9,87,110,206
20220208,08FEB2022:00:00:00,UFU FERNANDEZ,108,82,138,38,30,206,206,0,206,0,16,3,49,47,28,37,17,9,0,23,92,91,206
20220208,08FEB2022:00:00:00,UFU FERRER,134,85,112,105,29,246,246,0,246,0,27,5,57,63,45,20,20,9,0,32,122,92,246
20220208,08FEB2022:00:00:00,UFU GRIERSON,100,94,124,64,17,205,205,0,205,0,11,9,67,50,34,12,17,5,0,16,129,60,205
20220208,08FEB2022:00:00:00,UFU GUTIERREZ,149,99,129,98,37,264,264,0,264,0,155,79,8,8,8,5,1,0,0,9,166,89,264
20220208,08FEB2022:00:00:00,UFU MUÑIZ,147,175,158,136,44,338,338,0,338,0,17,18,79,76,72,35,29,12,0,18,209,110,338
20220208,08FEB2022:00:00:00,UFU PENNA,95,105,71,125,26,222,222,0,222,0,35,23,43,41,35,23,15,7,0,14,134,74,222
20220208,08FEB2022:00:00:00,UFU PIROVANO,175,123,210,49,71,330,330,0,330,0,32,7,70,94,47,39,22,19,0,50,124,156,330
20220208,08FEB2022:00:00:00,UFU PIÑERO,126,93,175,41,18,234,234,0,234,0,15,18,46,59,31,32,23,10,0,18,137,76,234
20220208,08FEB2022:00:00:00,UFU RAMOS MEJIA,142,129,201,60,29,290,290,0,290,0,23,15,67,73,47,29,14,22,0,35,116,139,290
20220208,08FEB2022:00:00:00,UFU RIVADAVIA,211,147,264,78,41,383,383,0,383,0,25,5,82,109,66,41,37,18,0,46,162,174,383
20220208,08FEB2022:00:00:00,UFU SANTOJANNI,188,147,167,152,45,364,364,0,364,0,29,49,82,53,54,47,23,27,0,71,135,158,364
20220208,08FEB2022:00:00:00,UFU TORNU,100,124,186,27,24,237,237,0,237,0,16,22,33,50,62,22,18,14,0,24,116,95,237
20220208,08FEB2022:00:00:00,UFU VELEZ SARSFIELD,185,167,283,58,29,370,370,0,370,0,18,26,74,68,69,45,42,28,0,46,198,126,370
20220208,08FEB2022:00:00:00,UFU ZUBIZARRETA,132,112,187,53,8,248,248,0,248,0,4,18,47,70,44,26,21,18,0,32,95,121,248
20220209,09FEB2022:00:00:00,UFU ALVAREZ,246,199,315,101,39,455,455,0,455,0,43,41,117,85,88,26,26,29,0,33,263,159,455
20220209,09FEB2022:00:00:00,UFU ARGERICH,53,59,56,51,7,114,114,0,114,0,6,6,27,15,36,10,12,2,0,11,46,57,114
20220209,09FEB2022:00:00:00,UFU BORDA-MOYANO,69,125,134,51,14,199,199,0,199,0,5,9,20,54,27,51,19,14,0,23,82,94,199
20220209,09FEB2022:00:00:00,UFU DURAND,240,179,363,38,43,444,444,0,444,0,25,24,97,103,81,47,34,33,0,74,157,213,444
20220209,09FEB2022:00:00:00,UFU ELIZALDE,108,87,71,113,17,201,201,0,201,0,135,36,4,15,9,2,0,0,0,8,83,110,201
20220209,09FEB2022:00:00:00,UFU FERNANDEZ,138,105,162,37,57,256,256,0,256,0,13,14,45,66,45,29,17,27,0,32,107,117,256
20220209,09FEB2022:00:00:00,UFU FERRER,106,110,106,83,31,220,220,0,220,0,4,2,81,48,31,26,23,5,0,24,125,71,220
20220209,09FEB2022:00:00:00,UFU GRIERSON,116,106,167,51,12,230,230,0,230,0,8,12,62,65,38,15,16,14,0,7,150,73,230
20220209,09FEB2022:00:00:00,UFU GUTIERREZ,119,79,118,55,28,201,201,0,201,0,104,47,11,23,12,2,2,0,0,18,109,74,201
20220209,09FEB2022:00:00:00,UFU MUÑIZ,132,136,99,144,41,284,284,0,284,0,22,15,63,54,62,45,20,3,0,10,184,90,284
20220209,09FEB2022:00:00:00,UFU PENNA,123,105,102,123,11,236,236,0,236,0,37,18,70,48,23,21,14,5,0,14,147,75,236
20220209,09FEB2022:00:00:00,UFU PIROVANO,170,150,225,52,63,340,340,0,340,0,20,21,66,90,50,46,33,14,0,62,114,164,340
20220209,09FEB2022:00:00:00,UFU PIÑERO,193,113,242,56,16,314,314,0,314,0,8,25,80,70,47,40,28,16,0,29,185,96,314
20220209,09FEB2022:00:00:00,UFU RAMOS MEJIA,155,143,231,45,26,302,302,0,302,0,4,11,55,95,66,33,26,12,0,28,139,135,302
20220209,09FEB2022:00:00:00,UFU RIVADAVIA,191,142,231,70,48,349,349,0,349,0,16,7,90,78,58,57,14,29,0,38,148,163,349
20220209,09FEB2022:00:00:00,UFU SANTOJANNI,233,160,207,143,55,405,405,0,405,0,28,41,74,101,58,42,28,33,0,68,156,181,405
20220209,09FEB2022:00:00:00,UFU TORNU,137,86,183,24,20,227,227,0,227,0,19,10,45,74,39,13,17,10,0,23,110,94,227
20220209,09FEB2022:00:00:00,UFU VELEZ SARSFIELD,107,80,128,40,26,194,194,0,194,0,7,13,35,31,34,22,28,24,0,23,72,99,194
20220209,09FEB2022:00:00:00,UFU ZUBIZARRETA,162,131,185,95,19,299,299,0,299,0,6,19,67,61,43,43,33,27,0,46,111,142,299
20220210,10FEB2022:00:00:00,UFU ALVAREZ,222,161,290,69,45,404,404,0,404,0,49,32,82,83,69,28,39,22,0,25,245,134,404
20220210,10FEB2022:00:00:00,UFU ARGERICH,35,34,35,33,8,76,76,0,76,0,9,8,21,12,12,4,7,3,0,9,32,35,76
20220210,10FEB2022:00:00:00,UFU BORDA-MOYANO,48,68,71,43,11,125,125,0,125,0,9,8,19,13,25,26,18,7,0,19,49,57,125
20220210,10FEB2022:00:00:00,UFU DURAND,148,160,250,52,46,348,348,0,348,0,40,14,78,79,65,30,34,8,0,44,147,157,348
20220210,10FEB2022:00:00:00,UFU ELIZALDE,80,87,43,122,22,187,187,0,187,0,127,43,2,10,4,1,0,0,0,11,78,98,187
20220210,10FEB2022:00:00:00,UFU FERNANDEZ,123,83,152,31,50,233,233,0,233,0,27,3,53,50,27,21,31,21,0,21,103,109,233
20220210,10FEB2022:00:00:00,UFU FERRER,99,135,104,110,48,262,262,0,262,0,28,6,79,57,54,19,13,6,0,26,140,96,262
20220210,10FEB2022:00:00:00,UFU GRIERSON,102,83,99,73,31,203,203,0,203,0,18,19,64,40,36,21,3,2,0,11,122,70,203
20220210,10FEB2022:00:00:00,UFU GUTIERREZ,103,72,105,54,28,187,187,0,187,0,99,54,0,16,15,3,0,0,0,8,112,67,187
20220210,10FEB2022:00:00:00,UFU MUÑIZ,104,134,132,83,44,259,259,0,259,0,21,12,55,51,71,31,13,5,0,12,145,102,259
20220210,10FEB2022:00:00:00,UFU PENNA,113,99,105,97,24,226,226,0,226,0,40,20,66,27,24,23,24,2,0,12,137,77,226
20220210,10FEB2022:00:00:00,UFU PIROVANO,147,140,224,48,46,318,318,0,318,0,31,6,77,95,54,32,8,15,0,57,109,152,318
20220210,10FEB2022:00:00:00,UFU PIÑERO,126,130,201,52,19,272,272,0,272,0,16,14,67,81,43,22,22,7,0,16,168,87,272
20220210,10FEB2022:00:00:00,UFU RAMOS MEJIA,118,135,197,38,39,274,274,0,274,0,21,4,70,65,62,25,16,11,0,35,111,128,274
20220210,10FEB2022:00:00:00,UFU RIVADAVIA,150,109,182,56,55,293,293,0,293,0,34,10,60,56,48,37,34,14,0,49,109,134,293
20220210,10FEB2022:00:00:00,UFU SANTOJANNI,156,162,202,103,42,347,347,0,347,0,29,17,68,81,56,50,26,20,0,64,130,153,347
20220210,10FEB2022:00:00:00,UFU TORNU,125,73,164,31,13,208,208,0,208,0,12,20,47,39,37,22,13,18,0,20,116,72,208
20220210,10FEB2022:00:00:00,UFU VELEZ SARSFIELD,117,127,166,64,42,272,272,0,272,0,28,22,60,49,52,25,19,17,0,35,136,101,272
20220210,10FEB2022:00:00:00,UFU ZUBIZARRETA,125,102,120,96,49,265,265,0,265,0,38,21,55,71,39,13,10,18,0,44,90,131,265
20220211,11FEB2022:00:00:00,UFU ALVAREZ,140,105,175,52,18,245,245,0,245,0,13,23,67,45,44,23,21,9,0,33,106,106,245
20220211,11FEB2022:00:00:00,UFU ARGERICH,35,47,53,25,4,82,82,0,82,0,9,5,16,22,12,3,9,6,0,12,35,34,82
20220211,11FEB2022:00:00:00,UFU BORDA-MOYANO,72,52,66,52,6,124,124,0,124,0,6,5,30,18,28,21,9,7,0,11,58,55,124
20220211,11FEB2022:00:00:00,UFU DURAND,138,127,211,30,24,265,265,0,265,0,0,14,58,83,37,38,25,10,0,37,108,120,265
20220405,05APR2022:00:00:00,UFU GUTIERREZ,171,147,210,96,12,318,318,0,318,0,199,84,2,18,8,5,2,0,0,1,209,108,318
20220405,05APR2022:00:00:00,UFU MUÑIZ,68,64,59,62,12,133,133,0,133,0,6,13,24,28,31,27,4,0,0,3,53,77,133
20220405,05APR2022:00:00:00,UFU PENNA,36,19,38,14,3,55,55,0,55,0,0,6,12,19,5,7,3,3,0,0,39,16,55
20220405,05APR2022:00:00:00,UFU PIROVANO,117,82,157,20,23,200,200,0,200,0,1,27,36,37,52,19,12,16,0,13,90,97,200
20220405,05APR2022:00:00:00,UFU PIÑERO,101,62,140,20,3,163,163,0,163,0,0,22,38,29,33,23,14,4,0,6,116,41,163
20220405,05APR2022:00:00:00,UFU RAMOS MEJIA,102,77,133,26,20,179,179,0,179,0,2,3,34,45,37,29,20,9,0,6,111,62,179
20220405,05APR2022:00:00:00,UFU RIVADAVIA,118,74,140,35,18,193,193,0,193,0,1,2,46,45,36,18,25,20,0,8,93,92,193
20220405,05APR2022:00:00:00,UFU SANTOJANNI,71,68,80,55,5,140,140,0,140,0,1,17,27,26,24,16,15,14,0,4,69,67,140
20220405,05APR2022:00:00:00,UFU TORNU,116,91,162,33,12,207,207,0,207,0,25,17,40,53,39,24,5,4,0,6,121,80,207
20220405,05APR2022:00:00:00,UFU VELEZ SARSFIELD,128,117,200,42,3,245,245,0,245,0,0,22,37,62,31,43,25,25,0,12,153,80,245
20220405,05APR2022:00:00:00,UFU ZUBIZARRETA,71,57,96,24,9,129,129,0,129,0,1,24,10,25,22,27,8,12,0,1,64,64,129
20220406,06APR2022:00:00:00,UFU ALVAREZ,112,101,150,35,29,214,214,0,214,0,29,24,30,41,35,25,24,6,0,3,107,104,214
20220406,06APR2022:00:00:00,UFU ARGERICH,32,30,38,16,8,62,62,0,62,0,1,2,20,14,5,8,12,0,0,1,31,30,62
20220406,06APR2022:00:00:00,UFU DURAND,88,81,143,16,10,169,169,0,169,0,0,14,32,40,27,19,26,11,0,9,78,82,169
20220406,06APR2022:00:00:00,UFU FERNANDEZ,56,46,79,14,9,102,102,0,102,0,0,3,21,30,12,12,16,8,0,7,50,45,102
20220406,06APR2022:00:00:00,UFU GUTIERREZ,155,184,163,162,15,340,340,0,340,0,224,99,0,6,5,4,2,0,0,1,214,124,340
20220406,06APR2022:00:00:00,UFU MUÑIZ,84,78,81,66,15,162,162,0,162,0,0,14,32,42,32,34,7,1,0,2,100,60,162
20220406,06APR2022:00:00:00,UFU PENNA,17,15,20,10,2,32,32,0,32,0,0,3,4,8,1,6,5,5,0,0,22,10,32
20220406,06APR2022:00:00:00,UFU PIROVANO,127,68,158,16,21,195,195,0,195,0,0,25,46,59,23,18,22,2,0,12,91,92,195
20220406,06APR2022:00:00:00,UFU PIÑERO,99,102,183,13,5,201,201,0,201,0,0,23,40,29,42,37,21,9,0,8,141,52,201
20220406,06APR2022:00:00:00,UFU RAMOS MEJIA,68,53,91,22,8,121,121,0,121,0,0,1,37,34,21,15,8,5,0,2,72,47,121
20220406,06APR2022:00:00:00,UFU RIVADAVIA,125,47,138,27,8,173,173,0,173,0,1,10,47,26,27,27,24,11,0,10,86,76,173
20220406,06APR2022:00:00:00,UFU SANTOJANNI,80,63,103,32,9,144,144,0,144,0,1,16,27,32,25,14,17,12,0,7,71,66,144
20220406,06APR2022:00:00:00,UFU TORNU,91,60,136,12,4,152,152,0,152,0,4,26,25,18,40,16,13,10,0,7,80,65,152
20220406,06APR2022:00:00:00,UFU VELEZ SARSFIELD,105,75,157,18,6,181,181,0,181,0,1,18,19,43,30,30,14,26,0,5,117,59,181
20220406,06APR2022:00:00:00,UFU ZUBIZARRETA,70,43,86,20,8,114,114,0,114,0,1,21,16,13,27,20,7,9,0,10,49,54,114
20220407,07APR2022:00:00:00,UFU ALVAREZ,111,107,171,26,21,218,218,0,218,0,27,24,23,56,29,25,16,18,0,2,120,96,218
20220407,07APR2022:00:00:00,UFU ARGERICH,30,29,40,11,8,59,59,0,59,0,0,2,17,17,11,4,6,2,0,2,27,29,59
20220407,07APR2022:00:00:00,UFU DURAND,70,82,140,8,4,152,152,0,152,0,0,14,22,42,34,20,8,12,0,11,67,74,152
20220407,07APR2022:00:00:00,UFU FERNANDEZ,59,42,76,18,8,102,102,0,102,0,1,6,18,18,19,17,11,12,0,6,52,44,102
20220407,07APR2022:00:00:00,UFU GUTIERREZ,105,119,128,88,8,224,224,0,224,0,156,58,4,4,2,0,0,0,0,1,116,107,224
20220407,07APR2022:00:00:00,UFU MUÑIZ,69,75,61,64,23,148,148,0,148,0,5,9,30,19,29,37,12,7,0,2,87,59,148
20220407,07APR2022:00:00:00,UFU PENNA,28,24,28,24,0,52,52,0,52,0,2,4,15,9,8,12,2,0,0,1,28,23,52
20220407,07APR2022:00:00:00,UFU PIROVANO,121,88,180,14,16,210,210,0,210,0,1,13,31,65,31,25,18,26,0,15,95,100,210
20220407,07APR2022:00:00:00,UFU PIÑERO,81,61,106,32,5,143,143,0,143,0,1,15,25,39,21,19,16,7,0,5,100,38,143
20220407,07APR2022:00:00:00,UFU RAMOS MEJIA,76,54,86,33,14,133,133,0,133,0,3,1,31,41,25,19,3,10,0,4,76,53,133
20220407,07APR2022:00:00:00,UFU RIVADAVIA,158,68,169,44,14,227,227,0,227,0,1,14,53,58,41,22,17,21,0,10,112,105,227
20220407,07APR2022:00:00:00,UFU SANTOJANNI,52,63,74,37,4,115,115,0,115,0,0,20,22,14,29,15,11,4,0,9,50,56,115
20220407,07APR2022:00:00:00,UFU TORNU,91,84,147,20,8,175,175,0,175,0,10,17,32,14,45,27,20,10,0,4,101,70,175
20220407,07APR2022:00:00:00,UFU VELEZ SARSFIELD,98,69,142,17,8,167,167,0,167,0,0,19,28,39,25,31,15,10,0,10,100,57,167
20220407,07APR2022:00:00:00,UFU ZUBIZARRETA,65,56,78,36,9,123,123,0,123,0,2,10,23,37,15,11,15,10,0,5,61,57,123
20220408,08APR2022:00:00:00,UFU ALVAREZ,87,69,126,19,12,157,157,0,157,0,9,20,22,27,26,21,20,12,0,8,73,76,157
20220408,08APR2022:00:00:00,UFU ARGERICH,27,22,25,18,6,49,49,0,49,0,4,0,13,6,14,7,4,1,0,0,21,28,49
20220408,08APR2022:00:00:00,UFU DURAND,81,64,125,12,8,145,145,0,145,0,0,12,18,28,42,21,18,6,0,10,63,72,145
20220408,08APR2022:00:00:00,UFU FERNANDEZ,44,33,49,21,7,77,77,0,77,0,0,4,24,15,4,12,11,7,0,3,42,32,77
20220408,08APR2022:00:00:00,UFU GUTIERREZ,77,75,91,53,8,152,152,0,152,0,100,37,4,5,4,2,0,0,0,0,76,76,152
20220408,08APR2022:00:00:00,UFU MUÑIZ,35,51,46,34,6,86,86,0,86,0,0,7,9,26,18,11,9,6,0,3,26,57,86
20220408,08APR2022:00:00:00,UFU PENNA,13,13,18,6,2,26,26,0,26,0,0,2,7,8,4,3,2,0,0,0,16,10,26
20220408,08APR2022:00:00:00,UFU PIROVANO,76,77,114,22,17,153,153,0,153,0,0,3,29,42,31,16,13,19,0,14,66,73,153
20220408,08APR2022:00:00:00,UFU PIÑERO,51,40,75,16,0,91,91,0,91,0,0,5,18,14,19,17,9,9,0,2,64,25,91
20220408,08APR2022:00:00:00,UFU RAMOS MEJIA,52,45,66,20,14,100,100,0,100,0,3,4,24,14,20,17,13,5,0,1,57,42,100
20220408,08APR2022:00:00:00,UFU RIVADAVIA,97,67,126,21,18,165,165,0,165,0,1,11,69,34,22,21,4,3,0,3,83,79,165
20220408,08APR2022:00:00:00,UFU SANTOJANNI,75,63,100,38,0,138,138,0,138,0,0,14,27,21,18,26,20,12,0,10,67,61,138
20220408,08APR2022:00:00:00,UFU TORNU,90,65,138,11,6,155,155,0,155,0,17,27,13,34,24,17,11,12,0,3,87,64,155
20220408,08APR2022:00:00:00,UFU VELEZ SARSFIELD,87,61,116,30,3,149,149,0,149,0,1,12,28,23,30,18,18,19,0,4,90,55,149
20220408,08APR2022:00:00:00,UFU ZUBIZARRETA,36,29,47,16,2,65,65,0,65,0,0,2,15,7,18,12,7,4,0,2,22,41,65
20220409,09APR2022:00:00:00,UFU ALVAREZ,69,19,79,6,3,88,88,0,88,0,0,4,17,17,18,14,11,7,0,6,44,38,88
20220409,09APR2022:00:00:00,UFU DURAND,30,26,50,2,4,56,56,0,56,0,0,4,10,10,16,6,2,8,0,4,25,27,56
20220409,09APR2022:00:00:00,UFU GUTIERREZ,64,48,71,37,4,112,112,0,112,0,68,36,2,4,2,0,0,0,0,5,52,55,112
20220409,09APR2022:00:00:00,UFU MUÑIZ,71,112,106,56,21,183,183,0,183,0,2,13,43,44,35,32,9,5,0,7,122,54,183
20220409,09APR2022:00:00:00,UFU PIROVANO,68,37,82,10,13,105,105,0,105,0,0,6,14,38,17,20,4,6,0,9,45,51,105
20220409,09APR2022:00:00:00,UFU PIÑERO,8,12,17,3,0,20,20,0,20,0,0,1,5,0,6,5,0,3,0,2,10,8,20
20220409,09APR2022:00:00:00,UFU RAMOS MEJIA,64,48,86,16,10,112,112,0,112,0,6,12,22,20,25,10,9,8,0,6,58,48,112
20220409,09APR2022:00:00:00,UFU RIVADAVIA,78,58,88,15,33,136,136,0,136,0,0,4,44,34,18,10,16,10,0,5,66,65,136
20220409,09APR2022:00:00:00,UFU SANTOJANNI,39,32,55,13,3,71,71,0,71,0,0,11,13,18,20,5,4,0,0,5,34,32,71
20220409,09APR2022:00:00:00,UFU TORNU,51,46,86,5,8,99,99,0,99,0,8,14,11,26,11,9,9,11,0,13,45,41,99
20220409,09APR2022:00:00:00,UFU VELEZ SARSFIELD,55,43,84,12,2,98,98,0,98,0,0,14,15,16,24,14,7,8,0,11,42,45,98
20220623,23JUN2022:00:00:00,UFU PIÑERO,59,59,99,9,10,118,118,0,118,0,0,6,28,22,21,11,24,6,0,23,57,38,118
20220623,23JUN2022:00:00:00,UFU RAMOS MEJIA,133,95,195,17,18,230,230,0,230,0,2,7,30,74,42,29,24,22,0,30,128,72,230
20220623,23JUN2022:00:00:00,UFU RIVADAVIA,331,149,352,68,62,482,482,0,482,0,2,16,144,125,63,69,42,21,0,79,226,177,482
20220624,24JUN2022:00:00:00,UFU ALVAREZ,127,95,188,17,18,223,223,0,223,0,1,14,36,53,59,30,23,7,0,29,119,75,223
20220624,24JUN2022:00:00:00,UFU ARGERICH,44,32,52,19,5,76,76,0,76,0,0,5,17,18,9,9,8,10,0,14,33,29,76
20220624,24JUN2022:00:00:00,UFU DURAND,161,125,257,12,20,289,289,0,289,0,3,23,55,91,46,38,20,13,0,46,148,95,289
20220624,24JUN2022:00:00:00,UFU GUTIERREZ,23,30,30,20,3,53,53,0,53,0,21,18,1,6,5,2,0,0,0,3,31,19,53
20220624,24JUN2022:00:00:00,UFU MUÑIZ,88,83,97,55,20,172,172,0,172,0,1,9,34,47,41,24,13,3,0,25,72,75,172
20220624,24JUN2022:00:00:00,UFU PENNA,67,31,67,29,2,98,98,0,98,0,0,0,22,20,17,15,14,10,0,9,44,45,98
20220624,24JUN2022:00:00:00,UFU PIROVANO,204,136,259,29,56,344,344,0,344,0,4,6,64,80,66,52,38,34,0,65,136,143,344
20220624,24JUN2022:00:00:00,UFU PIÑERO,60,28,69,13,6,88,88,0,88,0,0,9,11,24,18,17,9,0,0,16,46,26,88
20220624,24JUN2022:00:00:00,UFU RAMOS MEJIA,4,3,4,3,0,7,7,0,7,0,0,0,2,0,1,4,0,0,0,2,4,1,7
20220624,24JUN2022:00:00:00,UFU RIVADAVIA,301,178,363,64,56,483,483,0,483,0,4,18,123,113,75,66,50,34,0,75,220,188,483
20220625,25JUN2022:00:00:00,UFU ALVAREZ,155,85,183,25,32,240,240,0,240,0,0,9,50,53,49,35,24,20,0,45,112,83,240
20220625,25JUN2022:00:00:00,UFU DURAND,135,116,229,13,9,251,251,0,251,0,0,3,45,60,59,38,30,16,0,56,118,77,251
20220625,25JUN2022:00:00:00,UFU GUTIERREZ,3,0,3,0,0,3,3,0,3,0,2,1,0,0,0,0,0,0,0,0,0,3,3
20220625,25JUN2022:00:00:00,UFU MUÑIZ,102,95,104,90,7,201,201,0,201,0,8,9,38,53,37,20,28,8,0,38,67,96,201
20220625,25JUN2022:00:00:00,UFU PIROVANO,163,128,233,23,35,291,291,0,291,0,0,9,41,79,47,51,33,31,0,61,113,117,291
20220625,25JUN2022:00:00:00,UFU PIÑERO,31,22,45,7,1,53,53,0,53,0,0,5,14,8,9,7,6,4,0,8,30,15,53
20220625,25JUN2022:00:00:00,UFU RIVADAVIA,222,122,264,36,50,350,350,0,350,0,6,10,80,100,60,47,24,23,0,67,150,132,350
20220625,25JUN2022:00:00:00,UFU ZUBIZARRETA,75,66,117,19,8,144,144,0,144,0,3,7,16,32,27,30,21,8,0,27,69,48,144
20220626,26JUN2022:00:00:00,UFU ALVAREZ,112,77,149,25,16,190,190,0,190,0,1,11,25,44,33,35,28,13,0,29,101,60,190
20220626,26JUN2022:00:00:00,UFU ARGERICH,14,8,13,9,0,22,22,0,22,0,0,2,5,4,5,1,2,3,0,2,12,8,22
20220626,26JUN2022:00:00:00,UFU DURAND,170,96,239,14,13,266,266,0,266,0,0,11,42,73,46,41,38,15,0,54,128,84,266
20220626,26JUN2022:00:00:00,UFU MUÑIZ,44,70,71,38,7,116,116,0,116,0,3,8,17,25,25,23,13,2,0,16,51,49,116
20220626,26JUN2022:00:00:00,UFU PIROVANO,158,89,203,20,25,248,248,0,248,0,1,7,29,57,54,48,33,19,0,52,111,85,248
20220626,26JUN2022:00:00:00,UFU PIÑERO,32,30,47,13,2,62,62,0,62,0,0,2,12,20,8,9,6,5,0,12,33,17,62
20220626,26JUN2022:00:00:00,UFU RIVADAVIA,186,115,246,22,37,305,305,0,305,0,4,8,76,62,48,49,36,22,0,61,143,101,305
20220626,26JUN2022:00:00:00,UFU ZUBIZARRETA,111,61,129,37,6,172,172,0,172,0,0,4,13,44,39,47,18,7,0,35,61,76,172
20220627,27JUN2022:00:00:00,UFU ALVAREZ,186,108,224,54,19,297,297,0,297,0,3,16,74,71,34,43,35,21,0,41,161,95,297
20220627,27JUN2022:00:00:00,UFU ARGERICH,49,37,60,15,11,86,86,0,86,0,0,0,20,23,21,11,5,6,0,17,38,31,86
20220627,27JUN2022:00:00:00,UFU DURAND,198,87,234,35,16,285,285,0,285,0,0,12,57,73,55,48,30,10,0,58,144,83,285
20220627,27JUN2022:00:00:00,UFU GUTIERREZ,32,20,27,24,1,52,52,0,52,0,32,14,1,5,0,0,0,0,0,1,34,17,52
20220627,27JUN2022:00:00:00,UFU MUÑIZ,93,88,85,62,35,182,182,0,182,0,3,13,32,45,42,14,19,14,0,21,81,80,182
20220627,27JUN2022:00:00:00,UFU PENNA,48,34,55,24,4,83,83,0,83,0,16,2,10,21,6,8,6,14,0,13,44,26,83
20220627,27JUN2022:00:00:00,UFU PIROVANO,214,117,261,35,37,333,333,0,333,0,2,9,63,85,57,48,49,20,0,58,134,141,333
20220627,27JUN2022:00:00:00,UFU PIÑERO,74,53,108,15,5,128,128,0,128,0,1,6,21,36,15,26,14,9,0,20,67,41,128
20220627,27JUN2022:00:00:00,UFU RAMOS MEJIA,6,0,3,3,0,6,6,0,6,0,0,0,0,2,0,1,3,0,0,1,3,2,6
20220627,27JUN2022:00:00:00,UFU RIVADAVIA,349,184,406,82,48,536,536,0,536,0,3,19,137,112,91,87,56,31,0,93,259,184,536
20220628,28JUN2022:00:00:00,UFU ALVAREZ,147,111,195,42,23,260,260,0,260,0,2,14,55,61,38,39,31,20,0,47,139,74,260
20220628,28JUN2022:00:00:00,UFU ARGERICH,47,21,43,11,14,68,68,0,68,0,0,3,11,19,18,7,4,6,0,11,30,27,68
20220628,28JUN2022:00:00:00,UFU DURAND,198,113,270,27,15,312,312,0,312,0,1,24,58,80,41,49,42,17,0,53,163,96,312
20220628,28JUN2022:00:00:00,UFU GUTIERREZ,45,14,40,14,5,59,59,0,59,0,30,20,0,3,4,0,2,0,0,1,36,22,59
20220628,28JUN2022:00:00:00,UFU MUÑIZ,95,92,114,53,21,188,188,0,188,0,5,11,28,45,44,37,16,2,0,20,78,90,188
20220628,28JUN2022:00:00:00,UFU PENNA,32,29,41,18,4,63,63,0,63,0,2,5,9,20,6,9,6,6,0,12,30,21,63
20220628,28JUN2022:00:00:00,UFU PIROVANO,222,151,307,34,33,374,374,0,374,0,1,15,81,96,75,45,49,12,0,56,158,160,374
20220628,28JUN2022:00:00:00,UFU PIÑERO,72,43,95,11,10,116,116,0,116,0,1,8,25,26,25,10,15,6,0,15,65,36,116
20220628,28JUN2022:00:00:00,UFU RAMOS MEJIA,3,3,3,3,0,6,6,0,6,0,0,0,0,1,3,2,0,0,0,0,4,2,6
20220628,28JUN2022:00:00:00,UFU RIVADAVIA,342,163,373,67,71,511,511,0,511,0,5,25,136,136,86,60,43,20,0,84,244,183,511
20220629,29JUN2022:00:00:00,UFU ALVAREZ,169,95,199,39,27,265,265,0,265,0,1,21,40,62,38,51,28,24,0,51,134,80,265
20220220,20FEB2022:00:00:00,UFU ELIZALDE,88,80,41,124,6,171,171,0,171,0,105,30,12,13,11,0,0,0,0,2,90,79,171
20220629,29JUN2022:00:00:00,UFU ARGERICH,60,30,57,21,12,90,90,0,90,0,1,3,27,25,10,11,8,5,0,15,31,44,90
20220629,29JUN2022:00:00:00,UFU DURAND,185,145,298,24,9,331,331,0,331,0,1,11,65,88,73,40,39,14,0,81,145,105,331
20220629,29JUN2022:00:00:00,UFU GUTIERREZ,34,38,35,32,5,72,72,0,72,0,47,14,3,2,4,2,0,0,0,3,41,28,72
20220629,29JUN2022:00:00:00,UFU MUÑIZ,65,75,84,40,18,142,142,0,142,0,2,10,33,36,26,16,15,4,0,21,51,70,142
20220629,29JUN2022:00:00:00,UFU PENNA,53,20,45,21,7,73,73,0,73,0,0,8,5,20,10,18,8,4,0,17,34,22,73
20220629,29JUN2022:00:00:00,UFU PIROVANO,203,146,270,42,37,349,349,0,349,0,0,18,81,74,43,58,37,38,0,65,133,151,349
20220629,29JUN2022:00:00:00,UFU PIÑERO,64,44,91,12,7,110,110,0,110,0,2,8,14,23,16,18,25,4,0,21,56,33,110
20220629,29JUN2022:00:00:00,UFU RAMOS MEJIA,19,4,10,13,0,23,23,0,23,0,0,0,4,8,2,1,2,6,0,3,11,9,23
20220629,29JUN2022:00:00:00,UFU RIVADAVIA,383,230,448,98,73,619,619,0,619,0,6,12,167,155,111,78,53,37,0,106,293,220,619
20220630,30JUN2022:00:00:00,UFU ALVAREZ,156,87,199,20,25,244,244,0,244,0,1,16,47,42,50,30,44,14,0,41,139,64,244
20220630,30JUN2022:00:00:00,UFU ARGERICH,43,28,42,23,6,71,71,0,71,0,2,4,13,17,17,6,10,2,0,11,28,32,71
20220630,30JUN2022:00:00:00,UFU DURAND,218,125,305,24,17,346,346,0,346,0,3,21,61,78,65,45,48,25,0,61,172,113,346
20220630,30JUN2022:00:00:00,UFU GUTIERREZ,56,44,55,43,3,101,101,0,101,0,57,25,6,6,4,2,1,0,0,3,57,41,101
20220630,30JUN2022:00:00:00,UFU MUÑIZ,96,97,117,62,16,195,195,0,195,0,4,6,36,45,34,42,24,4,0,33,65,97,195
20220630,30JUN2022:00:00:00,UFU PENNA,81,50,95,29,7,131,131,0,131,0,0,7,27,14,30,25,17,11,0,23,64,44,131
20220630,30JUN2022:00:00:00,UFU PIROVANO,217,167,307,30,50,387,387,0,387,0,3,11,79,85,77,66,28,38,0,60,182,145,387
20220630,30JUN2022:00:00:00,UFU PIÑERO,4,1,5,0,0,5,5,0,5,0,0,1,0,0,2,2,0,0,0,0,3,2,5
20220211,11FEB2022:00:00:00,UFU ELIZALDE,124,76,64,131,5,200,200,0,200,0,113,59,5,11,8,4,0,0,0,16,90,94,200
20220211,11FEB2022:00:00:00,UFU FERNANDEZ,99,70,122,26,21,169,169,0,169,0,0,4,22,49,29,31,22,12,0,16,88,65,169
20220211,11FEB2022:00:00:00,UFU FERRER,85,84,78,80,11,169,169,0,169,0,0,0,54,27,39,27,14,8,0,13,107,49,169
20220211,11FEB2022:00:00:00,UFU GRIERSON,70,91,103,50,8,161,161,0,161,0,0,16,56,27,32,23,3,4,0,7,111,43,161
20220211,11FEB2022:00:00:00,UFU GUTIERREZ,90,116,89,87,30,206,206,0,206,0,133,50,5,6,2,5,5,0,0,5,140,60,206
20220211,11FEB2022:00:00:00,UFU MUÑIZ,103,136,116,99,24,239,239,0,239,0,0,18,62,36,55,34,19,15,0,17,149,73,239
20220211,11FEB2022:00:00:00,UFU PENNA,88,88,75,88,13,176,176,0,176,0,17,10,64,39,27,11,6,2,0,17,108,51,176
20220211,11FEB2022:00:00:00,UFU PIROVANO,139,101,174,36,31,241,241,0,241,0,1,3,55,53,49,29,27,24,0,46,94,101,241
20220211,11FEB2022:00:00:00,UFU PIÑERO,118,84,158,42,2,202,202,0,202,0,0,4,71,31,44,32,11,9,0,13,136,52,202
20220211,11FEB2022:00:00:00,UFU RAMOS MEJIA,120,126,173,46,28,247,247,0,247,0,3,5,60,58,51,40,14,16,0,26,105,115,247
20220211,11FEB2022:00:00:00,UFU RIVADAVIA,159,94,195,36,24,255,255,0,255,0,2,6,67,66,40,38,26,10,0,33,120,102,255
20220211,11FEB2022:00:00:00,UFU SANTOJANNI,148,157,149,113,43,305,305,0,305,0,2,20,60,68,70,40,32,13,0,64,131,110,305
20220211,11FEB2022:00:00:00,UFU TORNU,110,104,180,14,20,214,214,0,214,0,10,24,28,53,47,23,13,16,0,26,114,74,214
20220211,11FEB2022:00:00:00,UFU VELEZ SARSFIELD,103,106,148,40,21,209,209,0,209,0,0,10,49,40,36,36,23,15,0,22,123,64,209
20220211,11FEB2022:00:00:00,UFU ZUBIZARRETA,74,57,79,46,6,131,131,0,131,0,1,4,26,29,27,22,14,8,0,31,0,100,131
20220212,12FEB2022:00:00:00,UFU ALVAREZ,111,102,176,29,8,213,213,0,213,0,10,12,53,48,41,23,20,6,0,21,96,96,213
20220212,12FEB2022:00:00:00,UFU ARGERICH,36,41,47,24,6,77,77,0,77,0,2,6,23,19,10,6,6,5,0,13,26,38,77
20220212,12FEB2022:00:00:00,UFU BORDA-MOYANO,39,57,41,50,5,96,96,0,96,0,0,3,22,18,24,18,5,6,0,10,61,25,96
20220212,12FEB2022:00:00:00,UFU DURAND,111,123,189,34,11,234,234,0,234,0,0,14,55,66,38,32,18,11,0,32,108,94,234
20220212,12FEB2022:00:00:00,UFU ELIZALDE,52,62,36,73,5,114,114,0,114,0,54,45,2,7,3,0,3,0,0,6,58,50,114
20220212,12FEB2022:00:00:00,UFU FERNANDEZ,67,67,113,12,9,134,134,0,134,0,0,7,34,36,19,12,19,7,0,20,48,66,134
20220212,12FEB2022:00:00:00,UFU FERRER,86,63,70,76,3,149,149,0,149,0,0,3,51,29,30,26,5,5,0,14,96,39,149
20220212,12FEB2022:00:00:00,UFU GRIERSON,93,50,88,49,6,143,143,0,143,0,0,7,38,38,21,21,15,3,0,6,89,48,143
20220212,12FEB2022:00:00:00,UFU GUTIERREZ,66,103,102,53,16,171,171,0,171,0,87,55,5,16,6,2,0,0,0,15,102,54,171
20220212,12FEB2022:00:00:00,UFU MUÑIZ,100,88,92,71,26,189,189,0,189,0,1,19,44,50,28,31,8,8,0,13,120,56,189
20220212,12FEB2022:00:00:00,UFU PENNA,83,60,67,71,5,143,143,0,143,0,22,26,31,26,16,13,9,0,0,8,95,40,143
20220212,12FEB2022:00:00:00,UFU PIROVANO,98,65,110,35,18,163,163,0,163,0,0,2,27,49,36,29,10,10,0,32,65,66,163
20220212,12FEB2022:00:00:00,UFU PIÑERO,100,67,130,26,11,167,167,0,167,0,0,14,40,58,21,18,8,8,0,18,102,47,167
20220212,12FEB2022:00:00:00,UFU RAMOS MEJIA,90,67,115,28,16,159,159,0,159,0,7,16,32,43,22,22,8,9,0,21,67,71,159
20220212,12FEB2022:00:00:00,UFU RIVADAVIA,130,104,179,37,22,238,238,0,238,0,4,2,77,51,36,31,26,11,0,20,117,100,238
20220212,12FEB2022:00:00:00,UFU SANTOJANNI,130,112,130,105,7,242,242,0,242,0,0,23,50,53,49,35,18,14,0,43,91,108,242
20220212,12FEB2022:00:00:00,UFU TORNU,72,38,97,12,2,111,111,0,111,0,5,18,18,16,31,10,9,4,0,12,58,41,111
20220212,12FEB2022:00:00:00,UFU VELEZ SARSFIELD,87,85,131,25,16,172,172,0,172,0,0,19,28,26,31,31,26,11,0,17,95,60,172
20220212,12FEB2022:00:00:00,UFU ZUBIZARRETA,129,109,156,76,6,238,238,0,238,0,0,2,46,73,56,26,20,15,0,48,71,119,238
20220213,13FEB2022:00:00:00,UFU ALVAREZ,120,70,154,25,11,190,190,0,190,0,11,14,48,31,47,23,10,6,0,21,107,62,190
20220213,13FEB2022:00:00:00,UFU ARGERICH,29,44,50,21,2,73,73,0,73,0,0,3,28,18,3,9,8,4,0,4,35,34,73
20220213,13FEB2022:00:00:00,UFU BORDA-MOYANO,25,41,34,21,11,66,66,0,66,0,0,10,13,18,3,14,5,3,0,4,44,18,66
20220213,13FEB2022:00:00:00,UFU DURAND,134,96,202,17,11,230,230,0,230,0,0,21,41,78,44,20,16,10,0,42,89,99,230
20220213,13FEB2022:00:00:00,UFU ELIZALDE,90,88,56,117,5,178,178,0,178,0,101,40,9,17,8,2,1,0,0,15,84,79,178
20220213,13FEB2022:00:00:00,UFU FERNANDEZ,64,57,94,21,7,122,122,0,122,0,1,2,26,23,31,17,17,5,0,22,52,48,122
20220213,13FEB2022:00:00:00,UFU FERRER,92,97,122,59,8,189,189,0,189,0,0,7,52,43,33,23,13,18,0,22,116,51,189
20220213,13FEB2022:00:00:00,UFU GRIERSON,68,68,100,34,2,136,136,0,136,0,0,10,32,29,33,19,11,2,0,6,96,34,136
20220213,13FEB2022:00:00:00,UFU GUTIERREZ,111,98,142,61,6,209,209,0,209,0,118,50,7,8,23,0,0,3,0,10,131,68,209
20220213,13FEB2022:00:00:00,UFU MUÑIZ,80,71,91,43,19,153,153,0,153,0,2,9,29,23,37,32,10,11,0,4,102,47,153
20220213,13FEB2022:00:00:00,UFU PENNA,73,66,73,61,7,141,141,0,141,0,10,19,26,31,32,14,6,3,0,9,95,37,141
20220213,13FEB2022:00:00:00,UFU PIROVANO,94,76,103,53,14,170,170,0,170,0,10,11,23,40,48,22,14,2,0,37,51,82,170
20220213,13FEB2022:00:00:00,UFU PIÑERO,91,62,102,31,20,153,153,0,153,0,0,14,33,45,25,28,4,4,0,7,104,41,153
20220213,13FEB2022:00:00:00,UFU RAMOS MEJIA,83,78,123,12,26,161,161,0,161,0,6,13,34,32,23,36,6,11,0,21,73,67,161
20220213,13FEB2022:00:00:00,UFU RIVADAVIA,114,104,159,52,8,219,219,0,219,0,1,3,53,53,33,36,23,17,0,29,101,87,219
20220213,13FEB2022:00:00:00,UFU SANTOJANNI,125,101,120,95,11,226,226,0,226,0,0,9,62,57,37,39,13,9,0,31,92,103,226
20220213,13FEB2022:00:00:00,UFU TORNU,73,57,102,22,6,130,130,0,130,0,0,15,14,27,27,23,18,6,0,16,72,42,130
20220213,13FEB2022:00:00:00,UFU VELEZ SARSFIELD,115,91,160,29,18,207,207,0,207,0,1,13,35,34,55,31,29,9,0,30,114,63,207
20220213,13FEB2022:00:00:00,UFU ZUBIZARRETA,102,98,151,45,5,201,201,0,201,0,1,13,35,38,46,36,24,8,0,26,78,97,201
20220214,14FEB2022:00:00:00,UFU ALVAREZ,168,158,241,66,20,327,327,0,327,0,20,18,92,72,36,44,16,29,0,26,184,117,327
20220214,14FEB2022:00:00:00,UFU ARGERICH,71,78,81,59,9,149,149,0,149,0,14,4,41,36,14,19,17,4,0,19,54,74,149
20220214,14FEB2022:00:00:00,UFU BORDA-MOYANO,71,77,76,59,14,149,149,0,149,0,2,5,40,32,25,28,10,7,0,10,68,71,149
20220214,14FEB2022:00:00:00,UFU DURAND,156,158,266,38,10,314,314,0,314,0,0,8,68,85,61,38,36,18,0,35,127,152,314
20220214,14FEB2022:00:00:00,UFU ELIZALDE,125,117,95,142,6,243,243,0,243,0,152,60,4,20,5,1,1,0,0,8,109,126,243
20220214,14FEB2022:00:00:00,UFU FERNANDEZ,104,111,141,38,36,215,215,0,215,0,0,10,37,62,63,17,16,10,0,15,105,95,215
20220214,14FEB2022:00:00:00,UFU FERRER,100,150,124,117,9,250,250,0,250,0,0,3,53,90,42,31,25,6,0,19,154,77,250
20220214,14FEB2022:00:00:00,UFU GRIERSON,129,134,167,71,25,263,263,0,263,0,0,18,70,82,41,29,14,9,0,5,178,80,263
20220214,14FEB2022:00:00:00,UFU GUTIERREZ,171,108,115,112,52,279,279,0,279,0,160,67,10,20,11,0,11,0,0,11,179,89,279
20220214,14FEB2022:00:00:00,UFU MUÑIZ,139,162,124,158,19,301,301,0,301,0,0,25,76,82,63,38,12,5,0,14,194,93,301
20220214,14FEB2022:00:00:00,UFU PENNA,158,133,138,143,12,293,293,0,293,0,28,22,92,67,45,28,5,6,0,12,199,82,293
20220214,14FEB2022:00:00:00,UFU PIROVANO,183,170,250,64,39,353,353,0,353,0,0,7,55,113,88,29,32,29,0,45,146,161,353
20220214,14FEB2022:00:00:00,UFU PIÑERO,161,153,233,62,19,314,314,0,314,0,0,36,61,82,63,28,33,11,0,15,209,88,314
20220409,09APR2022:00:00:00,UFU ZUBIZARRETA,38,11,36,12,1,49,49,0,49,0,0,5,5,12,11,5,3,8,0,3,0,46,49
20220410,10APR2022:00:00:00,UFU ALVAREZ,67,40,88,12,7,107,107,0,107,0,20,10,19,17,18,10,6,7,0,8,52,47,107
20220410,10APR2022:00:00:00,UFU ARGERICH,24,17,28,13,0,41,41,0,41,0,2,3,6,7,8,8,4,3,0,0,19,22,41
20220410,10APR2022:00:00:00,UFU DURAND,52,38,79,3,8,90,90,0,90,0,0,2,12,31,16,9,11,9,0,8,39,43,90
20220410,10APR2022:00:00:00,UFU GUTIERREZ,46,39,54,29,2,85,85,0,85,0,63,18,4,0,0,0,0,0,0,0,40,45,85
20220410,10APR2022:00:00:00,UFU MUÑIZ,39,72,54,45,13,112,112,0,112,0,1,1,19,25,37,13,14,2,0,3,61,48,112
20220410,10APR2022:00:00:00,UFU PIROVANO,81,39,98,8,14,120,120,0,120,0,0,10,18,29,30,16,8,9,0,13,50,57,120
20220410,10APR2022:00:00:00,UFU PIÑERO,37,16,41,7,6,54,54,0,54,0,1,0,6,10,10,8,10,9,0,3,30,21,54
20220410,10APR2022:00:00:00,UFU RAMOS MEJIA,62,46,80,16,12,108,108,0,108,0,7,5,13,28,18,17,8,12,0,3,56,49,108
20220410,10APR2022:00:00:00,UFU RIVADAVIA,89,45,102,19,13,134,134,0,134,0,0,9,40,18,19,25,12,11,0,8,68,58,134
20220410,10APR2022:00:00:00,UFU SANTOJANNI,37,29,45,13,8,66,66,0,66,0,0,12,6,13,6,9,6,14,0,6,26,34,66
20220410,10APR2022:00:00:00,UFU TORNU,42,37,68,3,8,79,79,0,79,0,6,5,6,23,15,4,11,9,0,6,39,34,79
20220410,10APR2022:00:00:00,UFU VELEZ SARSFIELD,57,39,92,4,0,96,96,0,96,0,0,8,16,15,23,16,9,9,0,11,38,47,96
20220410,10APR2022:00:00:00,UFU ZUBIZARRETA,35,20,30,22,3,55,55,0,55,0,0,2,10,9,15,13,4,2,0,13,0,42,55
20220411,11APR2022:00:00:00,UFU ALVAREZ,84,75,130,24,5,159,159,0,159,0,33,21,21,27,21,20,10,6,0,11,76,72,159
20220411,11APR2022:00:00:00,UFU ARGERICH,15,24,23,15,2,40,40,0,40,0,2,0,8,14,1,7,7,1,0,1,19,20,40
20220411,11APR2022:00:00:00,UFU BORDA-MOYANO,2,0,2,0,0,2,2,0,2,0,0,0,0,0,0,0,1,1,0,1,0,1,2
20220411,11APR2022:00:00:00,UFU DURAND,71,74,138,7,0,145,145,0,145,0,0,10,31,28,36,14,15,11,0,8,65,72,145
20220411,11APR2022:00:00:00,UFU FERNANDEZ,34,18,47,5,0,52,52,0,52,0,0,2,7,11,10,11,9,2,0,9,21,22,52
20220411,11APR2022:00:00:00,UFU GUTIERREZ,95,95,99,83,10,192,192,0,192,0,125,55,4,2,4,2,0,0,0,3,107,82,192
20220411,11APR2022:00:00:00,UFU MUÑIZ,73,82,85,56,15,156,156,0,156,0,2,16,14,43,27,28,14,12,0,9,70,77,156
20220411,11APR2022:00:00:00,UFU PENNA,16,7,16,7,0,23,23,0,23,0,0,3,2,14,0,4,0,0,0,2,13,8,23
20220411,11APR2022:00:00:00,UFU PIROVANO,156,85,164,46,32,242,242,0,242,0,1,7,67,56,38,35,29,9,0,21,112,109,242
20220411,11APR2022:00:00:00,UFU PIÑERO,60,26,72,8,7,87,87,0,87,0,1,5,15,17,24,17,7,1,0,2,57,28,87
20220411,11APR2022:00:00:00,UFU RAMOS MEJIA,88,54,101,28,15,144,144,0,144,0,2,8,35,30,35,15,12,7,0,6,81,57,144
20220411,11APR2022:00:00:00,UFU RIVADAVIA,147,65,164,29,19,212,212,0,212,0,0,13,48,51,43,34,20,3,0,6,105,100,212
20220411,11APR2022:00:00:00,UFU SANTOJANNI,86,66,86,57,10,153,153,0,153,0,1,22,20,29,34,16,12,19,0,9,72,72,153
20220411,11APR2022:00:00:00,UFU TORNU,55,44,67,26,6,99,99,0,99,0,8,11,14,20,19,12,13,2,0,4,42,53,99
20220411,11APR2022:00:00:00,UFU VELEZ SARSFIELD,80,49,92,20,17,129,129,0,129,0,0,12,24,39,23,9,14,8,0,13,54,62,129
20220411,11APR2022:00:00:00,UFU ZUBIZARRETA,53,38,61,18,13,92,92,0,92,0,1,10,32,11,12,10,10,6,0,8,27,57,92
20220412,12APR2022:00:00:00,UFU ALVAREZ,56,66,105,10,8,123,123,0,123,0,8,11,21,24,24,13,8,14,0,7,67,49,123
20220412,12APR2022:00:00:00,UFU ARGERICH,36,24,36,19,5,60,60,0,60,0,2,7,10,18,11,4,6,2,0,4,30,26,60
20220412,12APR2022:00:00:00,UFU DURAND,60,44,95,1,8,104,104,0,104,0,0,22,7,17,24,22,10,2,0,9,59,36,104
20220412,12APR2022:00:00:00,UFU FERNANDEZ,22,24,35,8,3,46,46,0,46,0,0,8,10,11,4,8,5,0,0,3,25,18,46
20220412,12APR2022:00:00:00,UFU GUTIERREZ,83,31,80,32,2,114,114,0,114,0,69,33,3,0,8,0,1,0,0,3,65,46,114
20220412,12APR2022:00:00:00,UFU MUÑIZ,65,37,56,41,5,102,102,0,102,0,5,10,25,21,22,6,8,5,0,1,42,59,102
20220412,12APR2022:00:00:00,UFU PENNA,14,17,20,11,0,31,31,0,31,0,2,2,4,13,8,2,0,0,0,5,13,13,31
20220412,12APR2022:00:00:00,UFU PIROVANO,132,88,173,10,37,220,220,0,220,0,0,23,47,62,35,21,20,12,0,26,96,98,220
20220412,12APR2022:00:00:00,UFU PIÑERO,33,19,39,9,5,53,53,0,53,0,1,5,15,10,12,6,4,0,0,2,27,24,53
20220412,12APR2022:00:00:00,UFU RAMOS MEJIA,38,46,70,9,5,84,84,0,84,0,0,2,26,17,12,14,9,4,0,1,48,35,84
20220412,12APR2022:00:00:00,UFU RIVADAVIA,110,66,148,19,10,177,177,0,177,0,1,8,49,37,29,26,12,15,0,4,93,80,177
20220412,12APR2022:00:00:00,UFU SANTOJANNI,93,43,103,27,6,136,136,0,136,0,2,9,22,37,27,21,9,9,0,21,54,61,136
20220412,12APR2022:00:00:00,UFU TORNU,57,27,74,7,3,84,84,0,84,0,10,6,10,17,23,7,5,6,0,2,43,39,84
20220412,12APR2022:00:00:00,UFU VELEZ SARSFIELD,94,67,131,14,16,161,161,0,161,0,0,12,27,32,34,22,19,15,0,13,68,80,161
20220412,12APR2022:00:00:00,UFU ZUBIZARRETA,30,15,40,5,0,45,45,0,45,0,0,4,5,11,10,4,5,6,0,5,22,18,45
20220413,13APR2022:00:00:00,UFU ALVAREZ,58,26,57,16,11,84,84,0,84,0,0,8,15,27,22,3,7,2,0,5,43,36,84
20220413,13APR2022:00:00:00,UFU ARGERICH,17,17,25,7,2,34,34,0,34,0,4,0,12,6,5,3,2,2,0,1,15,18,34
20220413,13APR2022:00:00:00,UFU GUTIERREZ,48,21,47,19,3,69,69,0,69,0,30,28,0,2,9,0,0,0,0,3,44,22,69
20220413,13APR2022:00:00:00,UFU MUÑIZ,69,56,48,70,7,125,125,0,125,0,0,12,33,31,24,15,8,2,0,1,82,42,125
20220413,13APR2022:00:00:00,UFU PENNA,9,13,5,16,1,22,22,0,22,0,0,1,4,6,6,3,2,0,0,2,8,12,22
20220413,13APR2022:00:00:00,UFU PIROVANO,78,44,97,8,17,122,122,0,122,0,0,6,27,25,24,22,15,3,0,14,62,46,122
20220413,13APR2022:00:00:00,UFU PIÑERO,13,17,27,3,0,30,30,0,30,0,0,1,8,11,3,4,3,0,0,2,16,12,30
20220413,13APR2022:00:00:00,UFU RAMOS MEJIA,56,23,65,9,5,79,79,0,79,0,0,5,10,15,18,7,10,14,0,2,47,30,79
20220413,13APR2022:00:00:00,UFU RIVADAVIA,72,73,120,8,17,145,145,0,145,0,0,12,40,28,26,20,8,11,0,5,77,63,145
20220413,13APR2022:00:00:00,UFU SANTOJANNI,62,68,84,34,12,130,130,0,130,0,0,11,16,29,23,18,21,12,0,23,50,57,130
20220413,13APR2022:00:00:00,UFU TORNU,28,25,45,3,5,53,53,0,53,0,0,2,14,16,6,6,5,4,0,5,28,20,53
20220413,13APR2022:00:00:00,UFU VELEZ SARSFIELD,62,47,91,12,6,109,109,0,109,0,0,12,15,18,21,9,30,4,0,16,38,55,109
20220414,14APR2022:00:00:00,UFU ALVAREZ,58,56,97,12,5,114,114,0,114,0,1,9,20,19,31,11,14,9,0,11,58,45,114
20220414,14APR2022:00:00:00,UFU DURAND,49,44,80,6,7,93,93,0,93,0,0,0,15,26,14,10,14,14,0,5,51,37,93
20220414,14APR2022:00:00:00,UFU GUTIERREZ,44,41,47,32,6,85,85,0,85,0,59,14,4,5,2,1,0,0,0,0,41,44,85
20220414,14APR2022:00:00:00,UFU MUÑIZ,34,47,45,29,7,81,81,0,81,0,0,8,18,20,22,5,4,4,0,4,36,41,81
20220414,14APR2022:00:00:00,UFU PIROVANO,96,59,135,8,12,155,155,0,155,0,0,6,23,39,33,26,20,8,0,29,65,61,155
20220414,14APR2022:00:00:00,UFU PIÑERO,22,16,30,2,6,38,38,0,38,0,0,4,6,11,7,7,3,0,0,0,22,16,38
20220414,14APR2022:00:00:00,UFU RAMOS MEJIA,62,30,75,11,8,94,94,0,94,0,4,16,13,11,25,6,10,9,0,5,50,39,94
20220414,14APR2022:00:00:00,UFU RIVADAVIA,83,34,84,18,15,117,117,0,117,0,0,3,21,39,12,12,21,9,0,10,56,51,117
20220414,14APR2022:00:00:00,UFU SANTOJANNI,38,41,57,20,2,79,79,0,79,0,0,10,13,18,19,12,2,5,0,12,31,36,79
20220414,14APR2022:00:00:00,UFU TORNU,51,27,66,8,4,78,78,0,78,0,3,2,5,34,17,6,2,9,0,8,39,31,78
20220414,14APR2022:00:00:00,UFU VELEZ SARSFIELD,40,53,73,16,4,93,93,0,93,0,0,12,18,17,22,7,13,4,0,9,39,45,93
20220414,14APR2022:00:00:00,UFU ZUBIZARRETA,38,30,40,24,5,69,69,0,69,0,1,5,9,10,14,7,16,7,0,6,34,29,69
20220630,30JUN2022:00:00:00,UFU RAMOS MEJIA,9,3,8,4,0,12,12,0,12,0,0,0,2,2,4,1,3,0,0,0,7,5,12
20220630,30JUN2022:00:00:00,UFU RIVADAVIA,338,212,391,84,82,557,557,0,557,0,7,27,152,147,82,57,56,29,0,92,276,189,557
20220701,01JUL2022:00:00:00,UFU ARGERICH,49,20,43,21,6,70,70,0,70,0,1,4,6,19,9,14,13,4,0,8,29,33,70
20220701,01JUL2022:00:00:00,UFU DURAND,202,135,292,23,22,337,337,0,337,0,0,14,61,78,62,54,38,30,0,60,169,108,337
20220701,01JUL2022:00:00:00,UFU GUTIERREZ,33,32,27,33,6,66,66,0,66,0,48,11,1,0,2,2,2,0,0,2,39,25,66
20220701,01JUL2022:00:00:00,UFU MUÑIZ,57,46,51,41,12,104,104,0,104,0,1,11,20,24,26,14,4,4,0,14,42,48,104
20220701,01JUL2022:00:00:00,UFU PENNA,45,51,65,25,6,96,96,0,96,0,0,2,22,18,22,20,9,3,0,16,48,32,96
20220701,01JUL2022:00:00:00,UFU PIROVANO,167,127,238,14,44,296,296,0,296,0,2,15,47,73,42,40,40,37,0,47,118,131,296
20220701,01JUL2022:00:00:00,UFU PIÑERO,1,3,2,1,1,4,4,0,4,0,0,1,1,0,0,1,0,1,0,0,4,0,4
20220701,01JUL2022:00:00:00,UFU RAMOS MEJIA,7,0,5,2,0,7,7,0,7,0,0,0,0,0,2,4,1,0,0,1,3,3,7
20220701,01JUL2022:00:00:00,UFU RIVADAVIA,72,28,71,16,13,100,100,0,100,0,0,2,19,20,19,20,9,11,0,24,38,38,100
20220702,02JUL2022:00:00:00,UFU DURAND,157,93,226,11,14,251,251,0,251,0,1,8,33,67,41,36,34,31,0,72,103,76,251
20220702,02JUL2022:00:00:00,UFU PIROVANO,180,132,242,32,38,312,312,0,312,0,0,7,37,62,77,47,45,37,0,54,142,116,312
20220702,02JUL2022:00:00:00,UFU PIÑERO,27,34,43,16,2,61,61,0,61,0,0,7,13,7,8,14,11,1,0,7,33,20,61
20220702,02JUL2022:00:00:00,UFU RIVADAVIA,25,21,31,11,4,46,46,0,46,0,0,1,11,5,4,8,9,8,0,9,21,16,46
20220702,02JUL2022:00:00:00,UFU ZUBIZARRETA,87,76,122,36,7,165,165,0,165,0,2,10,19,40,27,26,22,19,0,37,58,70,165
20220703,03JUL2022:00:00:00,UFU ARGERICH,7,10,14,1,2,17,17,0,17,0,1,0,3,3,1,2,3,4,0,2,8,7,17
20220703,03JUL2022:00:00:00,UFU DURAND,149,131,245,10,26,281,281,0,281,0,1,11,41,59,58,50,42,19,0,54,136,91,281
20220703,03JUL2022:00:00:00,UFU MUÑIZ,2,0,0,2,0,2,2,0,2,0,0,0,0,0,0,0,2,0,0,0,1,1,2
20220703,03JUL2022:00:00:00,UFU PIROVANO,212,134,270,43,35,348,348,0,348,0,2,7,64,88,54,68,43,22,0,80,135,132,348
20220703,03JUL2022:00:00:00,UFU PIÑERO,27,22,41,6,2,49,49,0,49,0,0,5,4,12,4,12,11,1,0,8,27,14,49
20220703,03JUL2022:00:00:00,UFU RAMOS MEJIA,2,0,2,0,0,2,2,0,2,0,0,0,0,1,1,0,0,0,0,0,1,1,2
20220703,03JUL2022:00:00:00,UFU ZUBIZARRETA,104,60,127,28,10,165,165,0,165,0,1,4,24,43,13,31,31,18,0,34,62,69,165
20220704,04JUL2022:00:00:00,UFU ARGERICH,67,36,74,25,5,104,104,0,104,0,1,2,21,41,12,14,6,7,0,14,42,48,104
20220704,04JUL2022:00:00:00,UFU DURAND,243,147,353,19,21,393,393,0,393,0,3,21,74,98,50,68,55,24,0,87,180,126,393
20220704,04JUL2022:00:00:00,UFU MUÑIZ,12,5,7,10,0,17,17,0,17,0,0,0,4,2,4,6,1,0,0,1,8,8,17
20220704,04JUL2022:00:00:00,UFU PENNA,81,39,82,34,6,122,122,0,122,0,4,5,7,29,28,17,17,15,0,25,54,42,122
20220704,04JUL2022:00:00:00,UFU PIROVANO,230,163,323,27,45,395,395,0,395,0,2,17,73,97,78,71,37,20,0,76,155,164,395
20220704,04JUL2022:00:00:00,UFU RAMOS MEJIA,5,2,4,3,0,7,7,0,7,0,0,0,0,0,0,3,2,2,0,1,4,2,7
20220705,05JUL2022:00:00:00,UFU ARGERICH,61,36,61,32,4,97,97,0,97,0,0,8,24,25,21,5,11,3,0,21,43,33,97
20220705,05JUL2022:00:00:00,UFU DURAND,239,154,331,34,30,395,395,0,395,0,2,18,82,88,73,63,44,25,0,76,192,127,395
20220705,05JUL2022:00:00:00,UFU PENNA,89,47,98,28,10,136,136,0,136,0,0,3,15,36,26,22,18,16,0,33,60,43,136
20220705,05JUL2022:00:00:00,UFU PIROVANO,212,137,265,37,49,351,351,0,351,0,2,13,86,82,64,52,32,20,0,61,165,125,351
20220705,05JUL2022:00:00:00,UFU RAMOS MEJIA,5,4,7,0,2,9,9,0,9,0,0,0,0,0,3,0,2,4,0,1,4,4,9
20220706,06JUL2022:00:00:00,UFU ARGERICH,35,46,63,14,6,83,83,0,83,0,2,4,17,19,20,11,7,3,0,16,40,27,83
20220706,06JUL2022:00:00:00,UFU DURAND,194,152,300,24,23,347,347,0,347,0,1,19,84,88,45,51,41,18,0,75,163,109,347
20220706,06JUL2022:00:00:00,UFU PENNA,68,36,63,35,6,104,104,0,104,0,2,3,10,31,25,20,9,4,0,14,48,42,104
20220706,06JUL2022:00:00:00,UFU PIROVANO,231,171,314,37,53,404,404,0,404,0,2,15,75,101,93,50,36,32,0,79,184,140,404
20220706,06JUL2022:00:00:00,UFU RAMOS MEJIA,13,0,6,7,0,13,13,0,13,0,0,2,0,4,5,2,0,0,0,0,7,6,13
20220707,07JUL2022:00:00:00,UFU ARGERICH,39,20,40,17,2,59,59,0,59,0,0,3,9,16,16,10,1,4,0,12,26,21,59
20220707,07JUL2022:00:00:00,UFU DURAND,219,172,345,23,25,393,393,0,393,0,2,12,76,97,65,55,52,34,0,87,186,120,393
20220707,07JUL2022:00:00:00,UFU PENNA,43,38,66,11,4,81,81,0,81,0,0,2,10,20,15,16,13,5,0,18,41,22,81
20220707,07JUL2022:00:00:00,UFU PIROVANO,230,156,307,53,31,391,391,0,391,0,5,16,64,92,88,46,48,32,0,73,162,156,391
20220707,07JUL2022:00:00:00,UFU RAMOS MEJIA,5,3,5,3,0,8,8,0,8,0,0,0,0,2,1,1,1,3,0,0,6,2,8
20220708,08JUL2022:00:00:00,UFU ARGERICH,47,31,49,27,3,79,79,0,79,0,1,2,13,16,13,11,17,6,0,13,33,33,79
20220708,08JUL2022:00:00:00,UFU DURAND,129,85,190,9,15,214,214,0,214,0,0,7,42,69,37,29,19,11,0,54,103,57,214
20220708,08JUL2022:00:00:00,UFU PENNA,51,38,66,19,5,90,90,0,90,0,1,5,15,15,20,16,17,1,0,17,48,25,90
20220708,08JUL2022:00:00:00,UFU PIROVANO,177,129,223,37,49,309,309,0,309,0,3,19,46,68,64,31,43,35,0,50,146,113,309
20220708,08JUL2022:00:00:00,UFU RAMOS MEJIA,5,0,5,0,0,5,5,0,5,0,0,0,0,2,1,0,0,2,0,1,2,2,5
20220709,09JUL2022:00:00:00,UFU DURAND,172,133,270,22,14,306,306,0,306,0,1,16,49,52,62,58,53,15,0,77,138,91,306
20220709,09JUL2022:00:00:00,UFU PIROVANO,171,111,226,30,28,284,284,0,284,0,2,6,33,73,66,52,42,10,0,50,113,121,284
20220709,09JUL2022:00:00:00,UFU PIÑERO,36,20,46,6,4,56,56,0,56,0,0,1,17,7,6,8,7,10,0,6,35,15,56
20220709,09JUL2022:00:00:00,UFU ZUBIZARRETA,105,70,131,36,10,177,177,0,177,0,2,10,12,25,39,25,41,23,0,32,70,75,177
20220710,10JUL2022:00:00:00,UFU DURAND,213,141,312,29,14,355,355,0,355,0,1,22,55,60,63,75,39,40,0,82,166,107,355
20220710,10JUL2022:00:00:00,UFU PIROVANO,157,112,208,18,48,274,274,0,274,0,5,8,47,51,64,47,36,16,0,61,112,101,274
20220710,10JUL2022:00:00:00,UFU PIÑERO,32,27,51,7,1,59,59,0,59,0,0,5,5,11,13,8,10,7,0,13,26,20,59
20220710,10JUL2022:00:00:00,UFU ZUBIZARRETA,107,76,126,53,6,185,185,0,185,0,2,9,20,31,44,38,31,10,0,40,71,74,185
20220711,11JUL2022:00:00:00,UFU ARGERICH,9,12,13,8,0,21,21,0,21,0,0,0,5,5,2,3,2,4,0,1,14,6,21
20220711,11JUL2022:00:00:00,UFU DURAND,67,69,117,15,4,136,136,0,136,0,0,5,19,42,21,23,16,10,0,30,71,35,136
20220711,11JUL2022:00:00:00,UFU PENNA,50,41,62,25,5,92,92,0,92,0,1,8,18,16,18,18,9,4,0,15,48,29,92
20220711,11JUL2022:00:00:00,UFU PIROVANO,126,86,165,29,18,212,212,0,212,0,0,7,30,46,39,47,22,21,0,33,95,84,212
20220711,11JUL2022:00:00:00,UFU RAMOS MEJIA,3,4,3,4,0,7,7,0,7,0,0,0,0,0,0,0,3,4,0,0,5,2,7
20220712,12JUL2022:00:00:00,UFU ARGERICH,46,25,52,19,0,71,71,0,71,0,0,0,17,22,17,8,4,3,0,13,28,30,71
20220712,12JUL2022:00:00:00,UFU PENNA,40,34,55,17,2,74,74,0,74,0,0,2,9,26,15,15,5,2,0,13,39,22,74
20220712,12JUL2022:00:00:00,UFU RAMOS MEJIA,7,5,8,4,0,12,12,0,12,0,0,0,3,5,1,1,1,1,0,3,7,2,12
20220713,13JUL2022:00:00:00,UFU ARGERICH,36,30,46,18,4,68,68,0,68,0,2,0,17,11,21,12,5,0,0,12,24,32,68
20220713,13JUL2022:00:00:00,UFU PENNA,60,60,95,21,4,120,120,0,120,0,9,4,19,23,27,20,13,5,0,19,63,38,120
20220713,13JUL2022:00:00:00,UFU RAMOS MEJIA,3,1,1,3,0,4,4,0,4,0,0,0,0,0,1,0,2,1,0,0,3,1,4
20220214,14FEB2022:00:00:00,UFU RAMOS MEJIA,185,191,258,95,23,376,376,0,376,0,3,10,86,77,64,65,43,28,0,35,168,173,376
20220214,14FEB2022:00:00:00,UFU RIVADAVIA,179,176,250,72,33,355,355,0,355,0,0,7,108,80,47,42,32,39,0,23,174,157,355
20220214,14FEB2022:00:00:00,UFU SANTOJANNI,169,172,201,121,19,341,341,0,341,0,0,12,64,81,70,45,40,29,0,55,141,145,341
20220214,14FEB2022:00:00:00,UFU TORNU,101,90,166,22,3,191,191,0,191,0,8,13,51,38,40,13,24,4,0,19,103,69,191
20220214,14FEB2022:00:00:00,UFU VELEZ SARSFIELD,142,139,199,64,18,281,281,0,281,0,0,19,47,55,57,48,31,24,0,18,173,90,281
20220214,14FEB2022:00:00:00,UFU ZUBIZARRETA,140,143,156,111,16,283,283,0,283,0,0,16,49,75,46,35,36,26,0,33,111,139,283
20220215,15FEB2022:00:00:00,UFU ALVAREZ,204,143,247,76,24,347,347,0,347,0,15,33,99,56,53,38,29,24,0,17,221,109,347
20220215,15FEB2022:00:00:00,UFU ARGERICH,45,38,40,36,7,83,83,0,83,0,3,2,25,24,10,7,7,5,0,12,39,32,83
20220215,15FEB2022:00:00:00,UFU BORDA-MOYANO,65,74,80,47,12,139,139,0,139,0,4,4,26,47,22,21,13,2,0,13,64,62,139
20220215,15FEB2022:00:00:00,UFU DURAND,184,129,234,45,35,314,314,0,314,0,1,11,66,95,51,39,35,16,0,31,159,124,314
20220215,15FEB2022:00:00:00,UFU ELIZALDE,130,118,63,184,2,249,249,0,249,0,159,60,3,16,6,3,2,0,0,9,125,115,249
20220215,15FEB2022:00:00:00,UFU FERNANDEZ,106,79,121,29,35,185,185,0,185,0,0,4,46,34,37,37,23,4,0,19,89,77,185
20220215,15FEB2022:00:00:00,UFU FERRER,116,148,121,122,21,264,264,0,264,0,0,9,79,72,53,34,15,2,0,13,178,73,264
20220215,15FEB2022:00:00:00,UFU GRIERSON,129,134,171,80,12,263,263,0,263,0,0,27,94,58,36,31,13,4,0,9,182,72,263
20220215,15FEB2022:00:00:00,UFU GUTIERREZ,138,105,126,84,33,243,243,0,243,0,117,74,12,20,12,2,3,3,0,6,161,76,243
20220215,15FEB2022:00:00:00,UFU MUÑIZ,132,147,123,135,24,282,282,0,282,0,8,13,59,87,43,40,27,5,0,8,190,84,282
20220215,15FEB2022:00:00:00,UFU PENNA,106,122,97,120,11,228,228,0,228,0,28,12,75,53,34,17,7,2,0,15,145,68,228
20220215,15FEB2022:00:00:00,UFU PIROVANO,142,129,189,39,44,272,272,0,272,0,1,14,78,86,45,27,12,9,0,37,127,108,272
20220215,15FEB2022:00:00:00,UFU PIÑERO,160,105,181,65,20,266,266,0,266,0,1,20,84,89,22,32,12,6,0,14,181,70,266
20220215,15FEB2022:00:00:00,UFU RAMOS MEJIA,180,156,230,70,36,336,336,0,336,0,4,16,85,90,68,39,19,15,0,29,157,150,336
20220215,15FEB2022:00:00:00,UFU RIVADAVIA,155,152,210,70,29,309,309,0,309,0,2,5,94,76,51,39,29,13,0,24,155,129,309
20220215,15FEB2022:00:00:00,UFU SANTOJANNI,140,151,160,109,23,292,292,0,292,0,1,31,61,73,48,40,28,10,0,30,140,122,292
20220215,15FEB2022:00:00:00,UFU TORNU,95,104,147,40,12,199,199,0,199,0,9,13,53,28,36,23,21,16,0,21,114,64,199
20220215,15FEB2022:00:00:00,UFU VELEZ SARSFIELD,152,158,244,47,19,310,310,0,310,0,0,23,75,52,74,30,33,23,0,15,195,100,310
20220215,15FEB2022:00:00:00,UFU ZUBIZARRETA,126,92,137,70,11,218,218,0,218,0,0,14,40,56,51,36,14,7,0,29,85,104,218
20220216,16FEB2022:00:00:00,UFU ALVAREZ,148,153,211,70,20,301,301,0,301,0,38,25,87,51,33,34,22,11,0,25,159,117,301
20220216,16FEB2022:00:00:00,UFU ARGERICH,46,50,59,35,2,96,96,0,96,0,6,8,33,23,9,7,2,8,0,10,39,47,96
20220216,16FEB2022:00:00:00,UFU BORDA-MOYANO,70,123,134,50,9,193,193,0,193,0,0,14,29,31,43,44,18,14,0,12,92,89,193
20220216,16FEB2022:00:00:00,UFU DURAND,197,162,297,37,26,360,360,0,360,0,2,21,88,101,47,55,23,23,0,39,158,162,360
20220216,16FEB2022:00:00:00,UFU ELIZALDE,90,146,55,180,1,236,236,0,236,0,138,80,7,2,7,2,0,0,0,9,107,120,236
20220216,16FEB2022:00:00:00,UFU FERNANDEZ,95,104,130,36,33,199,199,0,199,0,0,6,59,38,51,25,16,4,0,24,92,83,199
20220216,16FEB2022:00:00:00,UFU FERRER,143,172,126,158,31,315,315,0,315,0,0,16,83,107,62,27,20,0,0,16,203,96,315
20220216,16FEB2022:00:00:00,UFU GRIERSON,120,123,164,67,12,243,243,0,243,0,0,29,81,52,44,22,10,5,0,10,156,77,243
20220216,16FEB2022:00:00:00,UFU GUTIERREZ,128,99,98,106,24,228,228,0,228,0,109,85,1,17,12,4,0,0,0,5,144,79,228
20220216,16FEB2022:00:00:00,UFU MUÑIZ,111,170,110,153,18,281,281,0,281,0,4,48,58,63,62,25,12,9,0,7,197,75,281
20220216,16FEB2022:00:00:00,UFU PENNA,133,112,104,131,10,245,245,0,245,0,22,18,79,48,29,31,16,2,0,17,158,70,245
20220216,16FEB2022:00:00:00,UFU PIROVANO,152,157,210,44,55,309,309,0,309,0,0,8,98,73,49,39,27,15,0,31,143,135,309
20220216,16FEB2022:00:00:00,UFU PIÑERO,159,125,231,46,7,284,284,0,284,0,0,15,101,82,37,21,10,18,0,12,197,75,284
20220216,16FEB2022:00:00:00,UFU RAMOS MEJIA,172,144,233,56,27,316,316,0,316,0,0,9,69,92,59,41,22,24,0,24,146,146,316
20220216,16FEB2022:00:00:00,UFU RIVADAVIA,203,157,257,76,27,360,360,0,360,0,0,13,99,95,58,24,40,31,0,26,170,163,360
20220216,16FEB2022:00:00:00,UFU SANTOJANNI,176,177,198,128,28,354,354,0,354,0,9,26,99,69,54,48,33,16,0,44,154,156,354
20220216,16FEB2022:00:00:00,UFU TORNU,141,110,194,42,15,251,251,0,251,0,25,35,65,40,41,20,16,9,0,27,130,94,251
20220216,16FEB2022:00:00:00,UFU VELEZ SARSFIELD,115,120,166,53,16,235,235,0,235,0,0,17,78,50,29,22,30,9,0,12,150,73,235
20220216,16FEB2022:00:00:00,UFU ZUBIZARRETA,126,93,132,76,11,219,219,0,219,0,0,9,53,62,34,24,21,16,0,23,93,103,219
20220217,17FEB2022:00:00:00,UFU ALVAREZ,197,176,273,73,27,373,373,0,373,0,20,42,92,70,56,52,28,13,0,19,246,108,373
20220217,17FEB2022:00:00:00,UFU ARGERICH,50,44,60,33,1,94,94,0,94,0,5,9,27,25,7,14,4,3,0,5,46,43,94
20220217,17FEB2022:00:00:00,UFU BORDA-MOYANO,69,52,69,46,6,121,121,0,121,0,0,8,23,33,30,19,5,3,0,8,65,48,121
20220217,17FEB2022:00:00:00,UFU DURAND,144,104,200,28,20,248,248,0,248,0,0,6,69,70,49,16,31,7,0,53,106,89,248
20220217,17FEB2022:00:00:00,UFU ELIZALDE,134,86,65,151,4,220,220,0,220,0,118,66,7,17,7,2,3,0,0,8,107,105,220
20220217,17FEB2022:00:00:00,UFU FERNANDEZ,80,92,99,32,41,172,172,0,172,0,0,3,46,61,30,10,10,12,0,10,92,70,172
20220217,17FEB2022:00:00:00,UFU FERRER,110,91,77,104,20,201,201,0,201,0,0,5,62,55,50,23,3,3,0,12,131,58,201
20220217,17FEB2022:00:00:00,UFU GRIERSON,84,129,145,60,8,213,213,0,213,0,0,15,60,63,35,22,11,7,0,6,153,54,213
20220217,17FEB2022:00:00:00,UFU GUTIERREZ,143,120,138,87,38,263,263,0,263,0,131,81,4,22,14,5,4,2,0,4,179,78,263
20220217,17FEB2022:00:00:00,UFU MUÑIZ,132,180,171,121,20,312,312,0,312,0,2,16,73,98,55,33,19,16,0,5,210,97,312
20220217,17FEB2022:00:00:00,UFU PENNA,130,91,92,125,4,221,221,0,221,0,17,37,57,42,31,29,5,3,0,4,160,56,221
20220217,17FEB2022:00:00:00,UFU PIROVANO,155,134,188,45,56,289,289,0,289,0,0,12,79,76,68,31,13,10,0,28,141,120,289
20220217,17FEB2022:00:00:00,UFU PIÑERO,128,102,166,55,9,230,230,0,230,0,0,13,74,65,38,21,8,11,0,13,157,59,230
20220217,17FEB2022:00:00:00,UFU RAMOS MEJIA,126,145,186,55,30,271,271,0,271,0,5,12,73,66,50,24,25,16,0,16,138,117,271
20220217,17FEB2022:00:00:00,UFU RIVADAVIA,155,111,188,45,33,266,266,0,266,0,0,7,92,64,27,45,18,13,0,15,155,96,266
20220217,17FEB2022:00:00:00,UFU SANTOJANNI,138,176,189,102,23,314,314,0,314,0,0,27,73,79,55,39,19,22,0,49,147,118,314
20220217,17FEB2022:00:00:00,UFU TORNU,93,116,170,27,12,209,209,0,209,0,3,11,44,68,35,22,15,11,0,14,131,64,209
20220217,17FEB2022:00:00:00,UFU VELEZ SARSFIELD,74,94,101,46,21,168,168,0,168,0,0,14,30,51,19,26,20,8,0,23,78,67,168
20220217,17FEB2022:00:00:00,UFU ZUBIZARRETA,94,84,112,60,6,178,178,0,178,0,0,17,44,34,24,37,13,9,0,25,79,74,178
20220218,18FEB2022:00:00:00,UFU ALVAREZ,133,169,226,66,10,302,302,0,302,0,13,34,72,55,44,24,40,20,0,12,179,111,302
20220218,18FEB2022:00:00:00,UFU ARGERICH,30,32,39,23,0,62,62,0,62,0,1,3,13,16,9,5,8,7,0,3,29,28,62
20220415,15APR2022:00:00:00,UFU ALVAREZ,47,23,59,5,6,70,70,0,70,0,1,2,14,18,11,9,9,6,0,5,37,28,70
20220415,15APR2022:00:00:00,UFU ARGERICH,14,14,24,4,0,28,28,0,28,0,0,2,8,2,10,0,4,2,0,1,13,14,28
20220415,15APR2022:00:00:00,UFU DURAND,28,45,68,0,7,75,75,0,75,0,2,6,9,26,13,10,7,2,0,11,36,28,75
20220415,15APR2022:00:00:00,UFU GUTIERREZ,38,43,59,17,6,82,82,0,82,0,54,17,0,0,8,3,0,0,0,1,45,36,82
20220415,15APR2022:00:00:00,UFU MUÑIZ,40,50,45,42,3,90,90,0,90,0,1,8,15,22,16,14,8,6,0,3,27,60,90
20220415,15APR2022:00:00:00,UFU PIROVANO,77,42,98,12,9,119,119,0,119,0,0,3,12,27,34,24,17,2,0,19,51,49,119
20220415,15APR2022:00:00:00,UFU PIÑERO,19,5,19,3,2,24,24,0,24,0,0,3,4,6,7,0,3,1,0,0,16,8,24
20220415,15APR2022:00:00:00,UFU RAMOS MEJIA,58,34,72,10,12,94,94,0,94,0,7,6,13,31,15,10,7,5,0,3,52,39,94
20220415,15APR2022:00:00:00,UFU RIVADAVIA,67,33,79,14,9,102,102,0,102,0,2,2,27,21,10,20,11,9,0,9,47,46,102
20220415,15APR2022:00:00:00,UFU SANTOJANNI,47,23,52,13,5,70,70,0,70,0,1,8,10,15,17,10,6,3,0,7,29,34,70
20220415,15APR2022:00:00:00,UFU TORNU,22,14,33,3,0,36,36,0,36,0,0,8,10,6,8,0,4,0,0,0,18,18,36
20220415,15APR2022:00:00:00,UFU VELEZ SARSFIELD,59,37,63,29,5,97,97,0,97,0,1,4,6,15,37,21,9,4,0,4,48,45,97
20220415,15APR2022:00:00:00,UFU ZUBIZARRETA,38,19,42,10,6,58,58,0,58,0,1,2,3,18,19,2,7,6,0,8,26,24,58
20220416,16APR2022:00:00:00,UFU ALVAREZ,46,44,73,10,11,94,94,0,94,0,4,6,11,23,15,12,17,6,0,12,44,38,94
20220416,16APR2022:00:00:00,UFU ARGERICH,18,22,24,14,2,40,40,0,40,0,0,2,4,17,9,2,4,2,0,1,19,20,40
20220416,16APR2022:00:00:00,UFU DURAND,47,32,71,6,2,79,79,0,79,0,0,4,15,15,18,6,13,8,0,5,45,29,79
20220416,16APR2022:00:00:00,UFU GUTIERREZ,47,44,52,39,1,92,92,0,92,0,59,25,0,0,4,2,2,0,0,2,44,46,92
20220416,16APR2022:00:00:00,UFU MUÑIZ,63,66,71,49,10,130,130,0,130,0,7,12,13,37,25,18,13,5,0,3,70,57,130
20220416,16APR2022:00:00:00,UFU PIROVANO,101,58,119,26,14,159,159,0,159,0,0,10,16,30,41,16,25,21,0,28,69,62,159
20220416,16APR2022:00:00:00,UFU PIÑERO,24,9,28,4,1,33,33,0,33,0,0,0,2,6,16,4,5,0,0,1,18,14,33
20220416,16APR2022:00:00:00,UFU RAMOS MEJIA,51,46,85,10,2,97,97,0,97,0,5,13,10,11,16,18,18,6,0,5,51,40,97
20220416,16APR2022:00:00:00,UFU RIVADAVIA,94,85,123,29,28,180,180,0,180,0,1,0,39,37,48,21,17,17,0,18,85,77,180
20220416,16APR2022:00:00:00,UFU SANTOJANNI,48,28,51,23,2,76,76,0,76,0,0,6,12,12,15,14,9,8,0,14,24,38,76
20220416,16APR2022:00:00:00,UFU TORNU,34,43,62,13,2,77,77,0,77,0,4,2,10,13,15,13,12,8,0,7,33,37,77
20220416,16APR2022:00:00:00,UFU VELEZ SARSFIELD,46,60,78,22,6,106,106,0,106,0,0,6,16,14,22,20,12,16,0,4,49,53,106
20220416,16APR2022:00:00:00,UFU ZUBIZARRETA,64,46,87,20,3,110,110,0,110,0,0,18,1,14,25,25,20,7,0,13,50,47,110
20220417,17APR2022:00:00:00,UFU ALVAREZ,53,39,67,10,15,92,92,0,92,0,1,7,18,18,16,13,15,4,0,10,41,41,92
20220417,17APR2022:00:00:00,UFU DURAND,33,30,59,3,1,63,63,0,63,0,0,6,8,8,18,14,9,0,0,8,34,21,63
20220417,17APR2022:00:00:00,UFU GUTIERREZ,24,20,36,8,1,45,45,0,45,0,23,19,1,1,1,0,0,0,0,2,19,24,45
20220417,17APR2022:00:00:00,UFU MUÑIZ,53,41,60,26,8,94,94,0,94,0,6,6,12,34,18,10,5,3,0,2,41,51,94
20220417,17APR2022:00:00:00,UFU PIROVANO,62,50,95,10,7,112,112,0,112,0,0,3,11,28,23,18,20,9,0,14,53,45,112
20220417,17APR2022:00:00:00,UFU PIÑERO,5,9,14,0,0,14,14,0,14,0,0,2,0,7,0,2,3,0,0,0,9,5,14
20220417,17APR2022:00:00:00,UFU RAMOS MEJIA,39,31,66,0,4,70,70,0,70,0,0,5,10,17,21,10,6,1,0,8,36,25,70
20220417,17APR2022:00:00:00,UFU RIVADAVIA,90,50,100,24,16,140,140,0,140,0,0,4,33,31,24,27,14,7,0,5,81,54,140
20220417,17APR2022:00:00:00,UFU SANTOJANNI,28,33,39,20,2,61,61,0,61,0,0,8,13,6,14,10,8,2,0,9,22,30,61
20220417,17APR2022:00:00:00,UFU TORNU,30,32,57,5,0,62,62,0,62,0,0,6,16,15,13,5,4,3,0,3,29,30,62
20220417,17APR2022:00:00:00,UFU VELEZ SARSFIELD,46,28,54,16,4,74,74,0,74,0,0,10,7,16,10,14,4,13,0,8,30,36,74
20220417,17APR2022:00:00:00,UFU ZUBIZARRETA,59,38,79,16,2,97,97,0,97,0,0,11,8,24,19,6,19,10,0,6,48,43,97
20220418,18APR2022:00:00:00,UFU ALVAREZ,120,69,159,18,12,189,189,0,189,0,18,16,34,40,30,22,15,14,0,11,95,83,189
20220418,18APR2022:00:00:00,UFU ARGERICH,20,20,27,11,2,40,40,0,40,0,0,0,8,4,7,9,8,4,0,2,17,21,40
20220418,18APR2022:00:00:00,UFU BORDA-MOYANO,0,6,4,2,0,6,6,0,6,0,0,0,0,4,0,2,0,0,0,0,3,3,6
20220418,18APR2022:00:00:00,UFU DURAND,88,64,126,22,4,152,152,0,152,0,0,6,17,39,15,25,22,28,0,8,87,57,152
20220418,18APR2022:00:00:00,UFU FERNANDEZ,56,29,58,23,4,85,85,0,85,0,0,6,15,16,15,15,11,7,0,4,43,38,85
20220418,18APR2022:00:00:00,UFU GUTIERREZ,128,93,132,79,10,221,221,0,221,0,149,46,0,10,14,2,0,0,0,4,124,93,221
20220418,18APR2022:00:00:00,UFU MUÑIZ,74,93,69,93,6,168,168,0,168,0,8,7,25,36,18,35,20,19,0,5,80,83,168
20220418,18APR2022:00:00:00,UFU PENNA,18,14,20,9,3,32,32,0,32,0,0,3,7,7,3,4,6,2,0,1,18,13,32
20220418,18APR2022:00:00:00,UFU PIROVANO,154,132,213,40,33,286,286,0,286,0,0,14,73,68,36,51,27,17,0,35,127,124,286
20220418,18APR2022:00:00:00,UFU PIÑERO,30,30,47,9,5,61,61,0,61,0,1,5,6,16,13,8,8,4,0,0,36,25,61
20220418,18APR2022:00:00:00,UFU RAMOS MEJIA,90,67,122,22,13,157,157,0,157,0,0,1,28,41,33,18,24,12,0,5,89,63,157
20220418,18APR2022:00:00:00,UFU RIVADAVIA,162,103,193,52,20,265,265,0,265,0,0,7,74,56,46,31,23,28,0,14,133,118,265
20220418,18APR2022:00:00:00,UFU SANTOJANNI,105,68,113,51,9,173,173,0,173,0,0,20,10,27,30,24,38,24,0,27,67,79,173
20220418,18APR2022:00:00:00,UFU TORNU,76,26,87,10,5,102,102,0,102,0,2,10,14,14,28,11,15,8,0,5,59,38,102
20220418,18APR2022:00:00:00,UFU VELEZ SARSFIELD,69,74,93,33,17,143,143,0,143,0,0,12,35,34,28,26,5,3,0,14,63,66,143
20220418,18APR2022:00:00:00,UFU ZUBIZARRETA,52,32,61,15,8,84,84,0,84,0,0,12,11,8,23,12,7,11,0,7,42,35,84
20220419,19APR2022:00:00:00,UFU ALVAREZ,100,59,126,24,9,159,159,0,159,0,5,21,33,23,29,16,14,18,0,13,83,63,159
20220419,19APR2022:00:00:00,UFU ARGERICH,23,27,33,13,4,50,50,0,50,0,4,0,10,4,14,3,13,2,0,2,24,24,50
20220419,19APR2022:00:00:00,UFU DURAND,95,77,161,7,4,172,172,0,172,0,0,10,21,42,32,22,31,14,0,18,87,67,172
20220419,19APR2022:00:00:00,UFU FERNANDEZ,50,25,54,11,11,76,76,0,76,0,1,2,19,5,21,13,6,9,0,2,40,34,76
20220419,19APR2022:00:00:00,UFU GUTIERREZ,76,76,84,61,7,152,152,0,152,0,98,46,2,2,2,2,0,0,0,4,84,64,152
20220419,19APR2022:00:00:00,UFU MUÑIZ,63,76,66,64,10,140,140,0,140,0,6,3,27,33,27,28,10,6,0,7,60,73,140
20220419,19APR2022:00:00:00,UFU PENNA,13,13,14,12,0,26,26,0,26,0,0,0,5,2,7,7,5,0,0,0,13,13,26
20220419,19APR2022:00:00:00,UFU PIROVANO,138,90,180,21,30,231,231,0,231,0,3,12,47,62,45,34,18,10,0,22,110,99,231
20220419,19APR2022:00:00:00,UFU PIÑERO,25,24,36,10,3,49,49,0,49,0,0,3,9,8,9,8,8,4,0,1,26,22,49
20220419,19APR2022:00:00:00,UFU RAMOS MEJIA,90,53,109,23,14,146,146,0,146,0,3,2,39,29,28,14,11,20,0,7,77,62,146
20220419,19APR2022:00:00:00,UFU RIVADAVIA,169,106,186,60,30,276,276,0,276,0,1,6,77,61,43,42,26,20,0,18,136,122,276
20220419,19APR2022:00:00:00,UFU SANTOJANNI,117,88,143,47,15,205,205,0,205,0,0,28,57,30,51,24,9,6,0,21,92,89,205
20220419,19APR2022:00:00:00,UFU TORNU,83,42,97,22,6,125,125,0,125,0,2,15,11,17,39,16,15,10,0,9,58,58,125
20220419,19APR2022:00:00:00,UFU VELEZ SARSFIELD,93,60,129,15,9,153,153,0,153,0,0,20,38,23,24,27,15,6,0,14,64,75,153
20220714,14JUL2022:00:00:00,UFU PENNA,61,43,68,28,9,105,105,0,105,0,5,5,17,24,16,19,12,7,0,22,47,36,105
20220714,14JUL2022:00:00:00,UFU RAMOS MEJIA,2,3,3,2,0,5,5,0,5,0,0,0,0,2,0,0,2,1,0,0,3,2,5
20220715,15JUL2022:00:00:00,UFU PENNA,52,29,64,13,4,81,81,0,81,0,0,3,16,19,12,17,12,2,0,15,45,21,81
20220715,15JUL2022:00:00:00,UFU RAMOS MEJIA,3,0,3,0,0,3,3,0,3,0,0,0,0,1,0,0,0,2,0,0,2,1,3
20220716,16JUL2022:00:00:00,UFU DURAND,131,88,189,17,15,221,221,0,221,0,2,5,27,52,53,38,28,16,0,65,113,43,221
20220716,16JUL2022:00:00:00,UFU PIROVANO,127,98,187,23,16,226,226,0,226,0,1,3,34,58,50,36,25,19,0,61,101,63,226
20220716,16JUL2022:00:00:00,UFU PIÑERO,1,4,5,0,0,5,5,0,5,0,0,0,1,2,0,2,0,0,0,0,3,2,5
20220716,16JUL2022:00:00:00,UFU ZUBIZARRETA,95,58,121,23,11,155,155,0,155,0,2,6,22,28,23,36,21,17,0,35,77,43,155
20220717,17JUL2022:00:00:00,UFU DURAND,114,94,177,23,9,209,209,0,209,0,1,7,34,52,37,38,25,15,0,71,137,1,209
20220717,17JUL2022:00:00:00,UFU PIROVANO,107,62,122,26,23,171,171,0,171,0,2,2,23,45,30,34,20,15,0,65,71,35,171
20220717,17JUL2022:00:00:00,UFU PIÑERO,19,10,24,5,1,30,30,0,30,0,1,2,5,4,8,5,4,1,0,15,14,1,30
20220717,17JUL2022:00:00:00,UFU ZUBIZARRETA,64,51,82,26,8,116,116,0,116,0,1,5,13,20,20,27,18,12,0,39,57,20,116
20220718,18JUL2022:00:00:00,UFU PENNA,38,19,42,12,4,58,58,0,58,0,2,1,9,10,6,15,12,3,0,15,42,1,58
20220718,18JUL2022:00:00:00,UFU RAMOS MEJIA,2,1,2,1,0,3,3,0,3,0,0,0,0,0,0,0,2,1,0,0,3,0,3
20220719,19JUL2022:00:00:00,UFU PENNA,10,16,20,5,1,26,26,0,26,0,4,1,6,7,2,3,1,2,0,2,21,3,26
20220720,20JUL2022:00:00:00,UFU ARGERICH,4,4,4,4,0,8,8,0,8,0,0,0,0,3,4,0,0,1,0,1,4,3,8
20220720,20JUL2022:00:00:00,UFU PENNA,27,17,31,11,2,44,44,0,44,0,2,2,7,9,9,6,6,3,0,11,30,3,44
20220720,20JUL2022:00:00:00,UFU PIÑERO,2,3,5,0,0,5,5,0,5,0,0,0,2,0,1,2,0,0,0,1,4,0,5
20220721,21JUL2022:00:00:00,UFU ARGERICH,4,1,1,4,0,5,5,0,5,0,0,0,0,0,5,0,0,0,0,2,1,2,5
20220721,21JUL2022:00:00:00,UFU PENNA,26,10,26,9,1,36,36,0,36,0,0,0,10,8,7,3,7,1,0,9,26,1,36
20220722,22JUL2022:00:00:00,UFU ARGERICH,1,2,3,0,0,3,3,0,3,0,0,0,1,0,0,2,0,0,0,1,2,0,3
20220722,22JUL2022:00:00:00,UFU PENNA,25,13,26,11,2,39,39,0,39,0,1,2,8,9,7,9,2,1,0,6,32,1,39
20220723,23JUL2022:00:00:00,UFU DURAND,110,81,162,15,15,192,192,0,192,0,1,7,32,36,38,27,29,22,0,55,134,3,192
20220723,23JUL2022:00:00:00,UFU PIROVANO,92,94,147,19,22,188,188,0,188,0,2,5,29,41,35,29,27,20,0,52,102,34,188
20220723,23JUL2022:00:00:00,UFU ZUBIZARRETA,151,108,163,75,21,259,259,0,259,0,0,10,33,58,52,41,29,36,0,38,84,137,259
20220724,24JUL2022:00:00:00,UFU DURAND,110,95,174,19,15,208,208,0,208,0,3,2,45,40,39,25,31,23,0,60,142,6,208
20220724,24JUL2022:00:00:00,UFU PIROVANO,103,79,145,22,18,185,185,0,185,0,3,0,23,41,32,31,27,28,0,72,94,19,185
20220724,24JUL2022:00:00:00,UFU ZUBIZARRETA,94,70,115,29,21,165,165,0,165,0,1,2,20,38,34,25,19,26,0,32,40,93,165
20220725,25JUL2022:00:00:00,UFU ARGERICH,0,2,2,0,0,2,2,0,2,0,0,0,0,0,2,0,0,0,0,0,1,1,2
20220725,25JUL2022:00:00:00,UFU PENNA,25,13,26,11,1,38,38,0,38,0,0,0,2,14,10,8,2,2,0,8,27,3,38
20220725,25JUL2022:00:00:00,UFU PIROVANO,94,96,139,22,31,192,192,0,192,0,2,0,35,48,29,40,28,10,0,34,75,83,192
20220726,26JUL2022:00:00:00,UFU PENNA,23,23,34,11,3,48,48,0,48,0,2,0,11,9,9,5,8,4,0,10,35,3,48
20220727,27JUL2022:00:00:00,UFU PENNA,40,21,36,16,9,61,61,0,61,0,2,0,10,13,17,5,11,3,0,18,35,8,61
20220218,18FEB2022:00:00:00,UFU BORDA-MOYANO,41,57,30,57,11,98,98,0,98,0,0,8,19,23,26,11,9,2,0,5,51,41,98
20220218,18FEB2022:00:00:00,UFU DURAND,137,129,214,39,15,268,268,0,268,0,2,11,80,67,35,29,26,18,0,40,122,106,268
20220218,18FEB2022:00:00:00,UFU ELIZALDE,112,100,54,154,4,212,212,0,212,0,129,54,10,4,7,4,4,0,0,4,78,130,212
20220218,18FEB2022:00:00:00,UFU FERNANDEZ,79,64,91,17,36,144,144,0,144,0,1,5,32,43,28,16,11,8,0,13,74,57,144
20220218,18FEB2022:00:00:00,UFU FERRER,106,75,74,84,23,181,181,0,181,0,0,7,50,56,31,18,13,6,0,12,120,49,181
20220218,18FEB2022:00:00:00,UFU GRIERSON,76,86,84,56,22,162,162,0,162,0,0,21,40,40,32,13,7,9,0,3,113,46,162
20220218,18FEB2022:00:00:00,UFU GUTIERREZ,149,111,138,81,45,264,264,0,264,0,146,70,14,16,11,7,0,0,0,7,181,72,264
20220218,18FEB2022:00:00:00,UFU MUÑIZ,93,102,100,87,8,195,195,0,195,0,2,10,24,54,59,23,14,9,0,13,126,55,195
20220218,18FEB2022:00:00:00,UFU PENNA,125,86,100,105,6,211,211,0,211,0,23,28,54,26,36,19,21,4,0,13,139,59,211
20220218,18FEB2022:00:00:00,UFU PIROVANO,121,113,154,36,44,234,234,0,234,0,0,11,63,60,37,24,25,14,0,22,115,97,234
20220218,18FEB2022:00:00:00,UFU PIÑERO,112,84,147,46,3,196,196,0,196,0,0,11,68,40,30,15,30,2,0,5,142,48,196
20220218,18FEB2022:00:00:00,UFU RAMOS MEJIA,168,139,211,63,34,308,308,0,308,0,7,17,71,77,52,45,26,13,0,17,156,135,308
20220218,18FEB2022:00:00:00,UFU RIVADAVIA,132,121,177,42,37,256,256,0,256,0,3,2,73,65,40,31,26,16,0,24,126,105,256
20220218,18FEB2022:00:00:00,UFU SANTOJANNI,158,158,176,119,21,316,316,0,316,0,0,29,80,71,44,47,28,17,0,36,162,118,316
20220218,18FEB2022:00:00:00,UFU TORNU,112,90,158,35,9,202,202,0,202,0,13,25,43,34,31,20,15,21,0,17,116,69,202
20220218,18FEB2022:00:00:00,UFU VELEZ SARSFIELD,119,115,145,73,17,235,235,0,235,0,1,14,54,48,63,36,5,14,0,13,151,71,235
20220218,18FEB2022:00:00:00,UFU ZUBIZARRETA,95,71,102,58,6,166,166,0,166,0,0,12,33,41,35,24,17,4,0,13,72,81,166
20220219,19FEB2022:00:00:00,UFU ALVAREZ,129,121,173,55,22,250,250,0,250,0,11,24,55,48,46,38,14,14,0,8,138,104,250
20220219,19FEB2022:00:00:00,UFU ARGERICH,60,58,76,42,0,118,118,0,118,0,6,8,38,27,11,14,11,3,0,6,58,54,118
20220219,19FEB2022:00:00:00,UFU BORDA-MOYANO,58,34,62,21,9,92,92,0,92,0,0,8,15,21,16,20,9,3,0,2,66,24,92
20220219,19FEB2022:00:00:00,UFU DURAND,102,86,167,14,8,189,189,0,189,0,1,14,36,38,48,26,12,14,0,30,91,68,189
20220219,19FEB2022:00:00:00,UFU ELIZALDE,107,103,80,126,4,210,210,0,210,0,124,60,10,10,4,2,0,0,0,5,118,87,210
20220219,19FEB2022:00:00:00,UFU FERNANDEZ,65,58,93,16,14,123,123,0,123,0,0,6,27,28,24,20,10,8,0,7,57,59,123
20220219,19FEB2022:00:00:00,UFU FERRER,104,93,91,100,6,197,197,0,197,0,0,3,49,56,34,27,16,12,0,8,136,53,197
20220219,19FEB2022:00:00:00,UFU GRIERSON,60,80,101,29,10,140,140,0,140,0,0,14,46,31,25,18,0,6,0,2,83,55,140
20220219,19FEB2022:00:00:00,UFU GUTIERREZ,172,120,184,80,29,293,293,0,293,0,171,71,8,16,22,1,4,0,0,7,191,95,293
20220219,19FEB2022:00:00:00,UFU MUÑIZ,85,123,112,73,23,208,208,0,208,0,0,7,47,49,35,38,26,6,0,6,138,64,208
20220219,19FEB2022:00:00:00,UFU PENNA,99,94,103,80,10,193,193,0,193,0,21,24,49,32,32,12,18,5,0,7,128,58,193
20220219,19FEB2022:00:00:00,UFU PIROVANO,65,79,99,27,18,144,144,0,144,0,0,8,29,41,28,20,11,7,0,10,78,56,144
20220219,19FEB2022:00:00:00,UFU PIÑERO,122,103,169,47,9,225,225,0,225,0,0,13,52,57,41,30,30,2,0,11,157,57,225
20220219,19FEB2022:00:00:00,UFU RAMOS MEJIA,114,90,137,44,23,204,204,0,204,0,6,18,53,52,29,27,13,6,0,23,94,87,204
20220219,19FEB2022:00:00:00,UFU RIVADAVIA,164,111,221,34,21,276,276,0,276,0,1,12,92,60,43,29,28,11,0,21,133,121,276
20220219,19FEB2022:00:00:00,UFU SANTOJANNI,132,118,123,115,12,250,250,0,250,0,3,13,75,39,44,42,21,13,0,22,125,102,250
20220219,19FEB2022:00:00:00,UFU TORNU,51,53,89,6,9,104,104,0,104,0,9,11,20,14,24,14,6,6,0,15,44,45,104
20220219,19FEB2022:00:00:00,UFU VELEZ SARSFIELD,87,91,131,34,13,178,178,0,178,0,0,5,43,54,30,24,11,11,0,8,112,58,178
20220219,19FEB2022:00:00:00,UFU ZUBIZARRETA,111,93,121,83,0,204,204,0,204,0,0,12,43,37,26,34,34,18,0,17,88,99,204
20220220,20FEB2022:00:00:00,UFU ALVAREZ,132,145,227,34,16,277,277,0,277,0,14,17,46,74,38,32,34,22,0,16,165,96,277
20220220,20FEB2022:00:00:00,UFU ARGERICH,43,38,46,35,0,81,81,0,81,0,8,8,25,17,14,4,5,0,0,2,43,36,81
20220220,20FEB2022:00:00:00,UFU BORDA-MOYANO,22,28,27,20,3,50,50,0,50,0,0,8,11,10,6,11,2,2,0,3,31,16,50
20220220,20FEB2022:00:00:00,UFU DURAND,66,64,122,4,4,130,130,0,130,0,1,8,27,36,21,19,13,5,0,29,50,50,130
20220220,20FEB2022:00:00:00,UFU FERNANDEZ,54,41,66,22,7,95,95,0,95,0,0,0,21,28,21,12,12,1,0,7,55,33,95
20220220,20FEB2022:00:00:00,UFU FERRER,54,58,56,53,3,112,112,0,112,0,0,0,29,29,22,21,7,4,0,3,77,32,112
20220220,20FEB2022:00:00:00,UFU GRIERSON,73,79,101,43,8,152,152,0,152,0,0,8,36,35,27,27,6,13,0,2,105,45,152
20220220,20FEB2022:00:00:00,UFU GUTIERREZ,169,133,193,87,22,302,302,0,302,0,190,69,0,21,18,2,2,0,0,10,194,98,302
20220220,20FEB2022:00:00:00,UFU MUÑIZ,53,71,56,52,16,124,124,0,124,0,0,8,35,31,23,17,6,4,0,1,87,36,124
20220220,20FEB2022:00:00:00,UFU PENNA,70,56,72,50,4,126,126,0,126,0,21,20,24,21,20,5,10,5,0,1,88,37,126
20220220,20FEB2022:00:00:00,UFU PIROVANO,115,77,140,33,20,193,193,0,193,0,12,9,31,49,27,31,23,11,0,27,87,79,193
20220220,20FEB2022:00:00:00,UFU PIÑERO,91,56,118,18,11,147,147,0,147,0,0,12,50,21,29,22,6,7,0,10,94,43,147
20220220,20FEB2022:00:00:00,UFU RAMOS MEJIA,98,102,171,18,11,200,200,0,200,0,13,25,36,39,38,28,13,8,0,13,97,90,200
20220220,20FEB2022:00:00:00,UFU RIVADAVIA,91,102,131,33,30,194,194,0,194,0,1,7,58,51,19,28,22,8,0,13,99,82,194
20220220,20FEB2022:00:00:00,UFU SANTOJANNI,115,103,109,100,9,218,218,0,218,0,0,22,37,47,41,47,11,13,0,16,100,102,218
20220220,20FEB2022:00:00:00,UFU TORNU,55,56,91,13,7,111,111,0,111,0,10,17,15,29,22,13,2,3,0,3,76,32,111
20220220,20FEB2022:00:00:00,UFU VELEZ SARSFIELD,97,84,117,47,17,181,181,0,181,0,0,8,50,26,46,27,11,13,0,9,115,57,181
20220220,20FEB2022:00:00:00,UFU ZUBIZARRETA,96,118,108,98,9,215,215,0,215,0,1,25,26,64,38,23,20,18,0,19,89,107,215
20220221,21FEB2022:00:00:00,UFU ALVAREZ,174,195,204,123,42,369,369,0,369,0,18,28,98,82,69,26,24,24,0,12,238,119,369
20220221,21FEB2022:00:00:00,UFU ARGERICH,57,71,49,77,2,128,128,0,128,0,4,5,40,22,19,21,11,6,0,3,68,55,128
20220221,21FEB2022:00:00:00,UFU BORDA-MOYANO,54,53,57,48,2,107,107,0,107,0,0,5,22,31,22,13,13,1,0,2,57,48,107
20220221,21FEB2022:00:00:00,UFU DURAND,159,137,237,37,22,296,296,0,296,0,0,15,84,83,53,24,18,19,0,41,136,119,296
20220221,21FEB2022:00:00:00,UFU ELIZALDE,152,141,78,214,1,293,293,0,293,0,166,84,12,19,8,0,4,0,0,6,154,133,293
20220221,21FEB2022:00:00:00,UFU FERNANDEZ,94,108,135,31,36,202,202,0,202,0,0,2,55,40,48,24,19,14,0,8,114,80,202
20220221,21FEB2022:00:00:00,UFU FERRER,108,157,100,136,29,265,265,0,265,0,0,0,73,81,69,32,8,2,0,11,186,68,265
20220221,21FEB2022:00:00:00,UFU GRIERSON,118,117,143,70,22,235,235,0,235,0,0,13,54,62,52,35,15,4,0,5,170,60,235
20220221,21FEB2022:00:00:00,UFU GUTIERREZ,177,192,184,111,75,370,370,0,370,0,189,105,14,23,26,6,7,0,0,2,249,119,370
20220221,21FEB2022:00:00:00,UFU MUÑIZ,126,197,152,146,26,324,324,0,324,0,6,25,68,68,89,40,17,11,0,8,221,95,324
20220221,21FEB2022:00:00:00,UFU PENNA,95,112,91,105,12,208,208,0,208,0,6,18,53,61,37,9,23,1,0,6,149,53,208
20220419,19APR2022:00:00:00,UFU ZUBIZARRETA,59,39,63,17,18,98,98,0,98,0,0,11,14,20,23,13,13,4,0,8,50,40,98
20220420,20APR2022:00:00:00,UFU ALVAREZ,72,48,104,4,12,120,120,0,120,0,2,14,14,29,27,9,12,13,0,12,62,46,120
20220420,20APR2022:00:00:00,UFU ARGERICH,41,32,48,21,4,73,73,0,73,0,0,2,7,20,17,9,6,12,0,3,33,37,73
20220420,20APR2022:00:00:00,UFU DURAND,92,45,130,7,0,137,137,0,137,0,0,8,20,45,20,23,14,7,0,18,64,55,137
20220420,20APR2022:00:00:00,UFU FERNANDEZ,39,31,67,1,2,70,70,0,70,0,0,0,14,22,15,6,7,6,0,5,38,27,70
20220420,20APR2022:00:00:00,UFU GUTIERREZ,78,108,100,72,14,186,186,0,186,0,120,53,5,2,3,3,0,0,0,4,103,79,186
20220420,20APR2022:00:00:00,UFU MUÑIZ,86,87,82,76,15,173,173,0,173,0,3,10,28,52,33,20,24,3,0,4,104,65,173
20220420,20APR2022:00:00:00,UFU PENNA,2,4,4,0,2,6,6,0,6,0,0,0,0,0,0,2,4,0,0,0,3,3,6
20220420,20APR2022:00:00:00,UFU PIROVANO,130,104,200,15,19,234,234,0,234,0,0,10,63,43,61,25,19,13,0,20,103,111,234
20220420,20APR2022:00:00:00,UFU PIÑERO,22,43,41,22,2,65,65,0,65,0,0,1,6,22,21,13,2,0,0,3,39,23,65
20220420,20APR2022:00:00:00,UFU RAMOS MEJIA,94,58,128,15,9,152,152,0,152,0,0,0,32,36,42,15,12,15,0,10,81,61,152
20220420,20APR2022:00:00:00,UFU RIVADAVIA,136,109,183,39,23,245,245,0,245,0,0,5,72,60,33,30,18,27,0,14,122,109,245
20220420,20APR2022:00:00:00,UFU SANTOJANNI,95,79,132,37,5,174,174,0,174,0,0,14,25,39,35,39,17,5,0,31,67,76,174
20220420,20APR2022:00:00:00,UFU TORNU,50,44,78,14,2,94,94,0,94,0,0,6,17,13,30,7,14,7,0,11,42,41,94
20220420,20APR2022:00:00:00,UFU VELEZ SARSFIELD,69,64,110,12,11,133,133,0,133,0,0,8,24,30,22,23,13,13,0,12,57,64,133
20220420,20APR2022:00:00:00,UFU ZUBIZARRETA,59,39,68,24,6,98,98,0,98,0,0,14,11,29,13,12,13,6,0,11,52,35,98
20220421,21APR2022:00:00:00,UFU ALVAREZ,89,48,102,31,5,138,138,0,138,0,7,13,28,28,17,22,14,9,0,15,62,61,138
20220421,21APR2022:00:00:00,UFU ARGERICH,25,13,25,11,2,38,38,0,38,0,1,8,5,5,3,7,3,6,0,0,16,22,38
20220421,21APR2022:00:00:00,UFU DURAND,65,23,80,4,4,88,88,0,88,0,0,6,19,28,12,9,5,9,0,6,48,34,88
20220421,21APR2022:00:00:00,UFU FERNANDEZ,44,45,65,5,20,90,90,0,90,0,1,3,19,19,19,15,5,9,0,6,41,43,90
20220421,21APR2022:00:00:00,UFU GUTIERREZ,84,73,101,52,5,158,158,0,158,0,126,26,2,4,0,0,0,0,0,0,89,69,158
20220421,21APR2022:00:00:00,UFU MUÑIZ,73,75,68,72,11,151,151,0,151,0,9,9,27,29,38,19,9,11,0,5,87,59,151
20220421,21APR2022:00:00:00,UFU PENNA,17,12,21,8,0,29,29,0,29,0,0,3,13,2,5,0,3,3,0,1,15,13,29
20220421,21APR2022:00:00:00,UFU PIROVANO,100,93,153,22,18,193,193,0,193,0,0,9,23,47,49,23,22,20,0,24,85,84,193
20220421,21APR2022:00:00:00,UFU PIÑERO,40,25,53,7,7,67,67,0,67,0,2,3,8,12,10,16,16,0,0,4,34,29,67
20220421,21APR2022:00:00:00,UFU RAMOS MEJIA,73,41,81,20,14,115,115,0,115,0,1,6,31,27,23,18,6,3,0,7,62,46,115
20220421,21APR2022:00:00:00,UFU RIVADAVIA,123,89,157,38,20,215,215,0,215,0,3,4,57,52,28,30,16,25,0,13,109,93,215
20220421,21APR2022:00:00:00,UFU SANTOJANNI,53,38,69,18,4,91,91,0,91,0,0,9,10,9,27,14,20,2,0,16,44,31,91
20220421,21APR2022:00:00:00,UFU TORNU,64,55,97,19,3,119,119,0,119,0,11,11,15,31,18,5,14,14,0,12,49,58,119
20220421,21APR2022:00:00:00,UFU VELEZ SARSFIELD,71,69,105,21,14,140,140,0,140,0,0,11,25,32,32,15,9,16,0,18,54,68,140
20220421,21APR2022:00:00:00,UFU ZUBIZARRETA,47,32,64,12,4,80,80,0,80,0,1,6,7,18,17,13,8,10,0,10,37,33,80
20220422,22APR2022:00:00:00,UFU ALVAREZ,86,46,111,13,8,132,132,0,132,0,2,8,15,46,24,14,12,11,0,9,70,53,132
20220422,22APR2022:00:00:00,UFU ARGERICH,13,11,18,5,1,24,24,0,24,0,0,2,7,4,2,2,1,6,0,1,6,17,24
20220422,22APR2022:00:00:00,UFU DURAND,74,55,115,9,5,129,129,0,129,0,0,4,14,34,27,22,14,14,0,19,55,55,129
20220422,22APR2022:00:00:00,UFU FERNANDEZ,42,26,48,13,7,68,68,0,68,0,0,3,16,0,19,8,15,7,0,2,34,31,68
20220422,22APR2022:00:00:00,UFU GUTIERREZ,60,71,62,62,7,131,131,0,131,0,94,30,2,0,3,2,0,0,0,4,72,55,131
20220422,22APR2022:00:00:00,UFU MUÑIZ,61,67,65,50,13,128,128,0,128,0,6,5,19,19,35,29,8,7,0,3,68,57,128
20220422,22APR2022:00:00:00,UFU PENNA,17,8,18,7,0,25,25,0,25,0,0,0,3,8,5,4,5,0,0,1,15,9,25
20220422,22APR2022:00:00:00,UFU PIROVANO,85,62,126,7,14,147,147,0,147,0,0,8,20,48,32,23,6,10,0,11,70,66,147
20220422,22APR2022:00:00:00,UFU PIÑERO,32,19,43,7,1,51,51,0,51,0,0,0,8,12,9,12,6,4,0,4,28,19,51
20220422,22APR2022:00:00:00,UFU RAMOS MEJIA,74,28,80,16,6,102,102,0,102,0,0,2,18,26,17,22,9,8,0,6,54,42,102
20220422,22APR2022:00:00:00,UFU RIVADAVIA,122,67,150,15,24,189,189,0,189,0,0,15,52,29,21,31,23,18,0,14,86,88,189
20220422,22APR2022:00:00:00,UFU SANTOJANNI,81,45,97,24,5,126,126,0,126,0,2,20,16,18,16,17,18,19,0,23,50,52,126
20220422,22APR2022:00:00:00,UFU TORNU,71,44,101,14,0,115,115,0,115,0,4,4,21,21,22,23,16,4,0,6,55,53,115
20220422,22APR2022:00:00:00,UFU VELEZ SARSFIELD,49,49,74,24,0,98,98,0,98,0,0,0,22,24,25,11,6,10,0,14,38,46,98
20220422,22APR2022:00:00:00,UFU ZUBIZARRETA,31,28,40,15,4,59,59,0,59,0,0,9,4,9,7,17,7,6,0,8,28,23,59
20220423,23APR2022:00:00:00,UFU ALVAREZ,48,42,78,9,4,91,91,0,91,0,2,3,14,13,21,14,10,14,0,12,42,37,91
20220423,23APR2022:00:00:00,UFU DURAND,52,23,66,0,9,75,75,0,75,0,0,0,15,10,12,11,16,11,0,10,40,25,75
20220423,23APR2022:00:00:00,UFU GUTIERREZ,36,27,41,21,1,63,63,0,63,0,41,20,0,1,0,1,0,0,0,5,15,43,63
20220423,23APR2022:00:00:00,UFU MUÑIZ,50,46,40,49,7,96,96,0,96,0,0,4,28,26,12,14,12,0,0,1,53,42,96
20220423,23APR2022:00:00:00,UFU PIROVANO,67,47,85,22,8,115,115,0,115,0,1,0,10,43,36,14,5,6,0,19,44,52,115
20220423,23APR2022:00:00:00,UFU PIÑERO,10,13,17,2,4,23,23,0,23,0,0,0,2,5,5,4,2,5,0,2,12,9,23
20220423,23APR2022:00:00:00,UFU RAMOS MEJIA,51,28,67,10,3,80,80,0,80,0,8,2,10,12,11,13,16,8,0,4,41,35,80
20220423,23APR2022:00:00:00,UFU RIVADAVIA,131,72,148,34,23,205,205,0,205,0,2,7,42,31,32,37,38,16,0,13,96,96,205
20220423,23APR2022:00:00:00,UFU SANTOJANNI,27,31,36,20,2,58,58,0,58,0,0,0,3,8,14,13,8,12,0,4,30,24,58
20220423,23APR2022:00:00:00,UFU TORNU,36,28,57,5,2,64,64,0,64,0,4,4,9,4,14,10,6,13,0,8,31,25,64
20220423,23APR2022:00:00:00,UFU VELEZ SARSFIELD,61,33,76,11,7,94,94,0,94,0,0,8,17,23,22,8,11,5,0,19,33,42,94
20220423,23APR2022:00:00:00,UFU ZUBIZARRETA,48,30,55,19,5,79,79,0,79,0,1,3,4,13,22,5,20,11,0,12,33,34,79
20220424,24APR2022:00:00:00,UFU ALVAREZ,55,41,86,4,6,96,96,0,96,0,4,5,12,14,17,18,10,16,0,10,40,46,96
20220424,24APR2022:00:00:00,UFU DURAND,38,20,52,5,1,58,58,0,58,0,0,0,6,24,15,6,3,4,0,10,27,21,58
20220424,24APR2022:00:00:00,UFU GUTIERREZ,35,18,36,12,5,53,53,0,53,0,33,16,1,0,3,0,0,0,0,3,11,39,53
20220424,24APR2022:00:00:00,UFU MUÑIZ,44,52,50,42,7,99,99,0,99,0,5,2,19,22,19,21,9,2,0,3,41,55,99
20220424,24APR2022:00:00:00,UFU PIROVANO,77,69,127,8,11,146,146,0,146,0,0,8,19,32,31,22,19,15,0,26,63,57,146
20220424,24APR2022:00:00:00,UFU PIÑERO,7,9,14,1,1,16,16,0,16,0,0,0,3,9,0,3,1,0,0,1,10,5,16
20220424,24APR2022:00:00:00,UFU RAMOS MEJIA,42,22,52,10,2,64,64,0,64,0,3,4,10,10,23,5,6,3,0,3,34,27,64
20220424,24APR2022:00:00:00,UFU RIVADAVIA,91,65,106,33,18,157,157,0,157,0,1,5,34,35,21,39,9,13,0,10,80,67,157
20220424,24APR2022:00:00:00,UFU SANTOJANNI,29,24,42,9,3,54,54,0,54,0,1,4,13,10,12,2,6,6,0,5,25,24,54
20220424,24APR2022:00:00:00,UFU TORNU,48,29,68,4,5,77,77,0,77,0,13,7,8,10,1,6,18,14,0,5,35,37,77
20220221,21FEB2022:00:00:00,UFU PIROVANO,161,117,207,43,29,279,279,0,279,0,1,11,65,58,53,37,29,25,0,28,134,117,279
20220221,21FEB2022:00:00:00,UFU PIÑERO,130,135,207,46,13,266,266,0,266,0,2,10,69,71,45,31,21,17,0,12,186,68,266
20220221,21FEB2022:00:00:00,UFU RAMOS MEJIA,179,205,250,114,20,384,384,0,384,0,1,9,90,92,75,57,32,28,0,16,184,184,384
20220221,21FEB2022:00:00:00,UFU RIVADAVIA,175,171,227,75,44,346,346,0,346,0,0,12,101,74,56,52,30,21,0,20,182,144,346
20220221,21FEB2022:00:00:00,UFU SANTOJANNI,142,185,165,107,55,327,327,0,327,0,6,14,90,60,48,62,26,21,0,35,162,130,327
20220221,21FEB2022:00:00:00,UFU TORNU,106,107,161,36,16,213,213,0,213,0,11,18,38,58,31,23,18,16,0,12,132,69,213
20220221,21FEB2022:00:00:00,UFU VELEZ SARSFIELD,115,136,156,59,37,252,252,0,252,0,1,17,52,58,56,23,28,17,0,6,155,91,252
20220221,21FEB2022:00:00:00,UFU ZUBIZARRETA,128,102,142,70,18,230,230,0,230,0,0,25,52,53,43,27,17,13,0,22,97,111,230
20220222,22FEB2022:00:00:00,UFU ALVAREZ,148,174,232,69,21,322,322,0,322,0,9,31,82,56,60,21,42,21,0,6,217,99,322
20220222,22FEB2022:00:00:00,UFU ARGERICH,44,51,42,51,2,95,95,0,95,0,5,12,26,21,10,10,8,3,0,12,41,42,95
20220222,22FEB2022:00:00:00,UFU BORDA-MOYANO,45,74,47,59,14,120,120,0,120,0,4,13,29,23,33,15,3,0,0,4,63,53,120
20220222,22FEB2022:00:00:00,UFU DURAND,136,151,243,28,16,287,287,0,287,0,0,6,65,106,45,23,32,10,0,41,130,116,287
20220222,22FEB2022:00:00:00,UFU ELIZALDE,128,105,75,154,4,233,233,0,233,0,133,85,5,6,2,2,0,0,0,0,126,107,233
20220222,22FEB2022:00:00:00,UFU FERNANDEZ,125,81,146,33,27,206,206,0,206,0,0,5,54,56,37,17,18,19,0,16,111,79,206
20220222,22FEB2022:00:00:00,UFU FERRER,108,141,133,81,35,249,249,0,249,0,0,3,78,72,40,29,20,7,0,4,180,65,249
20220222,22FEB2022:00:00:00,UFU GRIERSON,99,75,109,56,9,174,174,0,174,0,0,6,44,45,33,26,14,6,0,5,120,49,174
20220222,22FEB2022:00:00:00,UFU GUTIERREZ,200,166,203,118,47,368,368,0,368,0,205,110,13,20,15,5,0,0,0,5,251,112,368
20220222,22FEB2022:00:00:00,UFU MUÑIZ,104,137,132,98,11,241,241,0,241,0,2,21,39,43,74,32,23,7,0,8,157,75,241
20220222,22FEB2022:00:00:00,UFU PENNA,114,141,134,107,14,255,255,0,255,0,38,30,72,41,24,24,20,6,0,2,182,71,255
20220222,22FEB2022:00:00:00,UFU PIROVANO,145,102,174,48,25,247,247,0,247,0,0,3,64,64,35,38,25,18,0,22,129,96,247
20220222,22FEB2022:00:00:00,UFU PIÑERO,102,111,163,34,16,213,213,0,213,0,0,7,60,49,26,51,18,2,0,6,131,76,213
20220222,22FEB2022:00:00:00,UFU RAMOS MEJIA,168,187,264,66,28,358,358,0,358,0,15,12,103,78,66,26,33,25,0,5,249,104,358
20220222,22FEB2022:00:00:00,UFU RIVADAVIA,169,140,207,64,40,311,311,0,311,0,2,10,108,75,42,39,22,13,0,13,172,125,311
20220222,22FEB2022:00:00:00,UFU SANTOJANNI,144,155,171,95,33,299,299,0,299,0,0,24,79,57,53,44,22,20,0,27,127,145,299
20220222,22FEB2022:00:00:00,UFU TORNU,118,106,174,37,13,224,224,0,224,0,22,32,24,51,55,25,10,5,0,8,151,65,224
20220222,22FEB2022:00:00:00,UFU VELEZ SARSFIELD,119,116,149,72,15,236,236,0,236,0,1,16,60,79,14,28,22,16,0,8,153,75,236
20220222,22FEB2022:00:00:00,UFU ZUBIZARRETA,119,106,105,93,27,225,225,0,225,0,0,15,44,58,47,31,24,6,0,8,108,109,225
20220223,23FEB2022:00:00:00,UFU ALVAREZ,199,194,307,61,27,395,395,0,395,0,26,46,75,78,59,32,33,46,0,7,262,126,395
20220223,23FEB2022:00:00:00,UFU ARGERICH,28,38,29,37,2,68,68,0,68,0,10,2,21,19,5,7,4,0,0,1,38,29,68
20220223,23FEB2022:00:00:00,UFU BORDA-MOYANO,47,58,46,51,11,108,108,0,108,0,5,15,25,23,22,10,7,1,0,7,60,41,108
20220223,23FEB2022:00:00:00,UFU DURAND,176,129,259,14,32,305,305,0,305,0,0,6,57,84,57,41,40,20,0,58,118,129,305
20220223,23FEB2022:00:00:00,UFU ELIZALDE,115,113,67,142,29,238,238,0,238,0,162,50,5,9,4,4,4,0,0,5,117,116,238
20220223,23FEB2022:00:00:00,UFU FERNANDEZ,105,115,127,46,51,224,224,0,224,0,4,18,53,67,25,35,18,4,0,18,112,94,224
20220223,23FEB2022:00:00:00,UFU FERRER,121,133,125,105,33,263,263,0,263,0,9,4,84,79,41,17,24,5,0,9,179,75,263
20220223,23FEB2022:00:00:00,UFU GRIERSON,120,104,132,87,13,232,232,0,232,0,8,14,78,47,28,30,22,5,0,9,157,66,232
20220223,23FEB2022:00:00:00,UFU GUTIERREZ,156,157,185,81,53,319,319,0,319,0,182,85,4,14,17,14,3,0,0,5,218,96,319
20220223,23FEB2022:00:00:00,UFU MUÑIZ,168,162,173,133,35,341,341,0,341,0,17,22,98,68,64,39,23,10,0,8,233,99,341
20220223,23FEB2022:00:00:00,UFU PENNA,110,100,83,121,11,215,215,0,215,0,37,22,54,40,25,24,11,2,0,2,157,56,215
20220223,23FEB2022:00:00:00,UFU PIROVANO,168,110,196,38,47,281,281,0,281,0,3,5,68,67,54,36,36,12,0,22,149,110,281
20220223,23FEB2022:00:00:00,UFU PIÑERO,129,111,188,37,15,240,240,0,240,0,0,13,87,38,49,22,24,7,0,4,174,61,240
20220223,23FEB2022:00:00:00,UFU RAMOS MEJIA,213,151,281,57,28,366,366,0,366,0,11,20,125,85,50,30,25,20,0,16,203,147,366
20220223,23FEB2022:00:00:00,UFU RIVADAVIA,155,148,209,65,39,313,313,0,313,0,10,10,84,81,44,47,21,16,0,14,166,133,313
20220223,23FEB2022:00:00:00,UFU SANTOJANNI,142,134,142,106,32,280,280,0,280,0,9,33,64,78,45,18,18,15,0,20,145,115,280
20220223,23FEB2022:00:00:00,UFU TORNU,98,88,146,35,5,186,186,0,186,0,26,28,19,39,47,13,7,7,0,6,81,99,186
20220223,23FEB2022:00:00:00,UFU VELEZ SARSFIELD,138,165,201,73,30,304,304,0,304,0,1,17,78,73,59,31,32,13,0,14,194,96,304
20220223,23FEB2022:00:00:00,UFU ZUBIZARRETA,109,104,147,58,11,216,216,0,216,0,3,17,33,69,46,26,14,8,0,32,81,103,216
20220224,24FEB2022:00:00:00,UFU ALVAREZ,141,159,231,44,26,301,301,0,301,0,26,26,87,53,70,10,17,12,0,14,189,98,301
20220224,24FEB2022:00:00:00,UFU ARGERICH,33,29,33,29,0,62,62,0,62,0,3,2,22,22,7,1,2,3,0,4,26,31,62
20220224,24FEB2022:00:00:00,UFU BORDA-MOYANO,62,45,51,52,4,107,107,0,107,0,4,12,23,24,25,16,2,1,0,4,57,46,107
20220224,24FEB2022:00:00:00,UFU DURAND,150,135,240,33,12,285,285,0,285,0,0,14,62,82,63,34,24,6,0,28,121,136,285
20220224,24FEB2022:00:00:00,UFU ELIZALDE,116,107,88,132,4,224,224,0,224,0,126,73,9,7,6,1,2,0,0,2,116,106,224
20220224,24FEB2022:00:00:00,UFU FERNANDEZ,76,89,111,30,24,165,165,0,165,0,0,8,40,43,24,29,11,10,0,9,81,75,165
20220224,24FEB2022:00:00:00,UFU FERRER,138,98,96,105,35,236,236,0,236,0,0,10,93,50,36,23,13,11,0,7,175,54,236
20220224,24FEB2022:00:00:00,UFU GRIERSON,92,115,124,59,24,207,207,0,207,0,0,13,75,55,17,21,12,14,0,3,146,58,207
20220224,24FEB2022:00:00:00,UFU GUTIERREZ,140,149,167,88,34,289,289,0,289,0,178,64,16,13,14,4,0,0,0,5,208,76,289
20220224,24FEB2022:00:00:00,UFU MUÑIZ,96,125,119,78,25,222,222,0,222,0,1,17,58,50,47,23,23,3,0,6,152,64,222
20220224,24FEB2022:00:00:00,UFU PENNA,114,88,109,86,7,202,202,0,202,0,33,11,56,53,34,9,4,2,0,3,140,59,202
20220224,24FEB2022:00:00:00,UFU PIROVANO,115,97,160,32,20,212,212,0,212,0,0,17,61,54,36,17,11,16,0,10,116,86,212
20220224,24FEB2022:00:00:00,UFU PIÑERO,101,127,187,28,13,228,228,0,228,0,0,21,57,75,45,17,8,5,0,8,163,56,228
20220224,24FEB2022:00:00:00,UFU RAMOS MEJIA,147,140,206,60,21,287,287,0,287,0,11,24,73,72,51,34,16,6,0,5,159,123,287
20220224,24FEB2022:00:00:00,UFU RIVADAVIA,138,138,197,59,22,278,278,0,278,0,2,8,92,79,30,30,21,16,0,22,150,106,278
20220224,24FEB2022:00:00:00,UFU SANTOJANNI,64,73,70,57,10,137,137,0,137,0,0,22,32,33,27,10,8,5,0,8,3,126,137
20220224,24FEB2022:00:00:00,UFU TORNU,105,135,172,50,18,240,240,0,240,0,27,13,53,66,31,19,18,13,0,8,154,78,240
20220224,24FEB2022:00:00:00,UFU VELEZ SARSFIELD,114,124,177,52,9,238,238,0,238,0,0,19,65,54,38,19,22,21,0,15,139,84,238
20220224,24FEB2022:00:00:00,UFU ZUBIZARRETA,89,115,132,64,9,205,205,0,205,0,1,17,44,53,35,27,15,13,0,18,87,100,205
20211112,12NOV2021:00:00:00,UFU BORDA-MOYANO,46,23,47,17,5,69,57,12,57,12,0,6,15,19,17,7,4,1,0,0,38,19,57
20211112,12NOV2021:00:00:00,UFU DURAND,115,84,182,16,1,199,197,2,197,2,0,5,31,65,44,20,28,6,0,9,105,83,197
20211112,12NOV2021:00:00:00,UFU ELIZALDE,82,87,48,116,5,169,149,20,155,14,133,29,4,3,0,0,0,0,0,0,86,63,149
20211112,12NOV2021:00:00:00,UFU FERNANDEZ,67,68,110,17,8,135,121,14,125,10,0,2,24,38,23,32,9,7,0,2,75,44,121
20211112,12NOV2021:00:00:00,UFU FERRER,77,27,65,38,1,104,102,2,102,2,0,2,14,35,18,19,7,9,0,1,75,26,102
20211112,12NOV2021:00:00:00,UFU GRIERSON,107,81,123,53,12,188,154,34,174,14,0,30,46,37,7,33,25,10,0,5,108,39,154
20211112,12NOV2021:00:00:00,UFU GUTIERREZ,98,103,80,117,4,201,197,4,199,2,133,34,7,20,5,0,2,0,0,1,133,63,197
20211112,12NOV2021:00:00:00,UFU MUÑIZ,110,126,125,102,9,236,190,46,198,38,10,13,49,57,31,33,32,11,0,6,131,53,190
20211112,12NOV2021:00:00:00,UFU PENNA,59,36,59,30,6,95,85,10,87,8,7,6,19,23,18,19,1,2,0,1,61,23,85
20211112,12NOV2021:00:00:00,UFU PIROVANO,156,144,236,36,28,300,290,10,296,4,0,7,84,68,56,34,25,26,0,8,162,120,290
20211112,12NOV2021:00:00:00,UFU PIÑERO,133,92,171,46,8,225,219,6,219,6,60,31,24,38,24,25,17,6,0,0,161,56,219
20211112,12NOV2021:00:00:00,UFU RAMOS MEJIA,98,84,119,34,29,182,148,34,148,34,7,4,30,44,40,24,19,14,0,3,86,59,148
20211112,12NOV2021:00:00:00,UFU RIVADAVIA,164,67,168,34,29,231,225,6,227,4,0,11,61,79,25,22,18,15,0,19,109,97,225
20211112,12NOV2021:00:00:00,UFU SANTOJANNI,107,118,125,92,8,225,217,8,225,0,3,21,49,44,36,32,21,19,0,8,115,94,217
20211112,12NOV2021:00:00:00,UFU TORNU,94,88,168,8,6,182,166,16,166,16,18,12,21,56,37,20,8,10,0,11,101,52,166
20211112,12NOV2021:00:00:00,UFU VELEZ SARSFIELD,160,102,195,52,15,262,250,12,252,10,0,11,42,82,46,23,30,28,0,2,176,72,250
20211112,12NOV2021:00:00:00,UFU ZUBIZARRETA,133,124,148,85,24,257,255,2,255,2,0,28,51,40,46,59,14,19,0,7,185,63,255
20211113,13NOV2021:00:00:00,UFU ALVAREZ,126,111,212,19,6,237,229,8,229,8,2,5,68,44,51,20,25,22,0,5,161,63,229
20211113,13NOV2021:00:00:00,UFU ARGERICH,10,4,6,6,2,14,14,0,14,0,2,6,2,2,0,2,0,0,0,0,8,6,14
20211113,13NOV2021:00:00:00,UFU BORDA-MOYANO,10,15,19,3,3,25,25,0,25,0,2,4,2,9,2,0,4,2,0,1,15,9,25
20211113,13NOV2021:00:00:00,UFU DURAND,115,60,152,18,5,175,167,8,167,8,5,11,31,47,44,17,10,10,0,6,93,68,167
20211113,13NOV2021:00:00:00,UFU ELIZALDE,42,69,28,80,3,111,93,18,103,8,94,14,2,0,1,0,0,0,0,0,58,35,93
20211113,13NOV2021:00:00:00,UFU FERNANDEZ,63,39,87,11,4,102,86,16,90,12,4,7,23,28,13,17,4,6,0,3,50,33,86
20211113,13NOV2021:00:00:00,UFU FERRER,76,34,61,43,6,110,108,2,108,2,0,3,22,29,16,24,5,11,0,2,80,26,108
20211113,13NOV2021:00:00:00,UFU GRIERSON,62,50,63,30,19,112,106,6,108,4,0,13,30,22,14,17,5,11,0,1,58,47,106
20211113,13NOV2021:00:00:00,UFU GUTIERREZ,80,90,103,67,0,170,160,10,162,8,110,36,1,8,8,7,0,0,0,0,104,56,160
20211113,13NOV2021:00:00:00,UFU MUÑIZ,79,62,74,54,13,141,117,24,121,20,0,10,19,38,17,25,18,14,0,1,82,34,117
20211113,13NOV2021:00:00:00,UFU PENNA,62,29,45,42,4,91,83,8,85,6,9,14,9,14,20,15,8,2,0,7,55,21,83
20211113,13NOV2021:00:00:00,UFU PIROVANO,145,97,210,15,17,242,234,8,238,4,0,4,52,69,45,36,21,15,0,12,123,99,234
20211113,13NOV2021:00:00:00,UFU PIÑERO,55,52,63,39,5,107,107,0,107,0,0,11,25,23,20,17,8,3,0,2,77,27,107
20211113,13NOV2021:00:00:00,UFU RAMOS MEJIA,66,47,92,11,10,113,93,20,93,20,4,6,20,25,26,12,14,6,0,1,52,40,93
20211113,13NOV2021:00:00:00,UFU RIVADAVIA,56,43,78,15,6,99,81,18,81,18,0,2,20,35,13,14,11,4,0,2,42,37,81
20211113,13NOV2021:00:00:00,UFU SANTOJANNI,127,92,137,67,15,219,195,24,213,6,12,22,30,39,43,25,32,16,0,10,104,81,195
20211113,13NOV2021:00:00:00,UFU TORNU,84,78,138,20,4,162,148,14,148,14,12,13,21,40,36,22,10,8,0,8,93,47,148
20211113,13NOV2021:00:00:00,UFU VELEZ SARSFIELD,104,142,201,29,16,246,244,2,244,2,0,10,36,49,63,45,29,14,0,1,174,69,244
20211113,13NOV2021:00:00:00,UFU ZUBIZARRETA,162,112,198,76,0,274,268,6,274,0,0,16,46,49,58,43,31,31,0,3,196,69,268
20211114,14NOV2021:00:00:00,UFU ALVAREZ,126,121,200,35,12,247,229,18,229,18,12,26,41,55,39,30,27,17,0,3,169,57,229
20211114,14NOV2021:00:00:00,UFU ARGERICH,28,25,33,18,2,53,53,0,53,0,0,2,11,15,9,8,2,6,0,0,33,19,53
20211114,14NOV2021:00:00:00,UFU BORDA-MOYANO,4,13,9,8,0,17,15,2,15,2,0,2,2,2,9,2,0,0,0,0,9,6,15
20211114,14NOV2021:00:00:00,UFU DURAND,117,87,187,8,9,204,192,12,192,12,12,15,24,60,43,19,18,13,0,20,96,76,192
20211114,14NOV2021:00:00:00,UFU ELIZALDE,76,74,56,94,0,150,112,38,144,6,111,31,2,0,1,3,2,0,0,0,70,42,112
20211114,14NOV2021:00:00:00,UFU FERNANDEZ,76,52,110,10,8,128,118,10,118,10,0,3,14,54,16,16,14,11,0,5,69,44,118
20211114,14NOV2021:00:00:00,UFU FERRER,33,29,32,30,0,62,58,4,58,4,0,0,12,17,18,12,0,3,0,0,42,16,58
20211114,14NOV2021:00:00:00,UFU GRIERSON,28,32,37,18,5,60,56,4,56,4,0,2,14,14,17,11,0,2,0,2,30,24,56
20211114,14NOV2021:00:00:00,UFU GUTIERREZ,76,103,84,83,12,179,169,10,171,8,121,42,0,8,8,0,0,0,0,4,108,57,169
20211114,14NOV2021:00:00:00,UFU MUÑIZ,64,61,63,58,4,125,109,16,109,16,0,7,23,28,31,17,14,5,0,1,77,31,109
20211114,14NOV2021:00:00:00,UFU PENNA,34,10,30,14,0,44,44,0,44,0,3,6,5,8,10,8,4,0,0,0,32,12,44
20211114,14NOV2021:00:00:00,UFU PIROVANO,129,106,198,17,20,235,199,36,231,4,14,1,30,57,43,49,17,24,0,3,115,81,199
20211114,14NOV2021:00:00:00,UFU PIÑERO,69,60,85,33,11,129,123,6,123,6,0,10,27,35,31,10,11,5,0,1,93,29,123
20211114,14NOV2021:00:00:00,UFU RAMOS MEJIA,63,56,98,9,12,119,109,10,109,10,6,4,23,30,31,15,2,8,0,6,60,43,109
20211114,14NOV2021:00:00:00,UFU RIVADAVIA,63,68,107,9,15,131,125,6,127,4,0,2,29,36,17,22,15,10,0,6,67,52,125
20211114,14NOV2021:00:00:00,UFU SANTOJANNI,81,71,92,42,18,152,136,16,148,4,0,11,15,37,23,38,15,13,0,9,74,53,136
20211114,14NOV2021:00:00:00,UFU TORNU,73,46,96,14,9,119,109,10,109,10,6,14,9,21,35,16,8,10,0,5,71,33,109
20211114,14NOV2021:00:00:00,UFU VELEZ SARSFIELD,91,110,160,32,9,201,199,2,199,2,0,18,31,46,49,32,18,7,0,1,122,76,199
20211114,14NOV2021:00:00:00,UFU ZUBIZARRETA,99,80,109,57,13,179,175,4,179,0,0,18,19,21,47,51,9,14,0,4,124,47,175
20211115,15NOV2021:00:00:00,UFU ALVAREZ,205,193,324,48,26,398,382,16,384,14,46,27,75,106,66,36,27,15,0,10,277,95,382
20211115,15NOV2021:00:00:00,UFU ARGERICH,56,68,69,49,6,124,96,28,100,24,19,20,25,18,12,17,6,7,0,2,54,39,96
20211115,15NOV2021:00:00:00,UFU BORDA-MOYANO,30,34,38,13,13,64,64,0,64,0,0,3,18,13,15,12,1,2,0,2,37,25,64
20211115,15NOV2021:00:00:00,UFU DURAND,164,119,238,26,19,283,273,10,275,8,19,22,55,73,63,21,23,7,0,6,158,109,273
20211115,15NOV2021:00:00:00,UFU ELIZALDE,126,112,67,165,6,238,204,34,226,12,173,56,1,7,1,0,0,0,0,0,120,84,204
20211115,15NOV2021:00:00:00,UFU FERNANDEZ,66,80,111,15,20,146,126,20,140,6,0,5,27,43,27,17,17,10,0,5,74,47,126
20211115,15NOV2021:00:00:00,UFU FERRER,97,49,81,54,11,146,142,4,142,4,0,0,27,46,35,19,8,11,0,6,96,40,142
20211115,15NOV2021:00:00:00,UFU GRIERSON,70,71,78,45,18,141,137,4,139,2,0,18,22,42,33,12,10,4,0,7,74,55,137
20211115,15NOV2021:00:00:00,UFU GUTIERREZ,164,112,141,127,8,276,260,16,270,6,185,52,6,13,8,10,0,2,0,1,150,109,260
20211115,15NOV2021:00:00:00,UFU MUÑIZ,173,185,125,202,31,358,276,82,306,52,6,59,37,68,74,51,34,29,0,2,181,93,276
20211115,15NOV2021:00:00:00,UFU PENNA,115,108,132,75,16,223,211,12,211,12,59,14,41,48,13,23,19,6,0,2,154,54,211
20211216,16DEC2021:00:00:00,UFU MUÑIZ,419,416,487,288,60,835,775,60,801,34,22,117,168,189,159,113,44,23,0,43,570,162,775
20211216,16DEC2021:00:00:00,UFU PENNA,105,70,102,56,17,175,169,6,169,6,11,17,31,48,41,21,4,2,0,23,113,33,169
20211216,16DEC2021:00:00:00,UFU PIROVANO,488,394,705,91,86,882,834,48,862,20,0,45,275,271,132,88,41,30,0,153,470,211,834
20211216,16DEC2021:00:00:00,UFU PIÑERO,218,182,316,61,23,400,378,22,378,22,29,44,96,75,64,43,26,23,0,25,284,68,378
20211216,16DEC2021:00:00:00,UFU RAMOS MEJIA,283,260,430,35,78,543,512,31,515,28,0,31,153,163,100,54,36,6,0,76,310,126,512
20211216,16DEC2021:00:00:00,UFU RIVADAVIA,450,338,573,114,101,788,752,36,752,36,4,27,270,219,121,89,35,23,0,98,428,226,752
20211216,16DEC2021:00:00:00,UFU SANTOJANNI,229,191,208,182,30,420,393,27,418,2,0,26,93,89,93,64,36,19,0,56,235,102,393
20211216,16DEC2021:00:00:00,UFU TORNU,351,258,526,56,27,609,565,44,567,42,36,67,100,154,126,62,37,27,0,82,347,132,565
20211216,16DEC2021:00:00:00,UFU VELEZ SARSFIELD,254,172,357,54,15,426,419,7,424,2,0,9,113,112,76,64,26,26,0,53,286,80,419
20211216,16DEC2021:00:00:00,UFU ZUBIZARRETA,155,121,178,69,29,276,264,12,276,0,8,23,67,53,43,34,33,15,0,22,94,148,264
20211217,17DEC2021:00:00:00,UFU ALVAREZ,363,317,552,68,60,680,668,12,668,12,14,52,185,156,103,100,38,32,0,71,461,136,668
20211217,17DEC2021:00:00:00,UFU ARGERICH,110,81,138,42,11,191,165,26,165,26,6,4,43,43,48,32,10,5,0,24,95,46,165
20211217,17DEC2021:00:00:00,UFU BORDA-MOYANO,46,72,71,33,14,118,112,6,112,6,0,4,19,23,32,26,8,6,0,2,64,46,112
20211217,17DEC2021:00:00:00,UFU DURAND,175,141,290,9,17,316,308,8,308,8,0,16,94,79,47,38,34,8,0,70,164,74,308
20211217,17DEC2021:00:00:00,UFU ELIZALDE,100,64,51,100,13,164,152,12,158,6,109,32,5,10,8,0,0,0,0,4,107,41,152
20211217,17DEC2021:00:00:00,UFU FERNANDEZ,412,309,610,45,66,721,637,84,695,26,0,25,264,184,110,77,27,34,0,81,397,159,637
20211217,17DEC2021:00:00:00,UFU FERRER,128,112,142,94,4,240,234,6,234,6,0,16,67,50,50,38,19,0,0,30,161,43,234
20211217,17DEC2021:00:00:00,UFU GRIERSON,242,138,222,108,50,380,330,50,368,12,0,21,130,87,59,61,17,5,0,50,215,64,330
20211217,17DEC2021:00:00:00,UFU GUTIERREZ,142,144,202,57,27,286,269,17,278,8,175,55,14,17,8,15,2,0,0,10,189,70,269
20211217,17DEC2021:00:00:00,UFU MUÑIZ,345,336,405,202,74,681,578,103,583,98,21,65,119,193,116,100,45,22,0,28,448,102,578
20211217,17DEC2021:00:00:00,UFU PENNA,78,62,113,24,3,140,126,14,126,14,6,13,42,30,10,16,19,4,0,24,79,23,126
20211217,17DEC2021:00:00:00,UFU PIROVANO,469,399,627,98,143,868,838,30,852,16,0,43,296,254,120,83,43,29,0,129,478,231,838
20211217,17DEC2021:00:00:00,UFU PIÑERO,184,177,267,59,35,361,340,21,343,18,31,53,48,76,65,38,38,12,0,40,223,75,340
20211217,17DEC2021:00:00:00,UFU RAMOS MEJIA,256,264,401,42,77,520,455,65,458,62,6,55,125,137,85,57,42,13,0,73,250,132,455
20211217,17DEC2021:00:00:00,UFU RIVADAVIA,512,358,652,117,101,870,846,24,850,20,0,34,312,236,98,101,56,33,0,92,476,278,846
20211217,17DEC2021:00:00:00,UFU SANTOJANNI,299,241,328,185,27,540,504,36,532,8,3,38,164,135,66,51,56,27,0,75,301,128,504
20211217,17DEC2021:00:00:00,UFU TORNU,417,279,616,40,40,696,640,56,640,56,21,73,155,173,136,63,48,27,0,77,400,163,640
20211217,17DEC2021:00:00:00,UFU VELEZ SARSFIELD,225,194,336,51,32,419,410,9,417,2,0,22,111,103,57,58,53,15,0,46,275,89,410
20211217,17DEC2021:00:00:00,UFU ZUBIZARRETA,136,112,167,42,39,248,246,2,248,0,2,27,71,53,36,35,10,14,0,12,153,81,246
20211218,18DEC2021:00:00:00,UFU ALVAREZ,384,285,547,80,42,669,646,23,649,20,10,66,172,153,81,85,83,19,0,79,427,140,646
20211218,18DEC2021:00:00:00,UFU ARGERICH,3,2,3,2,0,5,5,0,5,0,2,2,1,0,0,0,0,0,0,0,3,2,5
20211218,18DEC2021:00:00:00,UFU BORDA-MOYANO,56,58,64,46,4,114,112,2,112,2,0,7,26,32,17,20,10,2,0,16,71,25,112
20211218,18DEC2021:00:00:00,UFU DURAND,213,134,304,25,18,347,327,20,337,10,0,15,85,104,61,25,25,32,0,62,170,95,327
20211218,18DEC2021:00:00:00,UFU ELIZALDE,110,82,79,91,22,192,145,47,186,6,111,66,2,2,9,2,0,0,0,9,94,42,145
20211218,18DEC2021:00:00:00,UFU FERNANDEZ,310,214,429,58,37,524,512,12,512,12,0,23,145,154,67,66,39,30,0,88,301,123,512
20211218,18DEC2021:00:00:00,UFU FERRER,83,51,79,52,3,134,132,2,132,2,0,5,35,33,19,26,13,3,0,23,83,26,132
20211218,18DEC2021:00:00:00,UFU GRIERSON,167,177,170,141,33,344,334,10,334,10,0,29,87,60,47,57,47,17,0,40,231,61,334
20211218,18DEC2021:00:00:00,UFU GUTIERREZ,171,119,238,35,17,290,275,15,278,12,166,78,3,26,10,3,4,0,0,26,168,81,275
20211218,18DEC2021:00:00:00,UFU MUÑIZ,324,359,443,184,56,683,585,98,603,80,20,103,140,171,109,82,41,17,0,52,414,119,585
20211218,18DEC2021:00:00:00,UFU PENNA,98,82,130,36,14,180,173,7,176,4,16,9,33,69,18,24,11,0,0,35,104,34,173
20211218,18DEC2021:00:00:00,UFU PIROVANO,396,315,587,61,63,711,698,13,703,8,0,46,176,224,95,82,52,36,0,107,422,169,698
20211218,18DEC2021:00:00:00,UFU PIÑERO,212,126,275,50,13,338,332,6,332,6,0,29,89,66,52,43,47,12,0,17,252,61,332
20211218,18DEC2021:00:00:00,UFU RAMOS MEJIA,249,186,334,48,53,435,415,20,415,20,8,24,98,131,37,58,38,41,0,86,218,111,415
20211218,18DEC2021:00:00:00,UFU RIVADAVIA,222,175,278,49,70,397,397,0,397,0,1,20,141,88,69,40,22,16,0,44,179,168,397
20211218,18DEC2021:00:00:00,UFU SANTOJANNI,269,241,265,209,36,510,485,25,494,16,0,27,121,129,92,58,57,26,0,115,246,124,485
20211218,18DEC2021:00:00:00,UFU TORNU,197,209,354,31,21,406,398,8,398,8,10,50,71,101,71,66,34,3,0,67,235,96,398
20211218,18DEC2021:00:00:00,UFU VELEZ SARSFIELD,231,206,356,65,16,437,424,13,435,2,0,34,95,105,86,78,19,20,0,56,276,92,424
20211218,18DEC2021:00:00:00,UFU ZUBIZARRETA,324,202,386,122,18,526,522,4,526,0,0,33,145,108,94,63,46,37,0,48,336,138,522
20211219,19DEC2021:00:00:00,UFU ALVAREZ,339,306,493,84,68,645,625,20,625,20,13,45,152,160,134,65,48,28,0,90,402,133,625
20211219,19DEC2021:00:00:00,UFU ARGERICH,41,37,49,25,4,78,78,0,78,0,1,4,14,25,14,6,9,5,0,16,31,27,78
20211219,19DEC2021:00:00:00,UFU BORDA-MOYANO,40,23,49,14,0,63,57,6,57,6,0,4,8,14,15,16,2,4,0,4,39,14,57
20211219,19DEC2021:00:00:00,UFU DURAND,178,141,283,16,20,319,301,18,303,16,4,14,66,84,40,42,37,32,0,103,129,69,301
20211219,19DEC2021:00:00:00,UFU ELIZALDE,57,70,28,91,8,127,111,16,119,8,48,62,3,3,11,0,0,0,0,4,82,25,111
20211219,19DEC2021:00:00:00,UFU FERNANDEZ,372,318,546,98,46,690,642,48,642,48,0,28,213,180,85,92,64,28,0,114,357,169,642
20211219,19DEC2021:00:00:00,UFU FERRER,77,95,96,73,3,172,166,6,166,6,0,10,40,55,40,19,3,5,0,27,107,32,166
20211219,19DEC2021:00:00:00,UFU GRIERSON,127,88,125,70,20,215,150,65,157,58,0,14,46,34,41,42,35,3,0,14,105,29,150
20211219,19DEC2021:00:00:00,UFU GUTIERREZ,199,136,270,53,12,335,323,12,323,12,153,119,7,14,22,11,6,3,0,22,206,95,323
20211219,19DEC2021:00:00:00,UFU MUÑIZ,298,283,313,211,57,581,522,59,541,40,11,47,133,115,152,54,53,16,0,33,369,120,522
20211219,19DEC2021:00:00:00,UFU PENNA,105,61,113,49,4,166,158,8,158,8,9,15,33,37,14,42,9,7,0,23,107,28,158
20211219,19DEC2021:00:00:00,UFU PIROVANO,368,265,500,59,74,633,616,17,619,14,11,39,184,196,81,71,32,19,0,112,341,163,616
20211219,19DEC2021:00:00:00,UFU PIÑERO,143,128,218,48,5,271,263,8,263,8,0,19,70,71,30,35,40,6,0,26,190,47,263
20211219,19DEC2021:00:00:00,UFU RAMOS MEJIA,188,238,343,22,61,426,410,16,410,16,9,36,110,102,72,55,39,3,0,74,243,93,410
20211219,19DEC2021:00:00:00,UFU RIVADAVIA,141,102,163,39,41,243,239,4,239,4,1,9,70,87,36,19,13,8,0,34,111,94,239
20210725,25JUL2021:00:00:00,UFU PIROVANO,139,137,204,40,32,276,256,20,270,6,2,18,56,68,80,34,10,8,0,33,115,108,256
20210725,25JUL2021:00:00:00,UFU PIÑERO,53,48,85,14,2,101,99,2,99,2,0,9,22,32,21,12,2,3,0,8,64,26,99
20210725,25JUL2021:00:00:00,UFU RAMOS MEJIA,102,83,134,24,27,185,173,12,173,12,2,5,39,50,38,25,16,10,0,14,106,53,173
20210725,25JUL2021:00:00:00,UFU RIVADAVIA,134,105,176,43,20,239,217,22,217,22,0,6,67,62,31,45,10,18,0,20,105,90,217
20210725,25JUL2021:00:00:00,UFU SANTOJANNI,173,137,155,129,26,310,290,20,306,4,12,28,46,81,55,47,24,17,0,15,206,69,290
20210725,25JUL2021:00:00:00,UFU TORNU,92,77,120,13,36,169,151,18,151,18,3,18,22,56,43,15,9,3,0,9,106,36,151
20210725,25JUL2021:00:00:00,UFU VELEZ SARSFIELD,122,107,158,58,13,229,225,4,229,0,0,11,53,57,54,20,29,5,0,17,143,65,225
20210725,25JUL2021:00:00:00,UFU ZUBIZARRETA,46,30,44,28,4,76,74,2,76,0,0,9,21,20,11,10,4,1,0,11,34,29,74
20210726,26JUL2021:00:00:00,UFU ALVAREZ,201,143,258,55,31,344,326,18,330,14,47,16,93,83,51,34,14,6,0,22,218,86,326
20210726,26JUL2021:00:00:00,UFU ARGERICH,72,60,80,35,17,132,124,8,126,6,6,0,34,26,28,20,11,7,0,17,56,51,124
20210726,26JUL2021:00:00:00,UFU BORDA-MOYANO,33,44,43,24,10,77,73,4,73,4,4,0,20,27,11,10,1,4,0,8,40,25,73
20210726,26JUL2021:00:00:00,UFU DURAND,129,121,200,18,32,250,242,8,242,8,11,4,58,89,27,30,19,12,0,40,109,93,242
20210726,26JUL2021:00:00:00,UFU ELIZALDE,182,137,77,206,36,319,277,42,303,16,186,65,15,27,17,5,4,0,0,4,193,80,277
20210726,26JUL2021:00:00:00,UFU FERNANDEZ,124,96,149,35,36,220,204,16,216,4,0,7,58,50,30,27,33,15,0,21,101,81,204
20210726,26JUL2021:00:00:00,UFU FERRER,100,60,61,62,37,160,156,4,160,0,0,0,48,38,38,23,8,5,0,19,94,43,156
20210726,26JUL2021:00:00:00,UFU GRIERSON,116,116,93,79,60,232,226,6,226,6,0,5,77,63,35,22,26,4,0,17,149,58,226
20210726,26JUL2021:00:00:00,UFU GUTIERREZ,152,133,120,131,34,285,267,18,285,0,161,49,21,26,23,0,5,0,0,1,180,85,267
20210726,26JUL2021:00:00:00,UFU MUÑIZ,132,152,129,126,29,284,244,40,248,36,0,6,76,68,58,48,17,11,0,11,165,68,244
20210726,26JUL2021:00:00:00,UFU PENNA,94,64,83,62,13,158,150,8,158,0,0,8,34,48,34,13,18,3,0,5,103,42,150
20210726,26JUL2021:00:00:00,UFU PIROVANO,169,143,223,33,56,312,288,24,308,4,0,9,67,80,83,37,21,15,0,28,123,137,288
20210726,26JUL2021:00:00:00,UFU PIÑERO,101,81,129,31,22,182,178,4,178,4,0,15,40,50,20,31,17,9,0,11,123,43,178
20210726,26JUL2021:00:00:00,UFU RAMOS MEJIA,204,143,231,78,38,347,293,54,299,48,11,16,111,71,58,49,21,10,0,25,178,90,293
20210726,26JUL2021:00:00:00,UFU RIVADAVIA,120,87,135,35,37,207,201,6,201,6,0,8,51,55,37,28,26,2,0,17,98,86,201
20210726,26JUL2021:00:00:00,UFU SANTOJANNI,237,232,238,161,70,469,449,20,461,8,16,31,102,113,81,78,40,8,0,33,311,105,449
20210726,26JUL2021:00:00:00,UFU TORNU,87,109,128,38,30,196,176,20,180,16,5,13,58,49,28,19,17,7,0,13,112,47,176
20210726,26JUL2021:00:00:00,UFU VELEZ SARSFIELD,175,114,172,84,33,289,251,38,285,4,0,8,89,38,52,49,38,15,0,24,148,79,251
20210726,26JUL2021:00:00:00,UFU ZUBIZARRETA,189,146,203,104,28,335,335,0,335,0,0,10,83,96,61,19,36,30,0,23,220,92,335
20210727,27JUL2021:00:00:00,UFU ALVAREZ,155,132,207,64,16,287,275,12,279,8,23,8,87,78,39,36,13,3,0,16,189,70,275
20210727,27JUL2021:00:00:00,UFU ARGERICH,49,40,55,23,11,89,79,10,81,8,10,9,26,15,6,15,4,4,0,6,38,35,79
20210727,27JUL2021:00:00:00,UFU BORDA-MOYANO,32,30,45,13,4,62,58,4,58,4,0,1,18,6,16,11,8,2,0,0,41,17,58
20210727,27JUL2021:00:00:00,UFU DURAND,99,101,159,22,19,200,194,6,194,6,13,10,48,70,28,21,6,4,0,20,94,80,194
20210727,27JUL2021:00:00:00,UFU ELIZALDE,150,166,63,241,12,316,278,38,310,6,210,50,13,17,16,5,4,1,0,5,195,78,278
20210727,27JUL2021:00:00:00,UFU FERNANDEZ,92,79,135,14,22,171,129,42,161,10,0,10,63,36,29,13,9,11,0,15,66,48,129
20210727,27JUL2021:00:00:00,UFU FERRER,57,64,70,45,6,121,107,14,111,10,0,0,13,43,31,22,9,3,0,13,64,30,107
20210727,27JUL2021:00:00:00,UFU GRIERSON,125,97,114,70,38,222,212,10,216,6,0,13,38,66,44,41,16,4,0,11,143,58,212
20210727,27JUL2021:00:00:00,UFU GUTIERREZ,157,108,139,102,24,265,223,42,261,4,111,64,31,48,6,3,2,0,0,7,154,62,223
20210727,27JUL2021:00:00:00,UFU MUÑIZ,128,138,141,100,25,266,202,64,214,52,0,7,65,69,67,34,17,7,0,11,134,57,202
20210727,27JUL2021:00:00:00,UFU PENNA,45,53,56,34,8,98,96,2,96,2,0,3,42,16,25,6,5,1,0,5,72,19,96
20210727,27JUL2021:00:00:00,UFU PIROVANO,135,120,184,38,33,255,243,12,247,8,0,1,64,95,52,20,15,8,0,23,119,101,243
20210727,27JUL2021:00:00:00,UFU PIÑERO,99,83,132,41,9,182,170,12,172,10,0,9,46,57,27,24,16,3,0,6,123,41,170
20210727,27JUL2021:00:00:00,UFU RAMOS MEJIA,178,146,204,54,66,324,298,26,308,16,7,15,87,96,53,42,22,2,0,16,199,83,298
20210727,27JUL2021:00:00:00,UFU RIVADAVIA,139,78,131,32,54,217,205,12,209,8,0,4,81,53,37,17,20,5,0,22,99,84,205
20210727,27JUL2021:00:00:00,UFU SANTOJANNI,212,156,190,143,35,368,356,12,360,8,2,26,68,123,79,21,36,13,0,13,257,86,356
20210727,27JUL2021:00:00:00,UFU TORNU,111,81,151,20,21,192,140,52,146,46,7,16,34,42,43,26,19,5,0,11,102,27,140
20210727,27JUL2021:00:00:00,UFU VELEZ SARSFIELD,116,134,189,43,18,250,242,8,244,6,0,6,40,70,80,19,25,10,0,18,157,67,242
20210727,27JUL2021:00:00:00,UFU ZUBIZARRETA,158,104,151,89,22,262,260,2,262,0,0,15,65,75,61,26,11,9,0,17,173,70,260
20210728,28JUL2021:00:00:00,UFU ALVAREZ,167,106,179,57,37,273,265,8,267,6,14,22,79,73,46,25,11,3,0,11,175,79,265
20210728,28JUL2021:00:00:00,UFU ARGERICH,72,41,60,47,6,113,101,12,101,12,11,7,29,27,24,10,0,5,0,5,55,41,101
20210728,28JUL2021:00:00:00,UFU BORDA-MOYANO,11,23,16,15,3,34,30,4,30,4,0,4,8,7,5,8,2,0,0,0,21,9,30
20210728,28JUL2021:00:00:00,UFU DURAND,97,87,152,17,15,184,174,10,174,10,7,8,47,55,23,23,14,7,0,23,81,70,174
20210728,28JUL2021:00:00:00,UFU ELIZALDE,140,82,60,155,7,222,208,14,212,10,123,39,17,30,6,6,1,0,0,1,124,83,208
20210728,28JUL2021:00:00:00,UFU FERNANDEZ,82,74,118,19,19,156,146,10,148,8,0,0,33,47,45,19,3,9,0,14,75,57,146
20210728,28JUL2021:00:00:00,UFU FERRER,82,67,64,78,7,149,137,12,139,10,0,5,49,47,27,15,5,1,0,8,92,37,137
20210728,28JUL2021:00:00:00,UFU GRIERSON,63,70,82,41,10,133,129,4,131,2,0,9,40,30,39,13,2,0,0,11,79,38,129
20210728,28JUL2021:00:00:00,UFU GUTIERREZ,102,81,119,62,2,183,181,2,183,0,102,25,17,20,15,2,0,2,0,7,126,48,181
20210728,28JUL2021:00:00:00,UFU MUÑIZ,101,121,97,104,21,222,166,56,176,46,0,7,55,63,47,27,15,8,0,7,123,36,166
20210728,28JUL2021:00:00:00,UFU PENNA,60,58,59,53,6,118,116,2,116,2,0,3,38,27,23,11,14,2,0,8,79,29,116
20210728,28JUL2021:00:00:00,UFU PIROVANO,122,125,171,52,24,247,217,30,243,4,0,9,72,87,48,8,16,7,0,28,105,84,217
20210728,28JUL2021:00:00:00,UFU PIÑERO,98,85,134,38,11,183,181,2,181,2,0,12,62,32,53,14,7,3,0,13,118,49,181
20210728,28JUL2021:00:00:00,UFU RAMOS MEJIA,163,141,212,66,26,304,278,26,278,26,4,21,92,81,47,28,21,10,0,16,173,89,278
20210728,28JUL2021:00:00:00,UFU RIVADAVIA,136,74,154,27,29,210,186,24,190,20,0,9,74,52,35,19,12,9,0,15,97,74,186
20210728,28JUL2021:00:00:00,UFU SANTOJANNI,164,146,159,126,25,310,302,8,310,0,3,2,71,76,77,27,41,13,0,16,213,73,302
20210728,28JUL2021:00:00:00,UFU TORNU,120,86,162,33,11,206,194,12,196,10,15,8,49,62,26,23,16,7,0,11,136,47,194
20210728,28JUL2021:00:00:00,UFU VELEZ SARSFIELD,145,115,195,53,12,260,240,20,254,6,0,10,67,83,55,22,12,11,0,10,163,67,240
20210917,17SEP2021:00:00:00,UFU TORNU,154,133,264,17,6,287,227,60,229,58,52,39,29,73,57,17,9,11,0,4,158,62,227
20210917,17SEP2021:00:00:00,UFU VELEZ SARSFIELD,130,97,173,47,7,227,217,10,223,4,0,17,29,54,55,24,22,26,0,0,152,65,217
20210917,17SEP2021:00:00:00,UFU ZUBIZARRETA,123,78,149,46,6,201,193,8,201,0,0,20,43,39,34,31,19,15,0,2,142,49,193
20210918,18SEP2021:00:00:00,UFU ALVAREZ,101,103,137,52,15,204,196,8,196,8,3,5,29,45,49,26,26,21,0,1,143,52,196
20210918,18SEP2021:00:00:00,UFU ARGERICH,0,2,0,2,0,2,2,0,2,0,2,0,0,0,0,0,0,0,0,0,1,1,2
20210918,18SEP2021:00:00:00,UFU BORDA-MOYANO,24,24,28,17,3,48,46,2,46,2,0,5,5,11,7,14,4,2,0,0,33,13,46
20210918,18SEP2021:00:00:00,UFU DURAND,99,57,134,14,8,156,148,8,148,8,1,6,33,52,27,11,19,7,0,1,86,61,148
20210918,18SEP2021:00:00:00,UFU ELIZALDE,94,107,62,132,7,201,157,44,191,10,130,48,8,7,7,1,0,0,0,0,97,60,157
20210918,18SEP2021:00:00:00,UFU FERNANDEZ,60,29,85,2,2,89,79,10,81,8,0,6,21,30,6,15,9,2,0,3,43,33,79
20210918,18SEP2021:00:00:00,UFU FERRER,61,21,41,39,2,82,80,2,80,2,0,0,14,35,24,7,2,0,0,1,58,21,80
20210918,18SEP2021:00:00:00,UFU GRIERSON,70,65,73,34,28,135,127,8,127,8,0,10,26,35,24,29,8,3,0,2,92,33,127
20210918,18SEP2021:00:00:00,UFU GUTIERREZ,112,112,131,93,0,224,222,2,222,2,159,57,3,3,2,0,0,0,0,5,158,59,222
20210918,18SEP2021:00:00:00,UFU MUÑIZ,88,69,75,76,6,157,117,40,125,32,9,15,32,27,33,25,16,0,0,2,91,24,117
20210918,18SEP2021:00:00:00,UFU PENNA,28,54,47,32,3,82,82,0,82,0,39,6,6,13,12,4,2,0,0,2,59,21,82
20210918,18SEP2021:00:00:00,UFU PIROVANO,118,66,157,18,9,184,172,12,176,8,0,8,28,52,44,18,19,15,0,7,96,69,172
20210918,18SEP2021:00:00:00,UFU PIÑERO,69,33,61,36,5,102,102,0,102,0,0,12,16,17,25,21,8,3,0,0,80,21,102
20210918,18SEP2021:00:00:00,UFU RAMOS MEJIA,91,82,125,24,24,173,153,20,153,20,6,10,36,40,28,29,12,12,0,0,82,71,153
20210918,18SEP2021:00:00:00,UFU RIVADAVIA,78,38,75,15,26,116,98,18,100,16,1,7,32,24,26,11,7,8,0,2,56,40,98
20210918,18SEP2021:00:00:00,UFU SANTOJANNI,141,87,119,84,25,228,214,14,218,10,6,19,26,34,47,44,22,30,0,2,120,92,214
20210918,18SEP2021:00:00:00,UFU TORNU,99,69,128,24,16,168,162,6,162,6,37,11,7,27,33,16,22,15,0,3,120,39,162
20210918,18SEP2021:00:00:00,UFU VELEZ SARSFIELD,128,94,154,56,12,222,210,12,216,6,0,27,37,50,50,41,12,5,0,3,142,65,210
20210918,18SEP2021:00:00:00,UFU ZUBIZARRETA,165,110,212,60,3,275,271,4,275,0,0,37,34,58,54,47,20,25,0,0,194,77,271
20210919,19SEP2021:00:00:00,UFU ALVAREZ,133,102,219,14,2,235,221,14,221,14,55,12,22,56,43,11,25,11,0,1,153,67,221
20210919,19SEP2021:00:00:00,UFU ARGERICH,40,24,35,26,3,64,64,0,64,0,11,9,11,9,13,5,4,2,0,1,39,24,64
20210919,19SEP2021:00:00:00,UFU BORDA-MOYANO,26,17,30,13,0,43,39,4,39,4,0,0,5,12,18,2,4,2,0,1,23,15,39
20210919,19SEP2021:00:00:00,UFU DURAND,74,44,104,4,10,118,110,8,110,8,11,7,17,25,30,18,6,4,0,5,62,43,110
20210919,19SEP2021:00:00:00,UFU ELIZALDE,126,86,82,122,8,212,164,48,204,8,119,47,11,26,5,4,0,0,0,0,101,63,164
20210919,19SEP2021:00:00:00,UFU FERNANDEZ,50,42,75,9,8,92,86,6,90,2,0,0,15,28,13,13,17,6,0,6,44,36,86
20210919,19SEP2021:00:00:00,UFU FERRER,61,24,43,40,2,85,75,10,81,4,0,0,17,17,19,18,9,5,0,2,56,17,75
20210919,19SEP2021:00:00:00,UFU GRIERSON,44,49,60,21,12,93,85,8,85,8,0,6,19,29,22,14,3,0,0,2,58,25,85
20210919,19SEP2021:00:00:00,UFU GUTIERREZ,104,83,133,49,5,187,181,6,183,4,118,47,6,13,3,0,0,0,0,4,123,54,181
20210919,19SEP2021:00:00:00,UFU MUÑIZ,82,67,72,65,12,149,121,28,125,24,2,17,15,43,30,15,19,8,0,1,85,35,121
20210919,19SEP2021:00:00:00,UFU PENNA,40,27,41,26,0,67,67,0,67,0,8,0,5,15,18,14,7,0,0,1,47,19,67
20210919,19SEP2021:00:00:00,UFU PIROVANO,132,108,186,26,28,240,210,30,238,2,40,15,24,48,48,23,19,23,0,2,123,85,210
20210919,19SEP2021:00:00:00,UFU PIÑERO,47,24,58,8,5,71,69,2,69,2,0,2,11,13,17,14,9,5,0,1,49,18,69
20210919,19SEP2021:00:00:00,UFU RAMOS MEJIA,86,80,115,29,22,166,158,8,158,8,12,17,34,45,26,17,9,6,0,1,85,72,158
20210919,19SEP2021:00:00:00,UFU RIVADAVIA,92,52,124,14,6,144,98,46,98,46,0,1,35,34,25,14,18,17,0,4,51,43,98
20210919,19SEP2021:00:00:00,UFU SANTOJANNI,114,97,112,76,23,211,193,18,201,10,2,24,31,39,33,56,13,13,0,4,111,78,193
20210919,19SEP2021:00:00:00,UFU TORNU,98,82,150,26,4,180,172,8,172,8,29,36,10,30,31,15,26,3,0,3,121,47,172
20210919,19SEP2021:00:00:00,UFU VELEZ SARSFIELD,77,72,127,17,5,149,149,0,149,0,0,8,11,41,43,26,11,9,0,0,108,41,149
20210919,19SEP2021:00:00:00,UFU ZUBIZARRETA,63,48,84,25,2,111,111,0,111,0,0,10,15,34,33,15,3,1,0,1,87,23,111
20210920,20SEP2021:00:00:00,UFU ALVAREZ,144,101,191,42,12,245,225,20,225,20,46,6,15,69,57,14,22,16,0,2,146,77,225
20210920,20SEP2021:00:00:00,UFU ARGERICH,88,61,94,53,2,149,141,8,143,6,31,20,14,22,18,11,12,21,0,1,77,63,141
20210920,20SEP2021:00:00:00,UFU BORDA-MOYANO,37,32,36,31,2,69,61,8,61,8,6,21,4,11,14,11,2,0,0,0,36,25,61
20210920,20SEP2021:00:00:00,UFU DURAND,115,144,214,32,13,259,243,16,243,16,39,15,43,51,30,27,42,12,0,8,139,96,243
20210920,20SEP2021:00:00:00,UFU ELIZALDE,200,190,158,228,4,390,366,24,374,16,252,88,12,21,14,3,0,0,0,0,240,126,366
20210920,20SEP2021:00:00:00,UFU FERNANDEZ,70,67,96,26,15,137,121,16,131,6,0,10,34,26,30,16,12,9,0,2,75,44,121
20210920,20SEP2021:00:00:00,UFU FERRER,70,65,91,42,2,135,125,10,129,6,3,1,34,40,27,18,7,5,0,1,92,32,125
20210920,20SEP2021:00:00:00,UFU GRIERSON,112,89,125,67,9,201,197,4,197,4,0,30,38,44,36,31,16,6,0,2,142,52,197
20210920,20SEP2021:00:00:00,UFU GUTIERREZ,158,167,185,130,10,325,303,22,313,12,239,58,9,17,2,0,0,0,0,1,183,118,303
20210920,20SEP2021:00:00:00,UFU MUÑIZ,123,113,101,125,10,236,190,46,190,46,9,19,34,72,35,47,16,4,0,1,135,54,190
20210920,20SEP2021:00:00:00,UFU PENNA,116,106,130,90,2,222,204,18,204,18,69,35,33,29,23,20,9,4,0,1,148,55,204
20210920,20SEP2021:00:00:00,UFU PIROVANO,121,112,188,26,19,233,229,4,229,4,0,16,29,75,52,30,19,12,0,4,142,83,229
20210920,20SEP2021:00:00:00,UFU PIÑERO,133,135,211,43,14,268,248,20,250,18,93,48,31,27,33,16,17,3,0,0,181,66,248
20210920,20SEP2021:00:00:00,UFU RAMOS MEJIA,165,136,210,67,24,301,279,22,297,4,25,18,37,63,48,63,25,22,0,4,161,114,279
20210920,20SEP2021:00:00:00,UFU RIVADAVIA,116,79,145,26,24,195,177,18,187,8,0,11,43,59,35,28,16,3,0,2,105,70,177
20210920,20SEP2021:00:00:00,UFU SANTOJANNI,172,130,167,121,14,302,286,16,294,8,22,42,64,54,60,34,16,10,0,4,167,115,286
20210920,20SEP2021:00:00:00,UFU TORNU,216,177,324,55,14,393,325,68,327,66,76,51,53,75,66,33,19,20,0,8,229,83,325
20210920,20SEP2021:00:00:00,UFU VELEZ SARSFIELD,131,124,188,58,9,255,213,42,253,2,3,15,38,64,58,29,33,15,0,0,152,61,213
20210920,20SEP2021:00:00:00,UFU ZUBIZARRETA,169,154,192,86,45,323,321,2,323,0,0,45,58,63,45,53,37,22,0,3,230,88,321
20210921,21SEP2021:00:00:00,UFU ALVAREZ,165,106,218,38,15,271,225,46,239,32,40,12,40,59,50,28,24,18,0,0,164,61,225
20210921,21SEP2021:00:00:00,UFU ARGERICH,62,42,66,38,0,104,78,26,80,24,18,3,18,7,17,16,13,12,0,2,43,32,78
20210921,21SEP2021:00:00:00,UFU BORDA-MOYANO,21,23,19,22,3,44,40,4,40,4,0,6,5,12,4,10,5,2,0,1,25,14,40
20210921,21SEP2021:00:00:00,UFU DURAND,107,87,169,16,9,194,126,68,128,66,15,19,42,43,32,21,12,10,0,5,69,52,126
20210921,21SEP2021:00:00:00,UFU ELIZALDE,140,101,88,146,7,241,179,62,223,18,138,64,10,17,7,2,3,0,0,0,121,58,179
20211115,15NOV2021:00:00:00,UFU PIROVANO,201,131,263,28,41,332,312,20,320,12,0,17,53,96,84,42,23,17,0,8,179,125,312
20211115,15NOV2021:00:00:00,UFU PIÑERO,109,65,120,39,15,174,166,8,166,8,68,36,10,20,15,12,9,4,0,0,126,40,166
20211115,15NOV2021:00:00:00,UFU RAMOS MEJIA,103,83,130,31,25,186,180,6,184,2,3,9,32,65,24,23,19,11,0,4,104,72,180
20211115,15NOV2021:00:00:00,UFU RIVADAVIA,156,107,185,54,24,263,247,16,249,14,0,10,49,70,51,38,28,17,0,7,143,97,247
20211115,15NOV2021:00:00:00,UFU SANTOJANNI,173,105,165,97,16,278,236,42,272,6,9,14,47,66,61,32,24,25,0,16,133,87,236
20211115,15NOV2021:00:00:00,UFU TORNU,151,93,202,28,14,244,194,50,200,44,27,31,24,58,39,36,21,8,0,6,124,64,194
20211115,15NOV2021:00:00:00,UFU VELEZ SARSFIELD,122,137,176,74,9,259,251,8,257,2,0,17,53,60,47,37,21,24,0,3,175,73,251
20211115,15NOV2021:00:00:00,UFU ZUBIZARRETA,198,159,228,83,46,357,353,4,355,2,0,34,59,67,90,48,32,27,0,3,253,97,353
20211116,16NOV2021:00:00:00,UFU ALVAREZ,185,155,285,36,19,340,322,18,324,16,38,37,70,65,34,54,35,7,0,8,226,88,322
20211116,16NOV2021:00:00:00,UFU ARGERICH,57,50,69,35,3,107,91,16,97,10,22,7,14,15,20,6,17,6,0,3,49,39,91
20211116,16NOV2021:00:00:00,UFU BORDA-MOYANO,50,39,64,22,3,89,75,14,75,14,0,23,9,19,21,10,5,2,0,0,45,29,75
20211116,16NOV2021:00:00:00,UFU DURAND,133,95,203,10,15,228,220,8,220,8,0,12,64,73,35,20,20,4,0,9,118,93,220
20211116,16NOV2021:00:00:00,UFU ELIZALDE,101,78,50,127,2,179,125,54,171,8,127,48,2,0,0,0,1,1,0,1,68,56,125
20211116,16NOV2021:00:00:00,UFU FERNANDEZ,84,45,96,16,17,129,125,4,127,2,0,2,40,25,26,17,10,9,0,5,73,47,125
20211116,16NOV2021:00:00:00,UFU FERRER,78,68,80,61,5,146,140,6,142,4,0,4,22,36,31,30,14,9,0,1,100,39,140
20211116,16NOV2021:00:00:00,UFU GRIERSON,60,53,61,27,25,113,105,8,105,8,2,16,33,14,28,13,3,4,0,2,51,51,105
20211116,16NOV2021:00:00:00,UFU GUTIERREZ,126,118,123,116,5,244,218,26,238,6,138,61,3,19,11,6,3,3,0,1,130,87,218
20211116,16NOV2021:00:00:00,UFU MUÑIZ,154,140,171,101,22,294,224,70,242,52,2,21,51,70,63,46,33,8,0,8,152,64,224
20211116,16NOV2021:00:00:00,UFU PENNA,72,31,62,35,6,103,99,4,101,2,20,11,19,18,12,14,9,0,0,1,67,31,99
20211116,16NOV2021:00:00:00,UFU PIROVANO,174,103,209,21,47,277,267,10,275,2,0,15,58,82,56,34,27,5,0,3,155,109,267
20211116,16NOV2021:00:00:00,UFU PIÑERO,102,107,171,24,14,209,207,2,207,2,64,26,38,45,21,1,14,0,0,1,154,52,207
20211116,16NOV2021:00:00:00,UFU RAMOS MEJIA,86,63,102,27,20,149,135,14,137,12,10,13,36,41,27,9,9,4,0,1,80,52,135
20211116,16NOV2021:00:00:00,UFU RIVADAVIA,149,114,191,40,32,263,253,10,253,10,0,13,72,69,42,17,33,17,0,19,135,99,253
20211116,16NOV2021:00:00:00,UFU SANTOJANNI,118,87,136,62,7,205,199,6,203,2,6,23,35,34,40,29,20,18,0,9,112,78,199
20211116,16NOV2021:00:00:00,UFU TORNU,131,104,188,36,11,235,195,40,195,40,17,20,36,36,66,21,28,11,0,4,112,71,195
20211116,16NOV2021:00:00:00,UFU VELEZ SARSFIELD,166,147,249,44,20,313,305,8,305,8,0,31,50,72,59,34,32,35,0,8,206,91,305
20211116,16NOV2021:00:00:00,UFU ZUBIZARRETA,165,132,193,84,20,297,273,24,297,0,0,29,62,33,67,39,43,24,0,6,198,69,273
20211117,17NOV2021:00:00:00,UFU ALVAREZ,156,157,244,35,34,313,303,10,303,10,32,30,47,70,45,36,25,28,0,4,218,81,303
20211117,17NOV2021:00:00:00,UFU ARGERICH,71,48,78,41,0,119,95,24,99,20,17,12,18,37,5,15,7,8,0,4,51,39,95
20211117,17NOV2021:00:00:00,UFU BORDA-MOYANO,47,24,41,30,0,71,63,8,65,6,1,6,15,12,17,11,3,6,0,0,39,24,63
20211117,17NOV2021:00:00:00,UFU DURAND,130,89,192,14,13,219,201,18,201,18,0,16,50,59,46,25,18,5,0,12,105,84,201
20211117,17NOV2021:00:00:00,UFU ELIZALDE,76,81,54,93,10,157,145,12,155,2,113,35,3,4,2,0,0,0,0,0,87,58,145
20211117,17NOV2021:00:00:00,UFU FERNANDEZ,97,68,130,18,17,165,143,22,155,10,0,4,17,56,47,19,14,8,0,4,83,55,143
20211117,17NOV2021:00:00:00,UFU FERRER,58,29,55,32,0,87,87,0,87,0,0,0,5,26,29,16,9,2,0,1,63,23,87
20211117,17NOV2021:00:00:00,UFU GRIERSON,85,87,109,40,23,172,172,0,172,0,0,13,41,46,18,34,13,7,0,4,122,44,172
20211117,17NOV2021:00:00:00,UFU GUTIERREZ,106,113,120,85,14,219,199,20,209,10,152,42,5,6,6,8,0,0,0,4,103,92,199
20211117,17NOV2021:00:00:00,UFU MUÑIZ,118,119,96,118,23,237,193,44,207,30,10,13,48,55,33,48,19,11,0,3,131,58,193
20211117,17NOV2021:00:00:00,UFU PENNA,61,51,62,50,0,112,104,8,104,8,36,13,21,11,12,14,5,0,0,4,74,26,104
20211117,17NOV2021:00:00:00,UFU PIROVANO,192,149,267,45,29,341,293,48,337,4,0,16,62,73,59,56,32,43,0,13,162,118,293
20211117,17NOV2021:00:00:00,UFU PIÑERO,147,143,221,49,20,290,274,16,276,14,77,35,32,51,33,39,20,3,0,2,197,74,274
20211117,17NOV2021:00:00:00,UFU RAMOS MEJIA,109,73,141,22,19,182,168,14,172,10,15,11,38,49,18,19,17,15,0,3,97,68,168
20211117,17NOV2021:00:00:00,UFU RIVADAVIA,148,95,194,30,19,243,227,16,231,12,0,9,60,75,42,25,21,11,0,4,127,96,227
20211117,17NOV2021:00:00:00,UFU SANTOJANNI,111,80,107,76,8,191,187,4,191,0,4,19,29,50,28,23,16,22,0,10,101,76,187
20211117,17NOV2021:00:00:00,UFU TORNU,141,96,202,28,7,237,203,34,203,34,29,17,18,76,47,28,15,7,0,6,123,74,203
20211117,17NOV2021:00:00:00,UFU VELEZ SARSFIELD,171,123,232,53,9,294,268,26,290,4,2,12,45,73,62,31,47,22,0,11,179,78,268
20211117,17NOV2021:00:00:00,UFU ZUBIZARRETA,114,86,123,59,18,200,198,2,198,2,0,23,40,32,38,26,16,25,0,5,141,52,198
20211118,18NOV2021:00:00:00,UFU ALVAREZ,207,172,318,30,31,379,346,33,367,12,64,21,79,59,70,46,29,11,0,6,240,100,346
20211118,18NOV2021:00:00:00,UFU ARGERICH,46,55,65,32,4,101,84,17,91,10,8,6,13,30,23,10,7,4,0,4,43,37,84
20211118,18NOV2021:00:00:00,UFU BORDA-MOYANO,54,18,41,27,4,72,70,2,70,2,0,21,10,10,9,12,8,2,0,1,44,25,70
20211118,18NOV2021:00:00:00,UFU DURAND,157,96,239,8,6,253,235,18,247,6,0,7,49,73,50,32,19,23,0,12,134,89,235
20211118,18NOV2021:00:00:00,UFU ELIZALDE,86,102,63,113,12,188,143,45,178,10,153,22,2,4,5,0,1,1,0,0,61,82,143
20211118,18NOV2021:00:00:00,UFU FERNANDEZ,116,75,143,43,5,191,142,49,177,14,0,7,38,50,41,28,16,11,0,7,79,56,142
20211118,18NOV2021:00:00:00,UFU FERRER,91,56,96,49,2,147,122,25,141,6,0,0,39,41,30,16,7,14,0,3,82,37,122
20211118,18NOV2021:00:00:00,UFU GRIERSON,105,60,111,34,20,165,153,12,165,0,0,10,41,40,38,18,8,10,0,8,107,38,153
20211118,18NOV2021:00:00:00,UFU GUTIERREZ,98,85,99,84,0,183,151,32,181,2,115,20,11,16,5,6,10,0,0,1,84,66,151
20211118,18NOV2021:00:00:00,UFU MUÑIZ,111,139,121,100,29,250,184,66,214,36,1,22,47,62,50,38,24,6,0,10,124,50,184
20211118,18NOV2021:00:00:00,UFU PENNA,72,40,74,36,2,112,108,4,108,4,12,19,20,25,3,21,9,3,0,4,73,31,108
20211118,18NOV2021:00:00:00,UFU PIROVANO,217,176,315,40,38,393,315,78,383,10,0,11,78,116,75,58,28,27,0,16,176,123,315
20211118,18NOV2021:00:00:00,UFU PIÑERO,109,74,153,23,7,183,166,17,181,2,61,11,20,28,37,6,12,8,0,0,122,42,166
20211118,18NOV2021:00:00:00,UFU RAMOS MEJIA,113,83,146,26,24,196,166,30,182,14,5,13,35,42,51,23,20,7,0,2,102,61,166
20211118,18NOV2021:00:00:00,UFU RIVADAVIA,175,108,213,46,24,283,236,47,247,36,0,8,85,82,39,26,20,23,0,10,130,96,236
20211118,18NOV2021:00:00:00,UFU SANTOJANNI,164,129,177,92,24,293,237,56,289,4,0,25,61,74,66,36,28,3,0,19,128,90,237
20211118,18NOV2021:00:00:00,UFU TORNU,131,131,212,41,9,262,220,42,220,42,26,25,32,44,58,41,20,16,0,11,133,73,220
20211118,18NOV2021:00:00:00,UFU VELEZ SARSFIELD,142,136,224,47,7,278,241,37,274,4,0,16,50,43,46,68,37,18,0,6,165,70,241
20211223,23DEC2021:00:00:00,UFU ARGERICH,160,127,179,84,24,287,281,6,281,6,0,12,103,78,27,39,16,12,0,41,157,81,281
20211223,23DEC2021:00:00:00,UFU BORDA-MOYANO,306,264,333,173,64,570,454,116,454,116,0,26,127,143,128,88,41,17,0,28,327,99,454
20211223,23DEC2021:00:00:00,UFU DURAND,304,190,401,37,56,494,482,12,482,12,0,17,179,129,67,59,29,14,0,114,244,124,482
20211223,23DEC2021:00:00:00,UFU ELIZALDE,169,124,147,128,18,293,275,18,281,12,116,101,5,30,33,4,4,0,0,15,189,71,275
20211223,23DEC2021:00:00:00,UFU FERNANDEZ,440,376,680,48,88,816,676,140,792,24,0,15,277,284,114,76,24,26,0,122,372,182,676
20211223,23DEC2021:00:00:00,UFU FERRER,193,154,217,103,27,347,331,16,331,16,0,1,89,114,67,27,42,7,0,69,185,77,331
20211223,23DEC2021:00:00:00,UFU GRIERSON,272,211,254,168,61,483,473,10,477,6,0,32,175,100,76,60,23,17,0,85,259,126,473
20211223,23DEC2021:00:00:00,UFU GUTIERREZ,477,372,645,107,97,849,829,20,829,20,346,253,21,89,74,42,18,6,0,49,594,181,829
20211223,23DEC2021:00:00:00,UFU MUÑIZ,583,540,638,355,130,1123,1052,71,1073,50,19,51,337,310,184,115,62,45,0,111,726,215,1052
20211223,23DEC2021:00:00:00,UFU PENNA,199,172,265,73,33,371,363,8,363,8,8,13,111,101,68,46,22,2,0,67,220,76,363
20211223,23DEC2021:00:00:00,UFU PIROVANO,511,463,753,84,137,974,927,47,956,18,0,64,299,298,99,98,65,51,0,242,449,236,927
20211223,23DEC2021:00:00:00,UFU PIÑERO,386,321,558,80,69,707,685,22,687,20,53,47,209,141,116,89,35,17,0,115,440,130,685
20211223,23DEC2021:00:00:00,UFU RAMOS MEJIA,372,329,513,82,106,701,643,58,645,56,7,21,252,195,97,54,50,25,0,128,377,137,643
20211223,23DEC2021:00:00:00,UFU RIVADAVIA,503,368,623,88,160,871,852,19,857,14,0,22,349,242,88,66,84,20,0,142,438,269,852
20211223,23DEC2021:00:00:00,UFU SANTOJANNI,419,312,445,217,69,731,702,29,721,10,0,45,248,193,95,54,47,49,0,192,342,168,702
20211223,23DEC2021:00:00:00,UFU TORNU,689,587,1049,114,113,1276,1208,68,1208,68,31,91,316,355,254,113,65,51,0,177,723,298,1208
20211223,23DEC2021:00:00:00,UFU VELEZ SARSFIELD,256,265,441,63,17,521,511,10,513,8,0,59,160,115,79,61,47,0,0,89,314,108,511
20211223,23DEC2021:00:00:00,UFU ZUBIZARRETA,225,209,314,74,46,434,412,22,434,0,6,38,102,87,91,36,37,37,0,40,255,117,412
20211224,24DEC2021:00:00:00,UFU ALVAREZ,332,209,436,54,51,541,517,24,517,24,32,39,134,130,85,69,30,22,0,72,323,122,517
20211224,24DEC2021:00:00:00,UFU ARGERICH,106,60,116,43,7,166,156,10,156,10,1,14,45,37,36,14,5,14,0,41,63,52,156
20211224,24DEC2021:00:00:00,UFU BORDA-MOYANO,167,109,173,68,35,276,236,40,236,40,4,10,70,73,70,37,6,6,0,30,139,67,236
20211224,24DEC2021:00:00:00,UFU DURAND,293,198,463,19,9,491,471,20,471,20,2,31,137,153,52,59,34,23,0,103,241,127,471
20211224,24DEC2021:00:00:00,UFU ELIZALDE,63,66,46,68,15,129,121,8,129,0,42,42,17,19,7,0,2,0,0,21,67,33,121
20211224,24DEC2021:00:00:00,UFU FERNANDEZ,231,211,385,34,23,442,367,75,434,8,1,27,147,138,62,30,23,14,0,96,159,108,367
20211224,24DEC2021:00:00:00,UFU FERRER,215,155,268,94,8,370,351,19,360,10,0,1,93,122,74,38,35,7,0,61,215,75,351
20211224,24DEC2021:00:00:00,UFU GRIERSON,204,170,266,83,25,374,368,6,370,4,0,15,131,57,52,53,54,12,0,52,238,76,368
20211224,24DEC2021:00:00:00,UFU GUTIERREZ,250,207,392,55,10,457,449,8,449,8,185,162,12,32,40,18,4,4,0,35,326,84,449
20211224,24DEC2021:00:00:00,UFU MUÑIZ,297,270,320,170,77,567,532,35,561,6,2,50,168,111,91,78,35,32,0,105,314,113,532
20211224,24DEC2021:00:00:00,UFU PENNA,98,98,140,44,12,196,182,14,182,14,5,7,53,38,41,21,16,15,0,37,107,38,182
20211224,24DEC2021:00:00:00,UFU PIROVANO,247,181,306,47,75,428,402,26,422,6,0,29,105,130,69,34,36,25,0,87,199,116,402
20211224,24DEC2021:00:00:00,UFU PIÑERO,294,183,392,76,9,477,471,6,471,6,0,62,151,100,50,58,40,16,0,48,325,93,471
20211224,24DEC2021:00:00:00,UFU RAMOS MEJIA,198,139,235,59,43,337,321,16,321,16,8,30,101,73,43,56,13,13,0,45,204,70,321
20211224,24DEC2021:00:00:00,UFU RIVADAVIA,161,91,200,21,31,252,252,0,252,0,0,5,106,66,34,19,18,4,0,31,116,105,252
20211224,24DEC2021:00:00:00,UFU SANTOJANNI,330,302,329,269,34,632,616,16,626,6,9,50,222,106,75,97,50,23,0,184,267,165,616
20211224,24DEC2021:00:00:00,UFU TORNU,220,211,354,62,15,431,407,24,407,24,7,30,104,89,90,55,37,19,0,94,214,99,407
20211224,24DEC2021:00:00:00,UFU VELEZ SARSFIELD,137,105,185,38,19,242,238,4,238,4,0,35,55,45,38,24,37,8,0,49,132,57,238
20211224,24DEC2021:00:00:00,UFU ZUBIZARRETA,94,39,92,41,0,133,133,0,133,0,0,11,39,30,9,20,17,7,0,22,55,56,133
20211225,25DEC2021:00:00:00,UFU ALVAREZ,178,165,313,26,4,343,337,6,337,6,10,29,85,58,50,53,41,17,0,86,170,81,337
20211225,25DEC2021:00:00:00,UFU ARGERICH,15,0,9,4,2,15,15,0,15,0,0,2,5,4,2,2,0,0,0,6,4,5,15
20211225,25DEC2021:00:00:00,UFU BORDA-MOYANO,115,116,130,99,2,231,231,0,231,0,0,30,52,42,44,42,15,6,0,72,98,61,231
20211225,25DEC2021:00:00:00,UFU DURAND,149,146,271,14,10,295,293,2,293,2,0,17,73,89,48,29,27,12,0,99,112,82,293
20211225,25DEC2021:00:00:00,UFU ELIZALDE,39,22,22,33,6,61,61,0,61,0,33,22,0,3,3,0,0,0,0,6,38,17,61
20211225,25DEC2021:00:00:00,UFU FERNANDEZ,8,12,18,0,2,20,0,20,20,0,0,2,3,11,4,0,0,0,0,0,0,0,0
20211225,25DEC2021:00:00:00,UFU MUÑIZ,225,216,223,192,26,441,399,42,435,6,3,38,141,84,70,75,22,8,0,76,246,77,399
20211225,25DEC2021:00:00:00,UFU PIROVANO,209,251,338,53,69,460,445,15,450,10,0,40,139,129,76,39,17,20,0,144,195,106,445
20211225,25DEC2021:00:00:00,UFU PIÑERO,142,124,202,58,6,266,266,0,266,0,0,18,80,47,49,45,19,8,0,81,133,51,266
20211225,25DEC2021:00:00:00,UFU RAMOS MEJIA,153,127,249,8,23,280,271,9,274,6,0,24,62,95,30,37,30,2,0,81,138,51,271
20211225,25DEC2021:00:00:00,UFU RIVADAVIA,89,77,135,9,22,166,166,0,166,0,0,6,39,47,14,23,26,11,0,30,31,105,166
20211225,25DEC2021:00:00:00,UFU SANTOJANNI,351,282,366,200,67,633,625,8,625,8,0,26,181,157,137,73,38,21,0,247,224,154,625
20211225,25DEC2021:00:00:00,UFU TORNU,148,144,238,28,26,292,0,292,0,292,4,27,65,76,41,46,15,18,0,0,0,0,0
20211225,25DEC2021:00:00:00,UFU ZUBIZARRETA,121,103,161,57,6,224,222,2,224,0,0,28,53,41,22,43,17,20,0,48,113,61,222
20211226,26DEC2021:00:00:00,UFU ALVAREZ,631,470,917,107,77,1101,1042,59,1042,59,18,149,292,208,182,109,115,28,0,304,501,237,1042
20211226,26DEC2021:00:00:00,UFU ARGERICH,53,44,69,25,3,97,97,0,97,0,4,10,30,16,15,6,11,5,0,23,33,41,97
20211226,26DEC2021:00:00:00,UFU BORDA-MOYANO,264,183,243,163,41,447,429,18,429,18,0,34,132,104,86,55,32,4,0,122,196,111,429
20211226,26DEC2021:00:00:00,UFU DURAND,372,292,597,48,19,664,636,28,636,28,0,46,194,191,83,82,36,32,0,339,139,158,636
20211226,26DEC2021:00:00:00,UFU ELIZALDE,149,100,105,128,16,249,236,13,245,4,83,123,9,20,12,2,0,0,0,26,156,54,236
20211226,26DEC2021:00:00:00,UFU FERNANDEZ,342,278,511,91,18,620,584,36,584,36,2,39,162,189,92,59,38,39,0,207,235,139,584
20211226,26DEC2021:00:00:00,UFU FERRER,120,97,104,113,0,217,217,0,217,0,0,4,49,43,41,41,24,15,0,57,114,46,217
20211226,26DEC2021:00:00:00,UFU GRIERSON,311,264,321,194,60,575,437,138,437,138,0,42,143,145,120,80,29,16,0,125,212,99,437
20211226,26DEC2021:00:00:00,UFU GUTIERREZ,354,306,487,113,60,660,648,12,648,12,183,330,11,37,64,29,6,0,0,111,410,126,648
20211226,26DEC2021:00:00:00,UFU MUÑIZ,445,495,471,371,98,940,849,91,922,18,16,89,261,292,130,91,40,21,0,170,509,170,849
20211226,26DEC2021:00:00:00,UFU PENNA,120,136,127,127,2,256,252,4,252,4,0,8,69,56,51,50,8,14,0,75,119,58,252
20211226,26DEC2021:00:00:00,UFU PIROVANO,465,393,647,89,122,858,837,21,846,12,16,56,240,244,99,104,45,54,0,248,301,288,837
20210728,28JUL2021:00:00:00,UFU ZUBIZARRETA,29,43,48,15,9,72,72,0,72,0,0,0,19,21,7,10,15,0,0,2,52,18,72
20210729,29JUL2021:00:00:00,UFU ALVAREZ,143,113,198,40,18,256,240,16,240,16,18,27,57,53,61,20,12,8,0,24,127,89,240
20210729,29JUL2021:00:00:00,UFU ARGERICH,49,49,58,34,6,98,88,10,90,8,4,5,26,22,15,6,14,6,0,7,44,37,88
20210729,29JUL2021:00:00:00,UFU BORDA-MOYANO,47,15,42,15,5,62,62,0,62,0,0,1,12,18,13,11,7,0,0,2,36,24,62
20210729,29JUL2021:00:00:00,UFU DURAND,92,85,146,16,15,177,177,0,177,0,0,6,46,59,31,20,7,8,0,11,98,68,177
20210729,29JUL2021:00:00:00,UFU ELIZALDE,157,66,67,155,1,223,203,20,209,14,135,42,19,21,6,0,0,0,0,0,102,101,203
20210729,29JUL2021:00:00:00,UFU FERNANDEZ,72,70,98,12,32,142,134,8,134,8,0,2,41,42,28,14,8,7,0,21,66,47,134
20210729,29JUL2021:00:00:00,UFU FERRER,44,50,55,37,2,94,90,4,90,4,0,0,27,36,13,10,5,3,0,12,55,23,90
20210729,29JUL2021:00:00:00,UFU GRIERSON,128,102,116,92,22,230,220,10,220,10,0,20,62,55,44,31,12,6,0,10,149,61,220
20210729,29JUL2021:00:00:00,UFU GUTIERREZ,113,81,76,102,16,194,180,14,190,4,104,20,25,30,12,0,3,0,0,4,124,52,180
20210729,29JUL2021:00:00:00,UFU MUÑIZ,86,159,85,135,25,245,211,34,217,28,0,12,49,83,45,33,19,4,0,11,138,62,211
20210729,29JUL2021:00:00:00,UFU PENNA,69,57,81,37,8,126,118,8,122,4,0,2,26,43,24,20,4,7,0,5,81,32,118
20210729,29JUL2021:00:00:00,UFU PIROVANO,120,120,191,16,33,240,218,22,234,6,0,9,39,57,64,29,33,9,0,16,113,89,218
20210729,29JUL2021:00:00:00,UFU PIÑERO,78,91,99,43,27,169,155,14,159,10,0,4,58,51,18,15,16,7,0,5,107,41,155
20210729,29JUL2021:00:00:00,UFU RAMOS MEJIA,145,136,200,39,42,281,261,20,265,16,9,17,79,76,48,25,13,14,0,18,164,79,261
20210729,29JUL2021:00:00:00,UFU RIVADAVIA,128,86,152,32,30,214,178,36,180,34,0,5,73,51,45,19,17,4,0,12,93,72,178
20210729,29JUL2021:00:00:00,UFU SANTOJANNI,173,173,188,127,31,346,338,8,342,4,2,19,70,102,75,40,30,8,0,26,219,93,338
20210729,29JUL2021:00:00:00,UFU TORNU,142,91,168,49,16,233,215,18,215,18,18,15,37,52,56,36,14,5,0,15,142,57,215
20210729,29JUL2021:00:00:00,UFU VELEZ SARSFIELD,133,117,175,64,11,250,216,34,248,2,0,3,42,93,46,26,28,12,0,8,140,68,216
20210729,29JUL2021:00:00:00,UFU ZUBIZARRETA,95,56,93,53,5,151,147,4,151,0,0,11,61,31,22,13,3,10,0,8,104,35,147
20210730,30JUL2021:00:00:00,UFU ALVAREZ,199,135,245,60,29,334,318,16,318,16,38,24,72,79,39,48,28,6,0,14,222,82,318
20210730,30JUL2021:00:00:00,UFU ARGERICH,46,16,33,26,3,62,54,8,54,8,5,2,14,9,12,12,3,5,0,6,27,21,54
20210730,30JUL2021:00:00:00,UFU BORDA-MOYANO,37,17,29,25,0,54,52,2,52,2,0,0,22,17,7,5,0,3,0,3,33,16,52
20210730,30JUL2021:00:00:00,UFU DURAND,112,54,122,26,18,166,160,6,160,6,5,5,46,40,28,21,12,9,0,14,86,58,160
20210730,30JUL2021:00:00:00,UFU ELIZALDE,120,77,47,150,0,197,163,34,185,12,142,23,15,9,3,3,2,0,0,8,87,68,163
20210730,30JUL2021:00:00:00,UFU FERNANDEZ,85,85,134,24,12,170,138,32,146,24,0,1,58,58,28,13,10,2,0,7,77,54,138
20210730,30JUL2021:00:00:00,UFU FERRER,102,76,94,76,8,178,174,4,174,4,0,0,49,44,52,15,11,7,0,11,122,41,174
20210730,30JUL2021:00:00:00,UFU GRIERSON,111,83,112,32,50,194,186,8,186,8,0,3,57,54,43,24,10,3,0,13,119,51,186
20210730,30JUL2021:00:00:00,UFU GUTIERREZ,108,77,95,75,15,185,175,10,185,0,83,34,16,21,23,5,3,0,0,5,120,49,175
20210730,30JUL2021:00:00:00,UFU MUÑIZ,107,127,116,102,16,234,200,34,208,26,0,12,52,55,45,37,25,8,0,7,136,57,200
20210730,30JUL2021:00:00:00,UFU PENNA,78,31,57,38,14,109,103,6,109,0,2,5,28,29,14,22,7,2,0,6,69,28,103
20210730,30JUL2021:00:00:00,UFU PIROVANO,135,114,196,28,25,249,195,54,245,4,2,6,59,70,44,27,13,28,0,24,89,82,195
20210730,30JUL2021:00:00:00,UFU PIÑERO,74,78,102,33,17,152,150,2,150,2,0,6,44,36,24,31,3,8,0,7,103,40,150
20210730,30JUL2021:00:00:00,UFU RAMOS MEJIA,124,98,133,60,29,222,206,16,206,16,4,9,42,51,39,28,37,12,0,12,127,66,206
20210730,30JUL2021:00:00:00,UFU RIVADAVIA,156,105,167,55,39,261,235,26,255,6,0,9,78,82,36,20,18,18,0,21,117,96,235
20210730,30JUL2021:00:00:00,UFU SANTOJANNI,240,195,222,174,39,435,401,34,429,6,7,35,82,129,80,48,42,12,0,23,274,104,401
20210730,30JUL2021:00:00:00,UFU TORNU,104,101,147,48,10,205,187,18,187,18,16,0,43,49,31,21,28,17,0,15,123,47,187
20210730,30JUL2021:00:00:00,UFU VELEZ SARSFIELD,133,88,152,58,11,221,211,10,217,4,0,9,47,48,48,56,13,0,0,25,127,59,211
20210730,30JUL2021:00:00:00,UFU ZUBIZARRETA,88,83,121,30,20,171,171,0,171,0,0,4,29,57,37,10,25,9,0,5,116,50,171
20210731,31JUL2021:00:00:00,UFU ALVAREZ,161,169,260,41,29,330,298,32,298,32,16,14,44,91,70,40,47,8,0,13,209,76,298
20210731,31JUL2021:00:00:00,UFU ARGERICH,6,4,6,4,0,10,10,0,10,0,0,0,2,2,6,0,0,0,0,1,3,6,10
20210731,31JUL2021:00:00:00,UFU BORDA-MOYANO,44,13,34,20,3,57,53,4,53,4,0,5,7,9,15,7,8,6,0,2,31,20,53
20210731,31JUL2021:00:00:00,UFU DURAND,114,60,149,12,13,174,168,6,168,6,4,9,32,50,38,17,12,12,0,14,79,75,168
20210731,31JUL2021:00:00:00,UFU ELIZALDE,97,108,68,134,3,205,137,68,173,32,141,24,14,14,7,4,1,0,0,6,83,48,137
20210731,31JUL2021:00:00:00,UFU FERNANDEZ,117,86,154,33,16,203,195,8,195,8,2,2,62,46,26,31,16,18,0,10,123,62,195
20210731,31JUL2021:00:00:00,UFU FERRER,130,98,125,87,16,228,210,18,218,10,0,4,57,74,44,20,24,5,0,9,145,56,210
20210731,31JUL2021:00:00:00,UFU GRIERSON,111,95,114,64,28,206,184,22,204,2,0,3,63,51,35,20,26,8,0,13,121,49,184
20210731,31JUL2021:00:00:00,UFU GUTIERREZ,126,87,159,45,9,213,185,28,191,22,92,41,19,27,18,11,2,3,0,4,128,53,185
20210731,31JUL2021:00:00:00,UFU MUÑIZ,124,119,103,115,25,243,215,28,227,16,0,0,66,56,47,29,33,12,0,13,140,62,215
20210731,31JUL2021:00:00:00,UFU PENNA,30,35,54,9,2,65,61,4,63,2,0,6,16,16,9,4,11,3,0,3,40,18,61
20210731,31JUL2021:00:00:00,UFU PIROVANO,104,81,134,34,17,185,171,14,175,10,0,7,52,47,43,17,12,7,0,9,92,70,171
20210731,31JUL2021:00:00:00,UFU PIÑERO,94,80,118,44,12,174,158,16,158,16,0,0,27,50,41,21,29,6,0,9,110,37,158
20210731,31JUL2021:00:00:00,UFU RAMOS MEJIA,140,126,202,37,27,266,248,18,258,8,10,10,63,88,45,33,11,6,0,16,164,68,248
20210731,31JUL2021:00:00:00,UFU RIVADAVIA,126,99,172,25,28,225,195,30,195,30,0,10,55,71,21,33,25,10,0,22,90,83,195
20210731,31JUL2021:00:00:00,UFU SANTOJANNI,220,139,188,141,30,359,339,20,355,4,0,16,61,83,82,65,39,13,0,12,241,86,339
20210731,31JUL2021:00:00:00,UFU TORNU,125,131,171,41,44,256,242,14,242,14,3,12,42,67,58,38,22,14,0,13,159,70,242
20210731,31JUL2021:00:00:00,UFU VELEZ SARSFIELD,177,125,225,48,29,302,290,12,296,6,0,13,47,64,63,44,47,24,0,26,189,75,290
20210731,31JUL2021:00:00:00,UFU ZUBIZARRETA,191,131,216,98,8,322,308,14,322,0,0,15,66,72,66,54,25,24,0,16,214,78,308
20210801,01AUG2021:00:00:00,UFU ALVAREZ,157,107,192,53,19,264,252,12,252,12,35,16,56,43,45,44,17,8,0,25,154,73,252
20210801,01AUG2021:00:00:00,UFU ARGERICH,40,22,42,18,2,62,62,0,62,0,2,8,10,8,14,12,8,0,0,5,30,27,62
20210801,01AUG2021:00:00:00,UFU BORDA-MOYANO,16,17,18,15,0,33,33,0,33,0,0,0,1,9,16,5,2,0,0,1,23,9,33
20210801,01AUG2021:00:00:00,UFU DURAND,137,95,202,10,20,232,224,8,224,8,4,17,50,44,59,26,15,17,0,13,147,64,224
20210801,01AUG2021:00:00:00,UFU ELIZALDE,96,55,52,99,0,151,107,44,139,12,98,25,12,10,4,2,0,0,0,5,58,44,107
20210801,01AUG2021:00:00:00,UFU FERNANDEZ,108,82,149,25,16,190,180,10,182,8,0,6,46,38,21,43,29,7,0,7,129,44,180
20210801,01AUG2021:00:00:00,UFU FERRER,107,70,88,82,7,177,175,2,175,2,0,2,19,44,57,28,25,2,0,11,121,43,175
20210921,21SEP2021:00:00:00,UFU FERNANDEZ,72,40,93,13,6,112,100,12,104,8,0,9,20,34,24,11,7,7,0,1,56,43,100
20210921,21SEP2021:00:00:00,UFU FERRER,69,19,56,21,11,88,80,8,80,8,0,5,20,23,23,8,6,3,0,0,63,17,80
20210921,21SEP2021:00:00:00,UFU GRIERSON,123,88,131,71,9,211,205,6,205,6,0,20,52,47,40,20,18,14,0,3,152,50,205
20210921,21SEP2021:00:00:00,UFU GUTIERREZ,136,140,143,130,3,276,260,16,274,2,179,57,19,4,9,5,3,0,0,3,180,77,260
20210921,21SEP2021:00:00:00,UFU MUÑIZ,115,72,82,99,6,187,161,26,165,22,6,14,37,51,35,33,11,0,0,2,109,50,161
20210921,21SEP2021:00:00:00,UFU PENNA,88,58,93,51,2,146,142,4,144,2,50,17,17,18,12,15,15,2,0,3,99,40,142
20210921,21SEP2021:00:00:00,UFU PIROVANO,113,88,155,26,20,201,187,14,195,6,0,2,54,53,42,17,22,11,0,0,113,74,187
20210921,21SEP2021:00:00:00,UFU PIÑERO,78,78,117,23,16,156,138,18,140,16,42,25,20,14,19,20,13,3,0,1,98,37,138
20210921,21SEP2021:00:00:00,UFU RAMOS MEJIA,118,99,153,39,25,217,159,58,165,52,20,14,34,57,29,30,20,13,0,2,94,63,159
20210921,21SEP2021:00:00:00,UFU RIVADAVIA,120,51,122,29,20,171,167,4,167,4,1,7,47,49,34,11,13,9,0,4,92,71,167
20210921,21SEP2021:00:00:00,UFU SANTOJANNI,129,71,107,88,5,200,196,4,198,2,2,24,33,38,35,30,24,14,0,0,122,74,196
20210921,21SEP2021:00:00:00,UFU TORNU,143,123,226,30,10,266,228,38,240,26,51,32,28,49,38,31,19,18,0,2,163,61,228
20210921,21SEP2021:00:00:00,UFU VELEZ SARSFIELD,76,107,123,46,14,183,167,16,175,8,0,7,44,44,29,32,19,8,0,4,113,50,167
20210921,21SEP2021:00:00:00,UFU ZUBIZARRETA,129,125,169,65,20,254,250,4,254,0,0,24,35,85,62,19,16,13,0,5,178,67,250
20210922,22SEP2021:00:00:00,UFU ALVAREZ,102,93,152,34,9,195,179,16,179,16,48,16,23,43,27,15,16,7,0,5,110,64,179
20210922,22SEP2021:00:00:00,UFU ARGERICH,97,55,85,59,8,152,135,17,135,17,24,17,24,31,27,16,9,4,0,1,75,59,135
20210922,22SEP2021:00:00:00,UFU BORDA-MOYANO,16,34,38,10,2,50,48,2,48,2,2,6,8,19,10,0,2,3,0,1,31,16,48
20210922,22SEP2021:00:00:00,UFU DURAND,135,89,192,26,6,224,200,24,202,22,42,22,48,31,42,22,11,6,0,7,111,82,200
20210922,22SEP2021:00:00:00,UFU ELIZALDE,134,200,124,203,7,334,304,30,312,22,213,77,16,15,8,5,0,0,0,0,197,107,304
20210922,22SEP2021:00:00:00,UFU FERNANDEZ,107,58,134,17,14,165,145,20,155,10,4,7,43,50,26,24,3,8,0,2,84,59,145
20210922,22SEP2021:00:00:00,UFU FERRER,68,58,66,60,0,126,114,12,118,8,0,0,28,29,42,17,10,0,0,0,84,30,114
20210922,22SEP2021:00:00:00,UFU GRIERSON,101,69,89,65,16,170,138,32,168,2,0,15,42,44,31,23,5,10,0,1,100,37,138
20210922,22SEP2021:00:00:00,UFU GUTIERREZ,106,100,130,74,2,206,192,14,202,4,159,29,5,8,4,0,1,0,0,0,120,72,192
20210922,22SEP2021:00:00:00,UFU MUÑIZ,138,110,116,111,21,248,194,54,200,48,12,33,44,56,52,32,15,4,0,1,133,60,194
20210922,22SEP2021:00:00:00,UFU PENNA,94,71,84,76,5,165,159,6,159,6,35,26,31,26,23,6,8,10,0,0,123,36,159
20210922,22SEP2021:00:00:00,UFU PIROVANO,130,102,186,30,16,232,216,16,232,0,3,22,41,85,27,28,12,14,0,1,134,81,216
20210922,22SEP2021:00:00:00,UFU PIÑERO,151,133,200,60,24,284,266,18,276,8,96,54,30,42,32,14,7,9,0,0,198,68,266
20210922,22SEP2021:00:00:00,UFU RAMOS MEJIA,117,75,134,40,18,192,176,16,186,6,21,24,21,54,30,17,13,12,0,3,102,71,176
20210922,22SEP2021:00:00:00,UFU RIVADAVIA,80,70,112,21,17,150,146,4,146,4,0,10,33,36,29,16,19,7,0,1,86,59,146
20210922,22SEP2021:00:00:00,UFU SANTOJANNI,119,86,128,71,6,205,189,16,201,4,25,34,35,30,17,38,15,11,0,7,111,71,189
20210922,22SEP2021:00:00:00,UFU TORNU,189,102,260,23,8,291,231,60,235,56,48,42,32,61,55,34,9,10,0,4,163,64,231
20210922,22SEP2021:00:00:00,UFU VELEZ SARSFIELD,96,96,145,37,10,192,169,23,186,6,0,12,40,45,35,15,28,17,0,2,124,43,169
20210922,22SEP2021:00:00:00,UFU ZUBIZARRETA,59,67,96,17,13,126,124,2,126,0,0,16,24,22,24,16,8,16,0,1,92,31,124
20210923,23SEP2021:00:00:00,UFU ALVAREZ,178,125,238,45,20,303,277,26,285,18,64,13,38,76,62,19,25,6,0,3,195,79,277
20210923,23SEP2021:00:00:00,UFU ARGERICH,66,43,75,31,3,109,87,22,87,22,13,16,21,22,16,8,9,4,0,1,47,39,87
20210923,23SEP2021:00:00:00,UFU BORDA-MOYANO,56,32,65,23,0,88,84,4,84,4,3,4,15,13,19,18,14,2,0,0,52,32,84
20210923,23SEP2021:00:00:00,UFU DURAND,110,100,186,15,9,210,196,14,198,12,29,17,38,50,45,10,15,6,0,4,101,91,196
20210923,23SEP2021:00:00:00,UFU ELIZALDE,159,157,92,215,9,316,282,34,310,6,216,58,10,17,9,4,0,2,0,0,189,93,282
20210923,23SEP2021:00:00:00,UFU FERNANDEZ,62,77,106,20,13,139,127,12,133,6,0,7,26,46,24,11,13,12,0,2,72,53,127
20210923,23SEP2021:00:00:00,UFU FERRER,41,32,39,26,8,73,67,6,67,6,0,2,19,15,20,5,7,5,0,0,53,14,67
20210923,23SEP2021:00:00:00,UFU GRIERSON,68,60,66,45,17,128,122,6,124,4,0,15,20,36,20,13,18,6,0,1,89,31,122
20210923,23SEP2021:00:00:00,UFU GUTIERREZ,155,159,195,109,10,314,290,24,314,0,209,65,8,18,9,3,2,0,0,2,208,80,290
20210923,23SEP2021:00:00:00,UFU MUÑIZ,99,99,102,79,17,198,160,38,170,28,10,10,34,66,32,24,10,12,0,1,114,45,160
20210923,23SEP2021:00:00:00,UFU PENNA,104,65,106,63,0,169,161,8,161,8,50,26,28,29,16,11,9,0,0,1,116,44,161
20210923,23SEP2021:00:00:00,UFU PIROVANO,99,94,166,8,19,193,183,10,189,4,0,13,42,58,38,19,10,13,0,0,108,75,183
20210923,23SEP2021:00:00:00,UFU PIÑERO,139,120,207,38,14,259,259,0,259,0,89,38,43,16,34,29,6,4,0,0,190,67,259
20210923,23SEP2021:00:00:00,UFU RAMOS MEJIA,122,109,169,38,24,231,209,22,217,14,43,18,33,48,46,18,20,5,0,4,125,78,209
20210923,23SEP2021:00:00:00,UFU RIVADAVIA,102,78,132,29,19,180,124,56,124,56,0,2,49,52,28,13,26,10,0,2,72,50,124
20210923,23SEP2021:00:00:00,UFU SANTOJANNI,110,90,124,65,11,200,188,12,194,6,0,31,29,37,37,31,19,16,0,2,119,67,188
20210923,23SEP2021:00:00:00,UFU TORNU,143,138,234,30,17,281,223,58,225,56,51,32,29,62,69,23,0,15,0,2,162,58,223
20210923,23SEP2021:00:00:00,UFU VELEZ SARSFIELD,119,108,157,31,39,227,213,14,217,10,0,22,47,75,28,19,22,14,0,5,142,66,213
20210923,23SEP2021:00:00:00,UFU ZUBIZARRETA,115,71,114,50,22,186,186,0,186,0,0,25,39,40,30,20,15,17,0,3,131,52,186
20210924,24SEP2021:00:00:00,UFU ALVAREZ,175,97,220,36,16,272,252,20,254,18,42,38,55,40,31,40,19,7,0,1,180,71,252
20210924,24SEP2021:00:00:00,UFU ARGERICH,51,31,53,29,0,82,68,14,68,14,14,2,14,8,20,9,9,6,0,0,40,28,68
20210924,24SEP2021:00:00:00,UFU BORDA-MOYANO,22,21,34,7,2,43,43,0,43,0,2,4,1,12,17,1,4,2,0,0,28,15,43
20210924,24SEP2021:00:00:00,UFU DURAND,115,71,170,8,8,186,144,42,152,34,29,23,21,52,27,14,11,9,0,5,87,52,144
20210924,24SEP2021:00:00:00,UFU ELIZALDE,144,126,92,178,0,270,208,62,224,46,179,57,8,13,9,2,2,0,0,2,127,79,208
20210924,24SEP2021:00:00:00,UFU FERNANDEZ,82,63,106,33,6,145,141,4,143,2,0,5,23,47,28,23,10,9,0,1,89,51,141
20210924,24SEP2021:00:00:00,UFU FERRER,51,36,47,34,6,87,81,6,83,4,0,3,12,42,12,12,0,6,0,0,55,26,81
20210924,24SEP2021:00:00:00,UFU GRIERSON,97,71,104,60,4,168,128,40,168,0,0,25,32,44,31,21,14,1,0,0,95,33,128
20210924,24SEP2021:00:00:00,UFU GUTIERREZ,132,123,171,76,8,255,239,16,255,0,185,40,16,5,5,4,0,0,0,2,167,70,239
20210924,24SEP2021:00:00:00,UFU MUÑIZ,78,122,99,96,5,200,156,44,156,44,0,16,41,67,35,26,9,6,0,0,115,41,156
20210924,24SEP2021:00:00:00,UFU PENNA,37,44,51,28,2,81,77,4,79,2,8,7,14,15,10,18,4,5,0,0,57,20,77
20210924,24SEP2021:00:00:00,UFU PIROVANO,102,60,126,14,22,162,148,14,156,6,0,0,44,28,40,30,15,5,0,1,85,62,148
20210924,24SEP2021:00:00:00,UFU PIÑERO,160,90,221,26,3,250,244,6,244,6,108,43,15,30,21,18,9,6,0,1,178,64,244
20211219,19DEC2021:00:00:00,UFU SANTOJANNI,265,225,224,223,43,490,463,27,480,10,0,34,120,131,71,66,34,34,0,115,213,131,463
20211219,19DEC2021:00:00:00,UFU TORNU,272,191,413,24,26,463,189,274,189,274,27,43,53,115,109,55,53,8,0,20,120,49,189
20211219,19DEC2021:00:00:00,UFU VELEZ SARSFIELD,189,207,297,79,20,396,383,13,392,4,0,16,88,82,90,67,24,29,0,93,188,102,383
20211219,19DEC2021:00:00:00,UFU ZUBIZARRETA,311,219,391,116,23,530,528,2,530,0,0,35,98,113,108,85,46,45,0,44,336,148,528
20211220,20DEC2021:00:00:00,UFU ALVAREZ,518,300,647,115,56,818,762,56,762,56,51,74,199,146,142,96,51,59,0,105,511,146,762
20211220,20DEC2021:00:00:00,UFU ARGERICH,99,117,154,62,0,216,183,33,189,27,9,2,36,73,25,22,28,21,0,32,103,46,183
20211220,20DEC2021:00:00:00,UFU BORDA-MOYANO,143,96,141,76,22,239,223,16,223,16,5,15,36,63,60,33,20,7,0,19,159,45,223
20211220,20DEC2021:00:00:00,UFU DURAND,183,144,300,25,2,327,313,14,321,6,0,30,70,80,60,47,22,18,0,69,163,81,313
20211220,20DEC2021:00:00:00,UFU ELIZALDE,131,109,78,152,10,240,222,18,234,6,152,58,17,4,7,2,0,0,0,7,164,51,222
20211220,20DEC2021:00:00:00,UFU FERNANDEZ,432,272,631,51,22,704,660,44,670,34,0,19,184,233,103,73,51,41,0,152,341,167,660
20211220,20DEC2021:00:00:00,UFU FERRER,82,89,111,54,6,171,166,5,166,5,0,0,61,46,35,17,0,12,0,34,101,31,166
20211220,20DEC2021:00:00:00,UFU GRIERSON,254,199,304,127,22,453,439,14,439,14,0,37,107,88,112,65,25,19,0,75,273,88,439
20211220,20DEC2021:00:00:00,UFU GUTIERREZ,168,150,199,82,37,318,279,39,304,14,186,67,19,20,13,11,0,2,0,16,184,79,279
20211220,20DEC2021:00:00:00,UFU MUÑIZ,399,369,492,229,47,768,716,52,730,38,2,36,165,225,176,71,74,19,0,58,508,150,716
20211220,20DEC2021:00:00:00,UFU PENNA,116,101,160,51,6,217,206,11,209,8,19,13,48,43,50,25,8,11,0,31,128,46,206
20211220,20DEC2021:00:00:00,UFU PIROVANO,581,532,924,85,104,1113,1078,35,1095,18,0,48,331,328,187,116,67,36,0,246,566,266,1078
20211220,20DEC2021:00:00:00,UFU PIÑERO,68,51,108,9,2,119,105,14,115,4,48,46,3,9,3,2,4,4,0,9,75,20,105
20211220,20DEC2021:00:00:00,UFU RAMOS MEJIA,311,263,457,64,53,574,556,18,558,16,13,18,122,164,101,89,36,31,0,74,343,139,556
20211220,20DEC2021:00:00:00,UFU RIVADAVIA,478,323,590,114,97,801,763,38,779,22,0,34,278,213,118,66,63,29,0,148,381,230,763
20211220,20DEC2021:00:00:00,UFU SANTOJANNI,310,232,323,202,17,542,519,23,536,6,6,37,102,135,72,112,38,40,0,79,311,129,519
20211220,20DEC2021:00:00:00,UFU TORNU,437,364,671,118,12,801,656,145,659,142,27,58,194,237,135,80,44,26,0,151,361,144,656
20211220,20DEC2021:00:00:00,UFU VELEZ SARSFIELD,256,241,397,75,25,497,478,19,489,8,0,41,137,80,89,86,44,20,0,74,307,97,478
20211220,20DEC2021:00:00:00,UFU ZUBIZARRETA,123,81,145,40,19,204,204,0,204,0,0,12,43,57,29,33,21,9,0,17,122,65,204
20211221,21DEC2021:00:00:00,UFU ALVAREZ,551,488,831,116,92,1039,989,50,989,50,21,56,336,278,130,102,82,34,0,147,636,206,989
20211221,21DEC2021:00:00:00,UFU ARGERICH,148,96,121,114,9,244,226,18,226,18,2,12,76,61,24,28,23,18,0,49,113,64,226
20211221,21DEC2021:00:00:00,UFU BORDA-MOYANO,127,110,125,80,32,237,205,32,205,32,7,32,47,66,45,17,18,5,0,11,146,48,205
20211221,21DEC2021:00:00:00,UFU DURAND,184,119,270,15,18,303,293,10,297,6,0,8,81,103,59,24,19,9,0,85,130,78,293
20211221,21DEC2021:00:00:00,UFU ELIZALDE,87,87,57,114,3,174,151,23,160,14,117,39,5,8,3,0,0,2,0,6,105,40,151
20211221,21DEC2021:00:00:00,UFU FERNANDEZ,471,322,655,83,55,793,689,104,759,34,0,22,268,227,105,72,64,35,0,134,383,172,689
20211221,21DEC2021:00:00:00,UFU FERRER,116,132,144,94,10,248,248,0,248,0,0,0,73,96,39,30,7,3,0,26,178,44,248
20211221,21DEC2021:00:00:00,UFU GRIERSON,287,196,281,151,51,483,469,14,469,14,0,50,154,131,75,44,19,10,0,70,305,94,469
20211221,21DEC2021:00:00:00,UFU GUTIERREZ,240,188,317,79,32,428,403,25,414,14,209,115,32,48,19,0,5,0,0,27,275,99,403
20211221,21DEC2021:00:00:00,UFU MUÑIZ,519,481,563,338,99,1000,933,67,956,44,22,94,235,262,207,116,34,30,0,93,639,201,933
20211221,21DEC2021:00:00:00,UFU PENNA,79,106,139,43,3,185,179,6,179,6,3,2,53,45,18,49,6,9,0,30,111,38,179
20211221,21DEC2021:00:00:00,UFU PIROVANO,559,490,794,135,120,1049,1028,21,1037,12,0,43,314,308,167,81,80,56,0,246,482,300,1028
20211221,21DEC2021:00:00:00,UFU PIÑERO,130,152,202,47,33,282,272,10,272,10,34,32,40,57,24,53,30,12,0,29,184,57,272
20211221,21DEC2021:00:00:00,UFU RAMOS MEJIA,391,259,486,86,78,650,622,28,622,28,1,35,216,191,79,69,43,16,0,124,363,133,622
20211221,21DEC2021:00:00:00,UFU RIVADAVIA,543,418,661,129,171,961,909,52,949,12,0,16,395,275,104,77,75,19,0,242,372,293,909
20211221,21DEC2021:00:00:00,UFU SANTOJANNI,453,375,421,359,48,828,793,35,802,26,0,86,224,171,166,88,68,25,0,150,409,234,793
20211221,21DEC2021:00:00:00,UFU TORNU,557,444,856,90,55,1001,899,102,899,102,41,66,219,293,180,100,69,33,0,164,507,228,899
20211221,21DEC2021:00:00:00,UFU VELEZ SARSFIELD,279,234,395,86,32,513,503,10,511,2,0,28,110,116,117,55,38,49,0,115,274,114,503
20211221,21DEC2021:00:00:00,UFU ZUBIZARRETA,230,186,283,99,34,416,416,0,416,0,0,16,122,98,77,52,26,25,0,37,248,131,416
20211222,22DEC2021:00:00:00,UFU ALVAREZ,517,362,711,103,65,879,847,32,847,32,23,84,273,221,83,90,57,48,0,177,499,171,847
20211222,22DEC2021:00:00:00,UFU ARGERICH,192,147,191,114,34,339,297,42,307,32,0,17,105,85,47,37,35,13,0,58,145,90,297
20211222,22DEC2021:00:00:00,UFU BORDA-MOYANO,121,92,129,50,34,213,171,42,171,42,6,9,50,55,38,34,18,3,0,3,138,30,171
20211222,22DEC2021:00:00:00,UFU DURAND,155,156,243,30,38,311,303,8,303,8,0,13,113,86,53,20,12,14,0,111,112,80,303
20211222,22DEC2021:00:00:00,UFU ELIZALDE,93,57,66,80,4,150,137,13,140,10,81,32,5,21,8,3,0,0,0,7,97,33,137
20211222,22DEC2021:00:00:00,UFU FERNANDEZ,456,317,600,88,85,773,635,138,753,20,0,24,281,273,87,41,40,27,0,137,315,183,635
20211222,22DEC2021:00:00:00,UFU FERRER,167,116,164,93,26,283,274,9,277,6,0,0,98,94,51,27,2,11,0,68,146,60,274
20211222,22DEC2021:00:00:00,UFU GRIERSON,216,220,253,122,61,436,432,4,434,2,0,33,131,84,66,52,46,24,0,68,284,78,432
20211222,22DEC2021:00:00:00,UFU GUTIERREZ,349,282,481,85,65,631,618,13,621,10,262,201,27,69,45,19,8,0,0,44,435,139,618
20211222,22DEC2021:00:00:00,UFU MUÑIZ,472,485,517,381,59,957,878,79,911,46,15,38,260,253,178,114,49,50,0,100,602,176,878
20211222,22DEC2021:00:00:00,UFU PENNA,131,113,137,84,23,244,228,16,228,16,7,15,71,83,37,18,13,0,0,41,147,40,228
20211222,22DEC2021:00:00:00,UFU PIROVANO,648,557,897,132,176,1205,1142,63,1179,26,0,62,424,328,195,107,50,39,0,343,507,292,1142
20211222,22DEC2021:00:00:00,UFU PIÑERO,319,247,409,119,38,566,554,12,554,12,31,58,143,105,77,77,32,43,0,79,350,114,554
20211222,22DEC2021:00:00:00,UFU RAMOS MEJIA,455,313,616,55,97,768,730,38,734,34,18,42,227,234,108,68,50,21,0,134,434,162,730
20211222,22DEC2021:00:00:00,UFU RIVADAVIA,509,396,626,150,129,905,817,88,827,78,0,26,342,247,119,74,43,54,0,223,318,270,817
20211222,22DEC2021:00:00:00,UFU SANTOJANNI,461,408,524,280,65,869,856,13,865,4,2,44,270,201,149,90,68,45,0,206,439,211,856
20211222,22DEC2021:00:00:00,UFU TORNU,618,561,928,96,155,1179,957,222,957,222,32,99,340,375,180,75,51,27,0,200,509,227,957
20211222,22DEC2021:00:00:00,UFU VELEZ SARSFIELD,302,244,438,81,27,546,520,26,540,6,0,34,151,136,98,70,34,23,0,114,294,112,520
20211222,22DEC2021:00:00:00,UFU ZUBIZARRETA,153,127,198,66,16,280,278,2,280,0,0,17,83,64,60,40,14,2,0,31,159,88,278
20211223,23DEC2021:00:00:00,UFU ALVAREZ,621,502,889,116,118,1123,1085,38,1091,32,21,96,336,293,151,112,83,31,0,152,701,232,1085
20211226,26DEC2021:00:00:00,UFU PIÑERO,316,298,426,121,67,614,602,12,602,12,0,54,192,145,74,68,72,9,0,152,319,124,602
20211226,26DEC2021:00:00:00,UFU RAMOS MEJIA,350,319,532,80,57,669,645,24,645,24,1,52,209,155,94,98,46,14,0,212,287,146,645
20211226,26DEC2021:00:00:00,UFU RIVADAVIA,284,236,403,60,57,520,392,128,392,128,0,19,166,137,55,81,23,39,0,138,133,121,392
20211226,26DEC2021:00:00:00,UFU SANTOJANNI,636,437,630,384,59,1073,1033,40,1059,14,2,106,352,203,175,137,65,33,0,435,346,252,1033
20211226,26DEC2021:00:00:00,UFU TORNU,535,456,849,95,47,991,929,62,929,62,17,78,264,262,201,98,47,24,0,261,427,226,929
20211226,26DEC2021:00:00:00,UFU VELEZ SARSFIELD,374,336,484,183,43,710,685,25,700,10,0,58,190,175,98,103,46,40,0,205,332,148,685
20211226,26DEC2021:00:00:00,UFU ZUBIZARRETA,326,236,378,172,12,562,562,0,562,0,0,57,155,97,96,92,47,18,0,117,271,174,562
20211227,27DEC2021:00:00:00,UFU ALVAREZ,505,393,687,131,80,898,792,106,792,106,12,47,260,213,120,92,106,48,0,245,375,172,792
20211227,27DEC2021:00:00:00,UFU ARGERICH,244,184,258,158,12,428,402,26,402,26,12,26,138,98,60,47,34,13,0,109,171,117,402
20211227,27DEC2021:00:00:00,UFU BORDA-MOYANO,259,276,294,188,53,535,427,108,427,108,0,37,116,110,122,98,42,10,0,20,317,90,427
20211227,27DEC2021:00:00:00,UFU DURAND,201,156,336,8,13,357,349,8,349,8,2,31,133,89,44,29,17,12,0,133,133,83,349
20211227,27DEC2021:00:00:00,UFU ELIZALDE,198,175,139,199,35,373,320,53,359,14,153,140,10,21,32,9,8,0,0,53,188,79,320
20211227,27DEC2021:00:00:00,UFU FERNANDEZ,323,273,515,67,14,596,574,22,574,22,0,27,188,176,77,61,33,34,0,221,139,212,574
20211227,27DEC2021:00:00:00,UFU FERRER,181,160,202,130,9,341,337,4,337,4,0,5,107,100,59,28,34,8,0,112,157,68,337
20211227,27DEC2021:00:00:00,UFU GRIERSON,197,161,234,89,35,358,348,10,348,10,0,21,108,76,51,54,28,20,0,95,184,68,348
20211227,27DEC2021:00:00:00,UFU GUTIERREZ,481,313,537,165,92,794,744,50,750,44,297,260,41,103,63,17,13,0,0,130,436,178,744
20211227,27DEC2021:00:00:00,UFU MUÑIZ,612,491,495,490,118,1103,1024,79,1089,14,2,86,314,306,209,111,52,23,0,206,617,201,1024
20211227,27DEC2021:00:00:00,UFU PENNA,165,112,161,105,11,277,270,7,273,4,0,26,67,62,59,38,20,5,0,57,153,60,270
20211227,27DEC2021:00:00:00,UFU PIROVANO,497,551,781,133,134,1048,983,65,1042,6,4,65,335,222,171,140,65,46,0,362,374,247,983
20211227,27DEC2021:00:00:00,UFU PIÑERO,35,48,55,22,6,83,81,2,81,2,49,26,0,2,3,0,3,0,0,7,58,16,81
20211227,27DEC2021:00:00:00,UFU RAMOS MEJIA,439,346,608,115,62,785,697,88,705,80,12,39,232,225,127,68,50,32,0,229,262,204,697
20211227,27DEC2021:00:00:00,UFU RIVADAVIA,465,336,551,159,91,801,772,29,777,24,0,19,258,208,109,110,35,62,0,278,261,232,772
20211227,27DEC2021:00:00:00,UFU SANTOJANNI,610,576,685,420,81,1186,1128,58,1174,12,0,101,321,262,219,170,75,38,0,492,388,248,1128
20211227,27DEC2021:00:00:00,UFU TORNU,598,580,962,144,72,1178,1106,72,1114,64,26,79,361,293,190,108,73,48,0,259,548,295,1106
20211227,27DEC2021:00:00:00,UFU VELEZ SARSFIELD,309,214,379,90,54,523,489,34,509,14,2,48,142,98,72,89,48,24,0,152,241,96,489
20211227,27DEC2021:00:00:00,UFU ZUBIZARRETA,148,112,179,64,17,260,252,8,260,0,0,20,97,47,30,36,21,9,0,70,67,115,252
20211228,28DEC2021:00:00:00,UFU ALVAREZ,741,511,934,166,152,1252,885,367,1060,192,20,65,488,243,171,149,88,28,0,295,370,220,885
20211228,28DEC2021:00:00:00,UFU ARGERICH,179,192,208,139,24,371,357,14,359,12,11,33,108,111,54,34,15,5,0,114,126,110,357
20211228,28DEC2021:00:00:00,UFU BORDA-MOYANO,191,190,214,127,40,381,116,265,119,262,2,51,101,74,73,45,24,11,0,4,90,22,116
20211228,28DEC2021:00:00:00,UFU DURAND,650,522,1022,88,62,1172,4,1168,14,1158,0,51,456,305,141,126,57,36,0,1,0,3,4
20211228,28DEC2021:00:00:00,UFU ELIZALDE,259,223,164,283,35,482,389,93,438,44,190,183,44,55,10,0,0,0,0,73,221,95,389
20211228,28DEC2021:00:00:00,UFU FERNANDEZ,618,487,861,136,108,1105,232,873,445,660,0,28,419,320,148,108,63,19,0,71,86,74,232
20211228,28DEC2021:00:00:00,UFU FERRER,206,148,200,142,12,354,0,354,0,354,0,13,138,96,49,30,26,2,0,0,0,0,0
20211228,28DEC2021:00:00:00,UFU GRIERSON,263,266,339,165,25,529,517,12,519,10,0,21,128,152,84,64,52,28,0,160,246,110,517
20211228,28DEC2021:00:00:00,UFU GUTIERREZ,467,332,617,104,78,799,426,373,769,30,268,257,24,101,82,52,15,0,0,86,245,94,426
20211228,28DEC2021:00:00:00,UFU MUÑIZ,701,671,622,624,126,1372,1339,33,1368,4,10,96,479,275,188,196,87,41,0,289,776,274,1339
20211228,28DEC2021:00:00:00,UFU PENNA,176,173,242,90,17,349,343,6,343,6,5,21,100,103,69,24,17,10,0,116,147,78,343
20211228,28DEC2021:00:00:00,UFU PIROVANO,643,575,870,161,187,1218,12,1206,1204,14,2,49,483,294,152,126,61,51,0,4,5,3,12
20211228,28DEC2021:00:00:00,UFU PIÑERO,366,271,443,151,43,637,102,535,102,535,65,52,204,120,66,72,48,10,0,7,72,23,102
20211228,28DEC2021:00:00:00,UFU RAMOS MEJIA,525,477,761,135,106,1002,932,70,932,70,16,73,279,232,166,109,74,53,0,258,448,225,932
20211228,28DEC2021:00:00:00,UFU RIVADAVIA,471,431,643,172,87,902,48,854,56,846,0,46,340,224,119,97,37,39,0,16,18,14,48
20211228,28DEC2021:00:00:00,UFU SANTOJANNI,850,671,856,538,127,1521,1479,42,1499,22,1,151,490,325,274,162,92,26,0,593,541,345,1479
20211228,28DEC2021:00:00:00,UFU TORNU,432,328,667,70,23,760,83,677,106,654,31,59,229,163,130,80,41,27,0,19,42,20,83
20211228,28DEC2021:00:00:00,UFU VELEZ SARSFIELD,6,0,6,0,0,6,4,2,4,2,0,0,4,2,0,0,0,0,0,0,3,1,4
20211228,28DEC2021:00:00:00,UFU ZUBIZARRETA,171,157,209,95,24,328,328,0,328,0,0,36,108,51,41,56,28,8,0,72,105,151,328
20211229,29DEC2021:00:00:00,UFU ALVAREZ,872,669,1097,308,136,1541,229,1312,1423,118,51,132,617,329,191,117,67,37,0,55,119,55,229
20211229,29DEC2021:00:00:00,UFU ARGERICH,183,199,259,117,6,382,368,14,368,14,8,13,149,76,63,41,19,13,0,106,149,109,368
20211229,29DEC2021:00:00:00,UFU BORDA-MOYANO,309,274,313,190,80,583,0,583,3,580,5,52,166,121,126,78,23,12,0,0,0,0,0
20211229,29DEC2021:00:00:00,UFU DURAND,775,678,1297,114,42,1453,2,1451,11,1442,0,76,508,393,217,143,79,37,0,0,1,1,2
20211229,29DEC2021:00:00:00,UFU ELIZALDE,305,174,213,239,27,479,76,403,311,168,162,129,83,63,19,15,8,0,0,12,41,23,76
20211229,29DEC2021:00:00:00,UFU FERNANDEZ,414,388,564,119,119,802,65,737,134,668,0,33,321,199,111,62,56,20,0,21,28,15,65
20211229,29DEC2021:00:00:00,UFU FERRER,272,217,269,202,18,489,0,489,5,484,0,15,191,159,60,44,16,4,0,0,0,0,0
20211229,29DEC2021:00:00:00,UFU GRIERSON,234,261,308,131,56,495,472,23,475,20,0,26,208,91,70,62,26,12,0,130,235,107,472
20211229,29DEC2021:00:00:00,UFU GUTIERREZ,406,338,543,146,55,744,427,317,730,14,233,231,52,95,77,37,13,6,0,89,237,99,427
20211229,29DEC2021:00:00:00,UFU MUÑIZ,781,687,650,705,113,1468,1414,54,1458,10,9,105,522,354,253,157,33,35,0,330,790,294,1414
20211229,29DEC2021:00:00:00,UFU PENNA,235,215,313,123,14,450,406,44,406,44,3,35,158,127,55,46,22,4,0,117,205,84,406
20211229,29DEC2021:00:00:00,UFU PIROVANO,564,507,836,142,93,1071,17,1054,1057,14,0,42,349,332,123,110,73,42,0,4,9,4,17
20211229,29DEC2021:00:00:00,UFU PIÑERO,461,314,547,176,52,775,146,629,149,626,98,86,267,102,94,74,34,20,0,18,96,32,146
20211229,29DEC2021:00:00:00,UFU RAMOS MEJIA,733,597,1020,163,147,1330,477,853,482,848,14,91,536,337,144,118,67,23,0,160,173,144,477
20211229,29DEC2021:00:00:00,UFU RIVADAVIA,567,420,678,165,144,987,18,969,33,954,2,29,400,258,138,85,49,26,0,7,5,6,18
20211229,29DEC2021:00:00:00,UFU SANTOJANNI,965,865,1042,606,182,1830,1768,62,1808,22,3,155,663,377,256,223,111,42,0,708,637,423,1768
20210801,01AUG2021:00:00:00,UFU GRIERSON,96,71,111,47,9,167,165,2,165,2,0,13,36,29,26,36,19,8,0,10,108,47,165
20210801,01AUG2021:00:00:00,UFU GUTIERREZ,83,61,97,45,2,144,138,6,142,2,65,35,5,20,12,6,1,0,0,6,78,54,138
20210801,01AUG2021:00:00:00,UFU MUÑIZ,71,70,60,76,5,141,121,20,129,12,0,3,19,37,36,28,8,10,0,11,77,33,121
20210801,01AUG2021:00:00:00,UFU PENNA,49,41,44,43,3,90,88,2,88,2,0,2,22,16,13,25,8,4,0,4,64,20,88
20210801,01AUG2021:00:00:00,UFU PIROVANO,182,91,214,21,38,273,239,34,259,14,17,23,47,74,56,32,15,9,0,31,108,100,239
20210801,01AUG2021:00:00:00,UFU PIÑERO,81,91,116,33,23,172,162,10,162,10,0,17,39,39,24,47,3,3,0,12,102,47,162
20210801,01AUG2021:00:00:00,UFU RAMOS MEJIA,182,71,195,26,32,253,239,14,243,10,2,7,64,40,45,54,32,9,0,10,170,58,239
20210801,01AUG2021:00:00:00,UFU RIVADAVIA,126,101,169,26,32,227,213,14,217,10,0,0,63,61,54,22,15,12,0,26,97,86,213
20210801,01AUG2021:00:00:00,UFU SANTOJANNI,235,141,199,152,25,376,362,14,376,0,15,20,60,83,82,51,35,30,0,19,253,90,362
20210801,01AUG2021:00:00:00,UFU TORNU,103,95,166,12,20,198,190,8,192,6,3,16,26,50,47,23,21,12,0,15,122,53,190
20210801,01AUG2021:00:00:00,UFU VELEZ SARSFIELD,168,108,170,72,34,276,258,18,262,14,0,26,70,39,57,50,26,8,0,21,166,71,258
20210801,01AUG2021:00:00:00,UFU ZUBIZARRETA,218,150,255,108,5,368,362,6,368,0,0,9,58,75,92,58,41,35,0,22,241,99,362
20210802,02AUG2021:00:00:00,UFU ALVAREZ,215,167,294,68,20,382,332,50,332,50,48,24,78,85,63,44,28,12,0,20,235,77,332
20210802,02AUG2021:00:00:00,UFU ARGERICH,70,60,64,60,6,130,116,14,118,12,15,3,32,19,23,19,14,5,0,8,50,58,116
20210802,02AUG2021:00:00:00,UFU BORDA-MOYANO,66,31,54,36,7,97,87,10,87,10,0,19,13,18,17,21,7,2,0,1,52,34,87
20210802,02AUG2021:00:00:00,UFU DURAND,141,115,210,29,17,256,230,26,230,26,6,6,70,64,52,39,14,5,0,16,123,91,230
20210802,02AUG2021:00:00:00,UFU ELIZALDE,122,129,81,165,5,251,225,26,237,14,141,51,13,25,11,6,4,0,0,4,136,85,225
20210802,02AUG2021:00:00:00,UFU FERNANDEZ,135,107,178,40,24,242,206,36,220,22,0,7,82,75,24,20,26,8,0,13,108,85,206
20210802,02AUG2021:00:00:00,UFU FERRER,122,87,122,78,9,209,199,10,201,8,0,2,43,68,52,27,15,2,0,13,133,53,199
20210802,02AUG2021:00:00:00,UFU GRIERSON,96,66,93,69,0,162,158,4,158,4,0,6,50,42,19,22,21,2,0,10,105,42,158
20210802,02AUG2021:00:00:00,UFU GUTIERREZ,151,105,127,121,8,256,218,38,252,4,116,61,13,31,22,7,4,2,0,13,129,76,218
20210802,02AUG2021:00:00:00,UFU MUÑIZ,176,183,168,154,37,359,295,64,333,26,0,5,83,96,55,59,50,11,0,12,198,85,295
20210802,02AUG2021:00:00:00,UFU PENNA,99,83,95,84,3,182,170,12,174,8,2,7,40,48,24,39,17,5,0,9,119,42,170
20210802,02AUG2021:00:00:00,UFU PIROVANO,158,130,218,34,36,288,268,20,284,4,0,6,63,99,39,28,35,18,0,15,148,105,268
20210802,02AUG2021:00:00:00,UFU PIÑERO,129,93,164,34,24,222,214,8,216,6,3,14,52,51,21,53,22,6,0,5,150,58,214
20210802,02AUG2021:00:00:00,UFU RAMOS MEJIA,254,191,293,97,55,445,399,46,413,32,24,26,107,101,80,53,36,18,0,29,232,138,399
20210802,02AUG2021:00:00:00,UFU RIVADAVIA,155,132,205,46,36,287,215,72,215,72,0,3,88,79,55,27,21,14,0,16,119,78,215
20210802,02AUG2021:00:00:00,UFU SANTOJANNI,257,171,188,216,24,428,408,20,420,8,14,33,97,101,67,63,34,19,0,16,290,100,408
20210802,02AUG2021:00:00:00,UFU TORNU,192,178,259,85,26,370,334,36,334,36,32,28,75,97,58,43,17,20,0,19,220,92,334
20210802,02AUG2021:00:00:00,UFU VELEZ SARSFIELD,196,148,265,69,10,344,314,30,336,8,0,14,72,60,78,63,47,10,0,12,214,88,314
20210802,02AUG2021:00:00:00,UFU ZUBIZARRETA,190,121,180,99,32,311,309,2,311,0,0,10,39,70,87,60,32,13,0,25,208,76,309
20210803,03AUG2021:00:00:00,UFU ALVAREZ,204,174,280,76,22,378,357,21,357,21,44,36,75,76,69,33,36,9,0,15,232,110,357
20210803,03AUG2021:00:00:00,UFU ARGERICH,63,43,58,48,0,106,88,18,90,16,8,4,32,23,24,14,1,0,0,8,43,36,88
20210803,03AUG2021:00:00:00,UFU BORDA-MOYANO,78,43,64,38,19,121,115,6,115,6,1,5,17,33,29,17,18,1,0,3,70,42,115
20210803,03AUG2021:00:00:00,UFU DURAND,125,98,193,18,12,223,219,4,219,4,10,17,52,56,35,28,13,12,0,16,118,85,219
20210803,03AUG2021:00:00:00,UFU ELIZALDE,134,115,69,176,4,249,223,26,237,12,142,72,8,8,9,4,6,0,0,3,134,86,223
20210803,03AUG2021:00:00:00,UFU FERNANDEZ,129,75,152,28,24,204,188,16,192,12,0,3,59,60,30,28,9,15,0,13,96,79,188
20210803,03AUG2021:00:00:00,UFU FERRER,98,96,97,93,4,194,186,8,190,4,0,4,56,47,41,28,12,6,0,13,118,55,186
20210803,03AUG2021:00:00:00,UFU GRIERSON,165,122,121,131,35,287,275,12,275,12,0,9,85,65,60,47,15,6,0,12,188,74,275
20210803,03AUG2021:00:00:00,UFU GUTIERREZ,186,147,203,121,9,333,305,28,331,2,165,78,20,36,25,9,0,0,0,2,213,88,305
20210803,03AUG2021:00:00:00,UFU MUÑIZ,127,127,136,107,11,254,196,58,208,46,4,6,63,62,50,50,9,10,0,7,137,52,196
20210803,03AUG2021:00:00:00,UFU PENNA,65,60,70,44,11,125,109,16,117,8,2,11,31,25,20,24,8,4,0,4,75,30,109
20210803,03AUG2021:00:00:00,UFU PIROVANO,167,134,233,44,24,301,285,16,299,2,0,5,54,104,67,41,17,13,0,23,152,110,285
20210803,03AUG2021:00:00:00,UFU PIÑERO,93,89,143,20,19,182,178,4,178,4,0,13,41,50,29,28,12,9,0,5,122,49,178
20210803,03AUG2021:00:00:00,UFU RAMOS MEJIA,201,198,288,78,33,399,375,24,381,18,24,25,104,98,69,33,26,20,0,22,238,115,375
20210803,03AUG2021:00:00:00,UFU RIVADAVIA,169,114,178,50,55,283,257,26,271,12,0,8,83,67,49,45,19,12,0,19,136,101,257
20210803,03AUG2021:00:00:00,UFU SANTOJANNI,223,218,215,188,38,441,425,16,437,4,10,41,67,114,101,66,33,9,0,25,287,113,425
20210803,03AUG2021:00:00:00,UFU TORNU,167,134,217,62,22,301,265,36,267,34,27,17,32,72,86,38,14,15,0,14,173,69,265
20210803,03AUG2021:00:00:00,UFU VELEZ SARSFIELD,182,155,266,53,18,337,333,4,335,2,0,17,80,81,78,43,22,16,0,13,224,96,333
20210803,03AUG2021:00:00:00,UFU ZUBIZARRETA,213,153,248,91,27,366,366,0,366,0,0,34,98,67,69,45,30,23,0,25,254,87,366
20210804,04AUG2021:00:00:00,UFU ALVAREZ,209,182,300,66,25,391,361,30,365,26,46,35,84,111,49,32,22,12,0,12,244,105,361
20210804,04AUG2021:00:00:00,UFU ARGERICH,52,50,60,40,2,102,84,18,84,18,16,2,22,25,14,11,6,6,0,6,42,35,84
20210804,04AUG2021:00:00:00,UFU BORDA-MOYANO,55,69,62,49,13,124,112,12,112,12,0,8,14,33,36,24,5,4,0,1,69,42,112
20210804,04AUG2021:00:00:00,UFU DURAND,136,103,207,25,7,239,229,10,235,4,24,7,48,72,51,21,12,4,0,14,122,93,229
20210804,04AUG2021:00:00:00,UFU ELIZALDE,115,80,61,134,0,195,179,16,191,4,99,66,5,11,8,4,2,0,0,4,112,63,179
20210804,04AUG2021:00:00:00,UFU FERNANDEZ,112,106,188,18,12,218,186,32,212,6,0,10,63,58,52,20,8,7,0,11,108,67,186
20210804,04AUG2021:00:00:00,UFU FERRER,117,103,92,118,10,220,204,16,208,12,0,5,34,77,56,25,15,8,0,6,142,56,204
20210804,04AUG2021:00:00:00,UFU GRIERSON,147,119,160,85,21,266,246,20,258,8,0,23,75,49,57,32,16,14,0,18,160,67,246
20210804,04AUG2021:00:00:00,UFU GUTIERREZ,136,145,164,115,2,281,267,14,277,4,159,66,3,29,9,12,0,3,0,7,177,83,267
20210804,04AUG2021:00:00:00,UFU MUÑIZ,115,154,124,118,27,269,237,32,237,32,0,6,60,70,47,38,46,2,0,11,156,70,237
20210804,04AUG2021:00:00:00,UFU PENNA,71,51,81,41,0,122,112,10,116,6,0,8,27,34,24,19,5,5,0,8,72,32,112
20210804,04AUG2021:00:00:00,UFU PIROVANO,179,109,244,29,15,288,272,16,282,6,0,9,61,80,53,55,18,12,0,32,125,115,272
20210804,04AUG2021:00:00:00,UFU PIÑERO,137,88,166,53,6,225,215,10,219,6,3,16,33,46,62,31,26,8,0,7,151,54,215
20210804,04AUG2021:00:00:00,UFU RAMOS MEJIA,180,182,240,82,40,362,320,42,336,26,16,15,89,118,64,29,25,6,0,25,187,107,320
20210924,24SEP2021:00:00:00,UFU RAMOS MEJIA,127,102,176,29,24,229,183,46,209,20,21,14,49,45,33,37,22,8,0,3,110,70,183
20210924,24SEP2021:00:00:00,UFU RIVADAVIA,93,69,124,25,13,162,122,40,124,38,0,4,55,45,23,20,12,3,0,2,68,52,122
20210924,24SEP2021:00:00:00,UFU SANTOJANNI,118,82,107,82,11,200,188,12,198,2,11,16,47,52,39,19,8,8,0,5,111,72,188
20210924,24SEP2021:00:00:00,UFU TORNU,176,174,308,28,14,350,272,78,274,76,94,21,40,70,57,45,21,2,0,11,180,74,272
20210924,24SEP2021:00:00:00,UFU VELEZ SARSFIELD,134,80,161,47,6,214,210,4,212,2,0,8,46,39,51,39,14,17,0,4,149,57,210
20210924,24SEP2021:00:00:00,UFU ZUBIZARRETA,36,22,24,25,9,58,56,2,58,0,0,2,8,15,20,8,5,0,0,0,44,12,56
20210925,25SEP2021:00:00:00,UFU ALVAREZ,69,86,129,20,6,155,147,8,147,8,14,10,31,38,37,8,12,5,0,1,109,37,147
20210925,25SEP2021:00:00:00,UFU BORDA-MOYANO,13,17,19,11,0,30,26,4,26,4,0,3,2,4,13,2,5,1,0,0,19,7,26
20210925,25SEP2021:00:00:00,UFU DURAND,79,58,116,13,8,137,123,14,123,14,3,7,34,38,30,10,10,5,0,3,71,49,123
20210925,25SEP2021:00:00:00,UFU ELIZALDE,137,97,63,159,12,234,196,38,222,12,153,54,14,4,4,1,4,0,0,0,135,61,196
20210925,25SEP2021:00:00:00,UFU FERNANDEZ,48,44,83,9,0,92,86,6,88,4,0,2,19,37,11,5,11,7,0,2,58,26,86
20210925,25SEP2021:00:00:00,UFU FERRER,40,43,36,39,8,83,78,5,80,3,0,0,12,14,22,14,12,9,0,0,61,17,78
20210925,25SEP2021:00:00:00,UFU GRIERSON,57,66,78,28,17,123,121,2,121,2,0,8,21,38,11,21,9,15,0,3,85,33,121
20210925,25SEP2021:00:00:00,UFU GUTIERREZ,120,92,136,74,2,212,200,12,208,4,142,43,8,4,12,3,0,0,0,1,137,62,200
20210925,25SEP2021:00:00:00,UFU MUÑIZ,55,55,43,59,8,110,84,26,84,26,2,10,8,24,25,28,7,6,0,1,57,26,84
20210925,25SEP2021:00:00:00,UFU PENNA,39,47,42,42,2,86,84,2,84,2,19,21,9,18,4,10,5,0,0,3,54,27,84
20210925,25SEP2021:00:00:00,UFU PIROVANO,119,63,155,19,8,182,172,10,174,8,2,7,28,47,44,26,12,16,0,7,95,70,172
20210925,25SEP2021:00:00:00,UFU PIÑERO,61,38,70,27,2,99,97,2,97,2,0,0,27,29,7,24,7,5,0,0,71,26,97
20210925,25SEP2021:00:00:00,UFU RAMOS MEJIA,74,49,93,21,9,123,117,6,119,4,4,11,27,22,28,11,9,11,0,0,63,54,117
20210925,25SEP2021:00:00:00,UFU RIVADAVIA,56,49,71,21,13,105,97,8,97,8,2,3,32,10,26,15,7,10,0,7,52,38,97
20210925,25SEP2021:00:00:00,UFU SANTOJANNI,133,88,130,75,16,221,207,14,211,10,0,32,38,34,48,31,22,16,0,5,120,82,207
20210925,25SEP2021:00:00:00,UFU TORNU,79,65,120,19,5,144,134,10,140,4,6,11,13,37,33,18,11,15,0,3,94,36,134
20210925,25SEP2021:00:00:00,UFU VELEZ SARSFIELD,114,82,154,32,10,196,186,10,190,6,0,12,31,43,38,26,31,15,0,5,125,56,186
20210925,25SEP2021:00:00:00,UFU ZUBIZARRETA,163,84,186,54,7,247,243,4,247,0,0,22,39,27,65,36,47,11,0,8,164,71,243
20210926,26SEP2021:00:00:00,UFU ALVAREZ,93,117,173,23,14,210,202,8,202,8,28,26,28,34,28,22,17,27,0,2,147,53,202
20210926,26SEP2021:00:00:00,UFU ARGERICH,34,29,39,23,1,63,61,2,63,0,7,4,15,9,15,8,3,2,0,0,28,33,61
20210926,26SEP2021:00:00:00,UFU BORDA-MOYANO,18,12,27,3,0,30,26,4,26,4,0,4,4,6,4,3,7,2,0,0,18,8,26
20210926,26SEP2021:00:00:00,UFU DURAND,79,49,108,0,20,128,124,4,124,4,6,13,14,25,36,19,7,8,0,8,66,50,124
20210926,26SEP2021:00:00:00,UFU ELIZALDE,133,99,66,162,4,232,194,38,218,14,141,60,12,10,3,5,1,0,0,0,118,76,194
20210926,26SEP2021:00:00:00,UFU FERNANDEZ,34,28,60,2,0,62,62,0,62,0,0,4,9,21,15,1,10,2,0,4,39,19,62
20210926,26SEP2021:00:00:00,UFU FERRER,60,24,45,36,3,84,84,0,84,0,0,0,20,22,13,14,9,6,0,0,62,22,84
20210926,26SEP2021:00:00:00,UFU GRIERSON,34,37,39,24,8,71,63,8,63,8,1,4,14,12,28,12,0,0,0,2,45,16,63
20210926,26SEP2021:00:00:00,UFU GUTIERREZ,143,145,214,65,13,292,270,22,278,14,200,78,6,2,2,0,3,1,0,2,191,77,270
20210926,26SEP2021:00:00:00,UFU MUÑIZ,76,45,64,53,4,121,103,18,105,16,0,8,27,41,27,7,4,7,0,0,71,32,103
20210926,26SEP2021:00:00:00,UFU PENNA,40,32,45,14,13,72,64,8,64,8,10,4,3,14,18,8,8,7,0,0,44,20,64
20210926,26SEP2021:00:00:00,UFU PIROVANO,122,108,175,35,20,230,212,18,218,12,20,25,33,57,48,22,19,6,0,1,113,98,212
20210926,26SEP2021:00:00:00,UFU PIÑERO,27,47,61,11,2,74,70,4,70,4,0,3,13,8,22,22,3,3,0,1,51,18,70
20210926,26SEP2021:00:00:00,UFU RAMOS MEJIA,70,70,112,14,14,140,130,10,130,10,12,11,22,30,20,22,7,16,0,4,75,51,130
20210926,26SEP2021:00:00:00,UFU RIVADAVIA,77,43,88,24,8,120,114,6,114,6,0,0,41,32,17,15,10,5,0,0,69,45,114
20210926,26SEP2021:00:00:00,UFU SANTOJANNI,104,51,75,66,14,155,143,12,145,10,0,15,32,26,41,18,15,8,0,0,92,51,143
20210926,26SEP2021:00:00:00,UFU TORNU,95,42,117,18,2,137,133,4,133,4,21,17,21,26,22,21,7,2,0,2,98,33,133
20210926,26SEP2021:00:00:00,UFU VELEZ SARSFIELD,103,68,123,35,13,171,167,4,167,4,0,12,26,37,47,25,19,5,0,5,111,51,167
20210926,26SEP2021:00:00:00,UFU ZUBIZARRETA,76,28,72,28,4,104,102,2,104,0,0,17,16,12,21,15,15,8,0,0,80,22,102
20210927,27SEP2021:00:00:00,UFU ALVAREZ,193,159,297,28,27,352,330,22,330,22,55,30,53,80,54,21,35,24,0,5,231,94,330
20210927,27SEP2021:00:00:00,UFU ARGERICH,61,63,76,45,3,124,112,12,112,12,30,7,15,17,19,16,10,10,0,1,59,52,112
20210927,27SEP2021:00:00:00,UFU BORDA-MOYANO,23,33,37,19,0,56,54,2,54,2,0,3,16,12,11,5,7,2,0,0,31,23,54
20210927,27SEP2021:00:00:00,UFU DURAND,113,96,179,22,8,209,199,10,199,10,49,38,29,45,27,5,8,8,0,9,115,75,199
20210927,27SEP2021:00:00:00,UFU ELIZALDE,198,209,130,270,7,407,358,49,372,35,247,99,16,23,12,8,2,0,0,0,229,129,358
20210927,27SEP2021:00:00:00,UFU FERNANDEZ,82,59,113,20,8,141,135,6,137,4,0,6,27,41,24,19,12,12,0,4,76,55,135
20210927,27SEP2021:00:00:00,UFU FERRER,90,79,90,70,9,169,159,10,159,10,0,1,34,39,46,38,11,0,0,0,113,46,159
20210927,27SEP2021:00:00:00,UFU GRIERSON,87,72,99,46,14,159,157,2,157,2,0,29,43,43,7,15,17,5,0,0,114,43,157
20210927,27SEP2021:00:00:00,UFU GUTIERREZ,186,173,225,126,8,359,335,24,349,10,237,78,4,26,12,2,0,0,0,3,220,112,335
20210927,27SEP2021:00:00:00,UFU MUÑIZ,85,105,76,106,8,190,174,16,174,16,5,7,38,62,31,25,14,8,0,1,130,43,174
20210927,27SEP2021:00:00:00,UFU PENNA,99,114,117,93,3,213,189,24,189,24,73,37,13,36,29,14,7,4,0,0,143,46,189
20210927,27SEP2021:00:00:00,UFU PIROVANO,151,113,208,32,24,264,246,18,258,6,0,15,43,85,56,31,22,12,0,1,147,98,246
20210927,27SEP2021:00:00:00,UFU PIÑERO,158,160,266,34,18,318,304,14,306,12,117,42,36,44,28,29,14,8,0,2,220,79,304
20210927,27SEP2021:00:00:00,UFU RAMOS MEJIA,151,129,205,58,17,280,270,10,276,4,40,22,46,64,44,21,25,18,0,6,162,102,270
20210927,27SEP2021:00:00:00,UFU RIVADAVIA,116,83,141,37,21,199,191,8,191,8,0,7,60,60,32,13,21,6,0,3,116,72,191
20210927,27SEP2021:00:00:00,UFU SANTOJANNI,142,104,166,72,8,246,226,20,234,12,30,44,24,36,38,29,28,17,0,6,130,90,226
20210927,27SEP2021:00:00:00,UFU TORNU,198,134,258,53,21,332,272,60,274,58,85,44,46,56,51,12,28,10,0,8,184,77,272
20210927,27SEP2021:00:00:00,UFU VELEZ SARSFIELD,140,131,198,61,12,271,233,38,261,10,0,18,44,68,70,37,15,19,0,3,168,62,233
20210927,27SEP2021:00:00:00,UFU ZUBIZARRETA,214,133,200,115,32,347,341,6,347,0,0,32,38,80,74,55,38,30,0,3,251,87,341
20210928,28SEP2021:00:00:00,UFU ALVAREZ,206,150,302,28,26,356,326,30,332,24,82,31,74,81,42,10,30,6,0,4,234,88,326
20210928,28SEP2021:00:00:00,UFU ARGERICH,67,54,68,51,2,121,89,32,111,10,38,8,21,18,12,17,6,1,0,0,48,40,89
20210928,28SEP2021:00:00:00,UFU BORDA-MOYANO,13,21,19,15,0,34,30,4,30,4,2,5,7,0,7,11,0,2,0,0,21,9,30
20211229,29DEC2021:00:00:00,UFU TORNU,522,453,798,127,50,975,6,969,9,966,26,98,306,209,140,101,48,47,0,0,5,1,6
20211229,29DEC2021:00:00:00,UFU VELEZ SARSFIELD,385,252,496,101,40,637,15,622,613,24,0,112,226,128,66,46,40,19,0,6,6,3,15
20211229,29DEC2021:00:00:00,UFU ZUBIZARRETA,197,173,237,91,42,370,366,4,366,4,0,32,126,80,58,41,17,16,0,111,129,126,366
20211230,30DEC2021:00:00:00,UFU ALVAREZ,1008,668,1231,269,176,1676,735,941,1616,60,58,147,553,335,281,160,92,50,0,211,360,164,735
20211230,30DEC2021:00:00:00,UFU ARGERICH,255,178,258,159,16,433,419,14,419,14,6,38,114,114,74,52,18,17,0,123,175,121,419
20211230,30DEC2021:00:00:00,UFU BORDA-MOYANO,331,347,383,247,48,678,335,343,506,172,16,56,188,118,139,86,47,28,0,22,225,88,335
20211230,30DEC2021:00:00:00,UFU DURAND,719,632,1141,128,82,1351,9,1342,21,1330,1,71,523,349,181,112,83,31,0,0,7,2,9
20211230,30DEC2021:00:00:00,UFU ELIZALDE,324,219,244,252,47,543,11,532,331,212,183,170,49,65,32,30,6,8,0,0,7,4,11
20211230,30DEC2021:00:00:00,UFU FERNANDEZ,471,414,653,136,96,885,72,813,323,562,0,41,312,247,130,90,28,37,0,9,34,29,72
20211230,30DEC2021:00:00:00,UFU FERRER,466,326,446,309,37,792,36,756,776,16,0,39,293,215,128,67,33,17,0,14,17,5,36
20211230,30DEC2021:00:00:00,UFU GRIERSON,322,277,318,213,68,599,579,20,583,16,0,51,223,134,86,69,22,14,0,149,295,134,579
20211230,30DEC2021:00:00:00,UFU GUTIERREZ,517,355,657,160,55,872,828,44,854,18,276,284,48,122,84,51,7,0,0,132,524,171,828
20211230,30DEC2021:00:00:00,UFU MUÑIZ,919,697,739,731,146,1616,1553,63,1588,28,2,108,540,443,247,148,91,37,0,367,871,312,1553
20211230,30DEC2021:00:00:00,UFU PENNA,320,267,351,220,16,587,579,8,579,8,7,27,172,183,79,75,28,16,0,122,349,105,579
20211230,30DEC2021:00:00:00,UFU PIROVANO,737,543,911,182,187,1280,17,1263,1260,20,0,54,439,322,218,126,77,44,0,6,4,7,17
20211230,30DEC2021:00:00:00,UFU PIÑERO,430,369,574,159,66,799,115,684,115,684,58,108,238,148,91,87,33,36,0,21,65,28,115
20211230,30DEC2021:00:00:00,UFU RAMOS MEJIA,775,708,1076,231,176,1483,480,1003,489,994,10,86,592,344,218,139,77,17,0,133,209,138,480
20211230,30DEC2021:00:00:00,UFU RIVADAVIA,634,496,802,207,121,1130,21,1109,44,1086,0,50,417,284,150,128,91,10,0,6,6,9,21
20211230,30DEC2021:00:00:00,UFU SANTOJANNI,683,574,666,422,169,1257,1213,44,1213,44,6,116,403,298,194,148,55,37,0,481,456,274,1213
20211230,30DEC2021:00:00:00,UFU TORNU,654,528,980,130,72,1182,9,1173,12,1170,25,101,362,251,202,144,49,48,0,0,4,5,9
20211230,30DEC2021:00:00:00,UFU VELEZ SARSFIELD,449,471,747,105,68,920,18,902,280,640,0,122,276,196,151,96,47,32,0,7,8,3,18
20211230,30DEC2021:00:00:00,UFU ZUBIZARRETA,273,231,349,86,69,504,488,16,504,0,4,52,156,112,62,61,32,25,0,101,173,214,488
20211231,31DEC2021:00:00:00,UFU ALVAREZ,540,379,701,156,62,919,162,757,901,18,34,71,302,191,163,85,40,33,0,53,71,38,162
20211231,31DEC2021:00:00:00,UFU ARGERICH,67,45,86,20,6,112,110,2,112,0,6,4,52,17,11,11,5,6,0,32,32,46,110
20211231,31DEC2021:00:00:00,UFU BORDA-MOYANO,156,146,190,96,16,302,194,108,212,90,0,31,71,68,56,47,18,11,0,44,103,47,194
20211231,31DEC2021:00:00:00,UFU DURAND,442,390,740,52,40,832,0,832,0,832,3,35,257,220,128,85,71,33,0,0,0,0,0
20211231,31DEC2021:00:00:00,UFU ELIZALDE,147,131,121,154,3,278,15,263,140,138,81,66,19,61,26,14,8,3,0,0,8,7,15
20211231,31DEC2021:00:00:00,UFU FERNANDEZ,175,182,286,42,29,357,36,321,55,302,0,9,134,78,48,37,32,19,0,20,4,12,36
20211231,31DEC2021:00:00:00,UFU FERRER,151,177,191,134,3,328,18,310,326,2,0,8,127,83,42,47,15,6,0,3,11,4,18
20211231,31DEC2021:00:00:00,UFU GRIERSON,263,204,288,141,38,467,455,12,461,6,0,17,168,110,74,59,33,6,0,205,124,126,455
20211231,31DEC2021:00:00:00,UFU GUTIERREZ,225,146,286,62,23,371,367,4,367,4,123,84,34,39,53,24,11,3,0,58,215,93,367
20211231,31DEC2021:00:00:00,UFU MUÑIZ,356,340,338,283,75,696,686,10,690,6,0,60,194,138,142,100,57,5,0,175,364,147,686
20211231,31DEC2021:00:00:00,UFU PENNA,243,146,214,147,28,389,381,8,381,8,0,18,127,108,76,42,16,2,0,113,194,74,381
20211231,31DEC2021:00:00:00,UFU PIROVANO,293,257,393,70,87,550,0,550,538,12,0,24,188,153,76,53,41,15,0,0,0,0,0
20211231,31DEC2021:00:00:00,UFU PIÑERO,271,191,335,90,37,462,20,442,20,442,0,22,149,107,72,68,30,14,0,4,10,6,20
20211231,31DEC2021:00:00:00,UFU RAMOS MEJIA,461,385,682,89,75,846,314,532,314,532,14,76,229,251,125,93,29,29,0,116,108,89,314
20211231,31DEC2021:00:00:00,UFU RIVADAVIA,243,215,352,62,44,458,6,452,6,452,0,19,163,117,72,45,34,8,0,2,0,4,6
20211231,31DEC2021:00:00:00,UFU SANTOJANNI,742,718,803,546,111,1460,1440,20,1440,20,0,123,437,356,275,147,84,38,0,606,491,343,1440
20211231,31DEC2021:00:00:00,UFU TORNU,212,164,302,66,8,376,0,376,0,376,6,23,126,77,75,33,23,13,0,0,0,0,0
20211231,31DEC2021:00:00:00,UFU VELEZ SARSFIELD,232,208,365,57,18,440,3,437,26,414,0,58,128,74,62,54,37,27,0,0,2,1,3
20211231,31DEC2021:00:00:00,UFU ZUBIZARRETA,87,74,127,32,2,161,161,0,161,0,0,11,50,30,35,22,6,7,0,43,51,67,161
20220101,01JAN2022:00:00:00,UFU ALVAREZ,417,359,627,101,48,776,36,740,744,32,20,54,190,181,165,92,44,30,0,14,11,11,36
20220101,01JAN2022:00:00:00,UFU ARGERICH,9,2,7,4,0,11,11,0,11,0,2,2,0,3,2,2,0,0,0,4,3,4,11
20220101,01JAN2022:00:00:00,UFU BORDA-MOYANO,240,266,275,222,9,506,474,32,474,32,1,17,106,172,107,61,18,24,0,189,147,138,474
20220101,01JAN2022:00:00:00,UFU DURAND,362,332,594,80,20,694,0,694,0,694,0,29,194,186,122,77,66,20,0,0,0,0,0
20220101,01JAN2022:00:00:00,UFU ELIZALDE,54,44,38,55,5,98,15,83,84,14,37,53,4,2,2,0,0,0,0,2,8,5,15
20220101,01JAN2022:00:00:00,UFU FERNANDEZ,189,167,239,72,45,356,0,356,134,222,0,14,90,116,59,31,35,11,0,0,0,0,0
20220101,01JAN2022:00:00:00,UFU FERRER,164,154,181,99,38,318,7,311,304,14,0,5,95,69,71,57,21,0,0,4,2,1,7
20220101,01JAN2022:00:00:00,UFU GUTIERREZ,85,59,91,46,7,144,136,8,144,0,60,35,12,8,21,5,3,0,0,23,70,43,136
20220101,01JAN2022:00:00:00,UFU MUÑIZ,365,367,416,260,56,732,712,20,728,4,0,51,199,188,152,86,46,10,0,288,271,153,712
20220101,01JAN2022:00:00:00,UFU PENNA,250,247,310,143,44,497,481,16,481,16,4,26,141,98,92,73,48,15,0,211,169,101,481
20220101,01JAN2022:00:00:00,UFU PIROVANO,392,311,536,103,64,703,6,697,369,334,0,39,184,156,145,101,65,13,0,2,2,2,6
20220101,01JAN2022:00:00:00,UFU PIÑERO,175,136,235,56,20,311,3,308,3,308,0,13,87,76,47,43,41,4,0,0,3,0,3
20220101,01JAN2022:00:00:00,UFU RAMOS MEJIA,376,302,496,94,88,678,220,458,220,458,0,10,182,188,133,83,68,14,0,91,60,69,220
20220101,01JAN2022:00:00:00,UFU RIVADAVIA,208,206,288,80,46,414,0,414,0,414,0,22,122,111,59,67,25,8,0,0,0,0,0
20220101,01JAN2022:00:00:00,UFU SANTOJANNI,113,117,109,110,11,230,230,0,230,0,0,12,67,51,51,23,21,5,0,121,37,72,230
20220101,01JAN2022:00:00:00,UFU TORNU,252,251,449,36,18,503,3,500,3,500,9,40,94,98,123,75,44,20,0,2,0,1,3
20220101,01JAN2022:00:00:00,UFU ZUBIZARRETA,188,155,245,90,8,343,337,6,343,0,0,26,81,81,67,48,28,12,0,106,89,142,337
20220102,02JAN2022:00:00:00,UFU ALVAREZ,723,622,1044,218,83,1345,415,930,1293,52,31,85,323,359,212,176,101,58,0,164,152,99,415
20220102,02JAN2022:00:00:00,UFU ARGERICH,127,70,99,93,5,197,197,0,197,0,3,12,49,42,44,31,8,8,0,61,57,79,197
20220102,02JAN2022:00:00:00,UFU BORDA-MOYANO,345,293,295,298,45,638,384,254,384,254,1,31,195,154,110,86,47,14,0,115,168,101,384
20220102,02JAN2022:00:00:00,UFU DURAND,732,558,1048,160,82,1290,0,1290,26,1264,0,62,331,359,197,178,98,65,0,0,0,0,0
20220102,02JAN2022:00:00:00,UFU ELIZALDE,212,192,151,222,33,406,25,381,382,24,212,139,9,26,11,4,5,0,0,2,14,9,25
20220102,02JAN2022:00:00:00,UFU FERNANDEZ,461,477,620,244,74,938,151,787,370,568,0,23,266,290,167,110,59,23,0,34,86,31,151
20220102,02JAN2022:00:00:00,UFU FERRER,351,303,365,275,14,654,3,651,648,6,0,15,184,148,151,109,40,7,0,2,0,1,3
20220102,02JAN2022:00:00:00,UFU GRIERSON,346,421,437,277,53,767,35,732,753,14,0,29,197,224,149,114,38,16,0,10,13,12,35
20220102,02JAN2022:00:00:00,UFU GUTIERREZ,420,342,559,175,28,762,737,25,740,22,285,244,54,67,63,37,12,0,0,179,398,159,737
20220102,02JAN2022:00:00:00,UFU MUÑIZ,710,569,589,532,158,1279,1240,39,1273,6,3,108,315,297,276,179,81,20,0,430,529,278,1240
20220102,02JAN2022:00:00:00,UFU PENNA,282,215,273,207,17,497,95,402,491,6,23,16,140,140,70,67,26,15,0,30,36,27,95
20220102,02JAN2022:00:00:00,UFU PIROVANO,582,559,818,213,110,1141,60,1081,1091,50,10,99,272,326,207,126,48,53,0,21,22,17,60
20220102,02JAN2022:00:00:00,UFU PIÑERO,474,339,508,251,54,813,15,798,15,798,0,47,241,205,151,86,61,22,0,8,3,4,15
20220102,02JAN2022:00:00:00,UFU RAMOS MEJIA,598,473,819,166,86,1071,57,1014,57,1014,12,73,303,277,170,132,70,34,0,26,14,17,57
20220102,02JAN2022:00:00:00,UFU RIVADAVIA,443,381,600,162,62,824,0,824,6,818,0,22,253,214,123,118,55,39,0,0,0,0,0
20220102,02JAN2022:00:00:00,UFU SANTOJANNI,482,476,430,456,72,958,798,160,798,160,2,53,286,215,150,129,73,50,0,423,177,198,798
20220102,02JAN2022:00:00:00,UFU TORNU,558,523,849,157,75,1081,79,1002,79,1002,33,86,265,285,176,132,66,38,0,19,39,21,79
20220102,02JAN2022:00:00:00,UFU VELEZ SARSFIELD,494,420,592,284,38,914,0,914,0,914,0,40,279,184,164,150,61,36,0,0,0,0,0
20220102,02JAN2022:00:00:00,UFU ZUBIZARRETA,292,241,359,171,3,533,533,0,533,0,0,16,145,99,106,85,50,32,0,203,121,209,533
20220103,03JAN2022:00:00:00,UFU ALVAREZ,644,486,774,250,106,1130,1130,0,1130,0,41,46,398,268,143,111,93,30,0,333,404,393,1130
20220103,03JAN2022:00:00:00,UFU ARGERICH,91,78,97,70,2,169,169,0,169,0,3,9,55,37,22,22,19,2,0,62,20,87,169
20220103,03JAN2022:00:00:00,UFU BORDA-MOYANO,393,396,433,302,54,789,789,0,789,0,2,54,202,196,168,98,56,13,0,196,315,278,789
20220103,03JAN2022:00:00:00,UFU DURAND,400,402,646,99,57,802,802,0,802,0,0,21,220,252,114,97,54,44,0,314,181,307,802
20220103,03JAN2022:00:00:00,UFU ELIZALDE,277,162,135,276,28,439,439,0,439,0,183,91,34,57,43,25,6,0,0,96,118,225,439
20220103,03JAN2022:00:00:00,UFU FERNANDEZ,241,229,348,79,43,470,470,0,470,0,0,6,151,127,81,58,29,18,0,172,102,196,470
20220103,03JAN2022:00:00:00,UFU FERRER,311,306,276,262,79,617,617,0,617,0,0,11,191,169,138,64,37,7,0,219,174,224,617
20220103,03JAN2022:00:00:00,UFU GRIERSON,215,180,205,145,45,395,395,0,395,0,0,15,122,104,80,53,21,0,0,122,139,134,395
20220103,03JAN2022:00:00:00,UFU GUTIERREZ,345,250,341,162,92,595,595,0,595,0,228,111,68,79,64,36,9,0,0,125,271,197,595
20220103,03JAN2022:00:00:00,UFU MUÑIZ,575,639,562,557,95,1214,1214,0,1214,0,4,41,383,318,229,155,66,18,0,327,501,386,1214
20220103,03JAN2022:00:00:00,UFU PENNA,284,234,274,218,26,518,518,0,518,0,0,24,150,138,86,72,23,25,0,178,180,160,518
20220103,03JAN2022:00:00:00,UFU PIROVANO,362,304,502,109,55,666,666,0,666,0,0,14,217,172,126,49,49,39,0,258,142,266,666
20220103,03JAN2022:00:00:00,UFU PIÑERO,432,358,549,198,43,790,790,0,790,0,0,35,310,197,115,81,45,7,0,244,296,250,790
20220103,03JAN2022:00:00:00,UFU RAMOS MEJIA,690,618,958,194,156,1308,1308,0,1308,0,4,42,437,331,209,174,74,37,0,490,250,567,1308
20220103,03JAN2022:00:00:00,UFU RIVADAVIA,630,496,689,295,144,1128,1128,0,1128,0,0,22,462,329,144,95,58,18,0,419,241,468,1128
20220103,03JAN2022:00:00:00,UFU SANTOJANNI,363,450,425,285,103,813,813,0,813,0,0,39,258,185,135,105,69,22,0,420,133,260,813
20220103,03JAN2022:00:00:00,UFU TORNU,537,503,807,178,55,1040,1040,0,1040,0,7,41,312,275,188,128,55,34,0,351,247,422,1040
20220103,03JAN2022:00:00:00,UFU VELEZ SARSFIELD,305,277,412,126,44,582,582,0,582,0,0,19,146,155,114,98,37,13,0,228,161,193,582
20220104,04JAN2022:00:00:00,UFU ALVAREZ,702,571,885,271,117,1273,1273,0,1273,0,38,87,463,306,164,119,48,48,0,499,306,468,1273
20220104,04JAN2022:00:00:00,UFU ARGERICH,13,21,17,17,0,34,34,0,34,0,1,3,5,10,3,6,5,1,0,10,11,13,34
20220104,04JAN2022:00:00:00,UFU BORDA-MOYANO,414,384,449,295,56,800,800,0,800,0,5,43,214,211,169,102,42,14,0,230,278,292,800
20220104,04JAN2022:00:00:00,UFU DURAND,697,537,1042,118,74,1234,1234,0,1234,0,0,41,438,361,191,113,58,32,0,500,238,496,1234
20220104,04JAN2022:00:00:00,UFU ELIZALDE,325,199,217,286,21,524,524,0,524,0,224,125,44,77,28,13,10,3,0,107,146,271,524
20220104,04JAN2022:00:00:00,UFU FERNANDEZ,460,366,565,147,114,826,826,0,826,0,0,22,324,251,106,68,29,26,0,202,102,522,826
20220104,04JAN2022:00:00:00,UFU FERRER,328,385,352,266,95,713,713,0,713,0,0,13,219,202,170,75,34,0,0,228,238,247,713
20220104,04JAN2022:00:00:00,UFU GRIERSON,269,189,223,196,39,458,458,0,458,0,0,20,164,108,83,52,28,3,0,163,153,140,458
20220104,04JAN2022:00:00:00,UFU GUTIERREZ,415,305,472,154,94,720,720,0,720,0,231,218,50,101,77,40,3,0,0,197,298,217,720
20220104,04JAN2022:00:00:00,UFU MUÑIZ,612,617,633,517,79,1229,1229,0,1229,0,5,49,381,327,240,161,52,14,0,353,487,389,1229
20220104,04JAN2022:00:00:00,UFU PENNA,293,235,260,238,30,528,528,0,528,0,10,20,163,161,72,65,27,10,0,198,150,180,528
20220104,04JAN2022:00:00:00,UFU PIROVANO,378,347,513,141,71,725,725,0,725,0,0,18,232,213,119,60,53,30,0,313,132,279,725
20220104,04JAN2022:00:00:00,UFU PIÑERO,556,512,715,250,103,1068,1068,0,1068,0,0,63,421,200,177,144,48,15,0,327,388,353,1068
20220104,04JAN2022:00:00:00,UFU RAMOS MEJIA,657,555,865,206,141,1212,1212,0,1212,0,5,60,351,344,211,136,84,21,0,507,212,493,1212
20220104,04JAN2022:00:00:00,UFU RIVADAVIA,639,544,831,210,142,1183,1183,0,1183,0,0,35,479,329,157,117,46,20,0,444,213,526,1183
20220104,04JAN2022:00:00:00,UFU SANTOJANNI,414,408,419,327,76,822,822,0,822,0,0,57,255,200,153,102,37,18,0,451,127,244,822
20220104,04JAN2022:00:00:00,UFU TORNU,664,523,903,198,86,1187,1187,0,1187,0,19,77,348,301,213,129,50,50,0,210,176,799,1187
20220104,04JAN2022:00:00:00,UFU VELEZ SARSFIELD,376,358,559,147,28,734,734,0,734,0,0,25,227,183,128,83,66,22,0,249,242,243,734
20220105,05JAN2022:00:00:00,UFU ALVAREZ,769,585,942,307,105,1354,1354,0,1354,0,48,78,451,350,195,131,64,37,0,447,390,517,1354
20220105,05JAN2022:00:00:00,UFU ARGERICH,121,88,142,63,4,209,209,0,209,0,13,6,59,56,33,25,12,5,0,75,43,91,209
20220105,05JAN2022:00:00:00,UFU BORDA-MOYANO,477,517,554,353,87,994,994,0,994,0,11,63,270,242,187,139,71,11,0,237,363,394,994
20220105,05JAN2022:00:00:00,UFU DURAND,759,621,1089,186,105,1380,1380,0,1380,0,2,56,505,366,228,125,59,39,0,537,279,564,1380
20220105,05JAN2022:00:00:00,UFU ELIZALDE,347,197,252,279,13,544,544,0,544,0,213,146,50,69,38,11,11,6,0,124,141,279,544
20220105,05JAN2022:00:00:00,UFU FERNANDEZ,404,353,501,141,115,757,757,0,757,0,3,19,267,219,126,60,44,19,0,279,163,312,757
20220105,05JAN2022:00:00:00,UFU FERRER,340,346,343,266,77,686,686,0,686,0,2,20,271,163,107,83,32,8,0,230,230,226,686
20220105,05JAN2022:00:00:00,UFU GRIERSON,195,276,242,169,60,471,471,0,471,0,0,23,167,106,83,58,28,6,0,166,149,156,471
20220105,05JAN2022:00:00:00,UFU GUTIERREZ,452,359,523,179,109,811,811,0,811,0,258,238,65,97,116,23,12,2,0,174,385,249,811
20220105,05JAN2022:00:00:00,UFU MUÑIZ,732,672,749,580,75,1404,1404,0,1404,0,2,64,471,417,242,137,59,12,0,429,513,462,1404
20220105,05JAN2022:00:00:00,UFU PENNA,339,247,298,252,36,586,586,0,586,0,15,39,200,120,98,72,32,10,0,197,202,187,586
20220105,05JAN2022:00:00:00,UFU PIROVANO,390,312,504,124,74,702,702,0,702,0,0,26,227,192,110,80,38,29,0,255,94,353,702
20210804,04AUG2021:00:00:00,UFU RIVADAVIA,131,111,158,60,24,242,140,102,140,102,0,6,68,66,26,46,22,8,0,12,77,51,140
20210804,04AUG2021:00:00:00,UFU SANTOJANNI,254,206,219,227,14,460,442,18,452,8,29,46,98,102,85,65,23,12,0,24,300,118,442
20210804,04AUG2021:00:00:00,UFU TORNU,189,138,265,52,10,327,299,28,303,24,16,28,48,80,73,53,13,16,0,18,198,80,299
20210804,04AUG2021:00:00:00,UFU VELEZ SARSFIELD,225,154,306,66,7,379,351,28,365,14,0,25,67,93,89,62,29,14,0,22,232,97,351
20210804,04AUG2021:00:00:00,UFU ZUBIZARRETA,60,53,62,32,19,113,113,0,113,0,0,0,12,35,21,15,22,8,0,5,77,31,113
20210805,05AUG2021:00:00:00,UFU ALVAREZ,165,155,219,63,38,320,306,14,308,12,33,21,76,60,69,30,17,14,0,18,195,93,306
20210805,05AUG2021:00:00:00,UFU ARGERICH,59,89,84,50,14,148,124,24,124,24,18,8,38,35,22,9,18,0,0,7,67,50,124
20210805,05AUG2021:00:00:00,UFU BORDA-MOYANO,38,44,37,27,18,82,76,6,76,6,0,6,8,25,25,8,7,3,0,2,54,20,76
20210805,05AUG2021:00:00:00,UFU DURAND,119,84,162,12,29,203,187,16,187,16,0,10,57,59,34,27,14,2,0,19,94,74,187
20210805,05AUG2021:00:00:00,UFU ELIZALDE,129,132,56,168,37,261,225,36,247,14,162,63,11,13,8,4,0,0,0,4,142,79,225
20210805,05AUG2021:00:00:00,UFU FERNANDEZ,118,71,153,18,18,189,181,8,189,0,0,13,69,36,21,23,17,10,0,16,96,69,181
20210805,05AUG2021:00:00:00,UFU FERRER,136,114,142,81,27,250,242,8,246,4,0,2,62,92,48,33,13,0,0,11,168,63,242
20210805,05AUG2021:00:00:00,UFU GRIERSON,113,88,96,81,24,201,199,2,199,2,0,21,37,68,37,18,11,9,0,13,132,54,199
20210805,05AUG2021:00:00:00,UFU GUTIERREZ,173,128,180,107,14,301,281,20,293,8,170,45,21,27,19,19,0,0,0,6,191,83,281
20210805,05AUG2021:00:00:00,UFU MUÑIZ,130,138,120,86,62,268,226,42,240,28,0,17,55,60,56,46,23,11,0,9,153,64,226
20210805,05AUG2021:00:00:00,UFU PENNA,85,83,73,72,23,168,154,14,160,8,0,8,21,48,34,32,15,10,0,7,106,41,154
20210805,05AUG2021:00:00:00,UFU PIROVANO,181,120,218,47,36,301,279,22,289,12,0,12,77,97,43,36,25,11,0,13,152,114,279
20210805,05AUG2021:00:00:00,UFU PIÑERO,96,127,146,45,32,223,215,8,219,4,4,7,63,62,43,17,17,10,0,5,149,60,215
20210805,05AUG2021:00:00:00,UFU RAMOS MEJIA,190,172,277,53,32,362,338,24,352,10,18,12,91,83,68,47,28,15,0,16,225,97,338
20210805,05AUG2021:00:00:00,UFU RIVADAVIA,158,91,162,46,41,249,241,8,241,8,0,19,74,70,31,29,21,5,0,23,118,99,241
20210805,05AUG2021:00:00:00,UFU SANTOJANNI,193,141,155,132,47,334,312,22,326,8,6,39,73,69,63,46,27,11,0,15,227,70,312
20210805,05AUG2021:00:00:00,UFU TORNU,170,144,230,42,42,314,284,30,284,30,17,30,75,55,46,51,29,11,0,14,199,69,284
20210805,05AUG2021:00:00:00,UFU VELEZ SARSFIELD,181,120,223,57,21,301,293,8,297,4,2,25,61,71,53,51,24,14,0,9,210,74,293
20210805,05AUG2021:00:00:00,UFU ZUBIZARRETA,93,60,86,53,14,153,135,18,153,0,0,30,28,43,14,21,11,6,0,9,91,35,135
20210806,06AUG2021:00:00:00,UFU ALVAREZ,202,173,308,52,15,375,347,28,349,26,35,17,84,93,57,49,28,12,0,15,240,92,347
20210806,06AUG2021:00:00:00,UFU ARGERICH,78,59,80,51,6,137,127,10,127,10,12,13,29,23,24,11,18,7,0,14,59,54,127
20210806,06AUG2021:00:00:00,UFU BORDA-MOYANO,31,42,29,37,7,73,67,6,67,6,2,9,16,11,28,5,0,2,0,7,36,24,67
20210806,06AUG2021:00:00:00,UFU DURAND,154,94,204,23,21,248,236,12,236,12,7,14,55,63,40,35,27,7,0,12,124,100,236
20210806,06AUG2021:00:00:00,UFU ELIZALDE,132,97,76,151,2,229,165,64,199,30,127,61,21,9,4,2,5,0,0,3,93,69,165
20210806,06AUG2021:00:00:00,UFU FERNANDEZ,132,147,198,55,26,279,245,34,267,12,0,13,84,90,46,29,13,4,0,14,157,74,245
20210806,06AUG2021:00:00:00,UFU FERRER,168,85,151,94,8,253,243,10,249,4,0,13,45,82,39,33,31,10,0,9,168,66,243
20210806,06AUG2021:00:00:00,UFU GRIERSON,134,95,92,123,14,229,219,10,223,6,0,17,50,62,35,47,15,3,0,16,139,64,219
20210806,06AUG2021:00:00:00,UFU GUTIERREZ,148,124,180,92,0,272,260,12,268,4,157,60,6,21,13,10,5,0,0,5,173,81,260
20210806,06AUG2021:00:00:00,UFU MUÑIZ,104,121,104,98,23,225,191,34,195,30,0,5,40,63,52,46,9,10,0,7,130,54,191
20210806,06AUG2021:00:00:00,UFU PENNA,68,79,94,46,7,147,135,12,141,6,2,2,29,59,25,20,7,3,0,6,97,32,135
20210806,06AUG2021:00:00:00,UFU PIROVANO,174,169,285,36,22,343,327,16,337,6,0,15,69,105,67,46,23,18,0,22,170,135,327
20210806,06AUG2021:00:00:00,UFU PIÑERO,63,68,119,10,2,131,123,8,123,8,0,3,35,6,39,19,21,8,0,5,81,37,123
20210806,06AUG2021:00:00:00,UFU RAMOS MEJIA,164,166,232,57,41,330,286,44,304,26,8,21,75,72,66,40,38,10,0,17,184,85,286
20210806,06AUG2021:00:00:00,UFU RIVADAVIA,122,119,177,44,20,241,235,6,235,6,0,9,88,51,35,23,24,11,0,24,121,90,235
20210806,06AUG2021:00:00:00,UFU SANTOJANNI,222,210,233,189,10,432,424,8,430,2,27,23,101,97,60,49,63,12,0,21,293,110,424
20210806,06AUG2021:00:00:00,UFU TORNU,173,136,263,35,11,309,271,38,277,32,22,43,54,58,72,23,24,13,0,10,183,75,271
20210806,06AUG2021:00:00:00,UFU VELEZ SARSFIELD,185,123,222,69,17,308,302,6,304,4,0,27,84,50,46,53,26,22,0,26,179,97,302
20210806,06AUG2021:00:00:00,UFU ZUBIZARRETA,157,119,192,65,19,276,272,4,276,0,0,43,48,37,54,45,20,29,0,13,181,78,272
20210807,07AUG2021:00:00:00,UFU ALVAREZ,157,119,225,36,15,276,260,16,260,16,17,18,64,57,38,51,15,16,0,14,177,69,260
20210807,07AUG2021:00:00:00,UFU ARGERICH,3,2,5,0,0,5,5,0,5,0,1,0,0,0,2,0,0,2,0,0,3,2,5
20210807,07AUG2021:00:00:00,UFU BORDA-MOYANO,47,25,47,20,5,72,72,0,72,0,0,2,14,25,15,7,7,2,0,3,42,27,72
20210807,07AUG2021:00:00:00,UFU DURAND,122,110,208,12,12,232,226,6,228,4,4,20,63,61,37,27,15,5,0,17,109,100,226
20210807,07AUG2021:00:00:00,UFU ELIZALDE,87,95,54,119,9,182,156,26,168,14,107,42,14,13,5,1,0,0,0,1,95,60,156
20210807,07AUG2021:00:00:00,UFU FERNANDEZ,120,90,177,19,14,210,192,18,206,4,0,12,66,45,40,24,9,14,0,8,118,66,192
20210807,07AUG2021:00:00:00,UFU FERRER,83,57,72,63,5,140,134,6,136,4,0,0,31,44,30,20,10,5,0,6,92,36,134
20210807,07AUG2021:00:00:00,UFU GRIERSON,107,78,87,81,17,185,181,4,183,2,0,5,39,49,45,18,23,6,0,6,127,47,181
20210807,07AUG2021:00:00:00,UFU GUTIERREZ,94,109,121,75,7,203,193,10,201,2,134,25,9,21,14,0,0,0,0,4,134,54,193
20210807,07AUG2021:00:00:00,UFU MUÑIZ,103,119,101,108,13,222,214,8,218,4,0,13,45,44,69,21,22,8,0,9,152,53,214
20210807,07AUG2021:00:00:00,UFU PENNA,78,41,64,46,9,119,111,8,115,4,3,1,17,38,25,13,12,10,0,4,78,29,111
20210807,07AUG2021:00:00:00,UFU PIROVANO,141,134,225,26,24,275,255,20,263,12,0,3,49,87,58,41,24,13,0,20,115,120,255
20210807,07AUG2021:00:00:00,UFU PIÑERO,90,54,104,40,0,144,142,2,142,2,0,7,27,39,20,36,5,10,0,3,103,34,142
20210807,07AUG2021:00:00:00,UFU RAMOS MEJIA,125,110,181,32,22,235,229,6,229,6,12,14,55,65,32,34,7,16,0,14,149,66,229
20210807,07AUG2021:00:00:00,UFU RIVADAVIA,149,128,226,29,22,277,197,80,197,80,4,7,78,78,49,34,16,11,0,13,99,81,197
20210807,07AUG2021:00:00:00,UFU SANTOJANNI,221,195,207,205,4,416,399,17,409,7,2,17,83,105,78,44,51,36,0,42,249,108,399
20210807,07AUG2021:00:00:00,UFU TORNU,167,125,220,39,33,292,282,10,282,10,10,32,63,54,45,51,26,11,0,7,196,79,282
20210807,07AUG2021:00:00:00,UFU VELEZ SARSFIELD,175,159,238,85,11,334,322,12,330,4,0,16,65,58,78,63,41,13,0,13,217,92,322
20210807,07AUG2021:00:00:00,UFU ZUBIZARRETA,206,166,281,89,2,372,366,6,372,0,0,21,55,72,101,46,38,39,0,13,255,98,366
20210808,08AUG2021:00:00:00,UFU ALVAREZ,128,87,182,28,5,215,203,12,203,12,24,22,34,66,39,23,4,3,0,13,135,55,203
20210808,08AUG2021:00:00:00,UFU ARGERICH,27,22,28,17,4,49,45,4,49,0,7,4,8,10,7,8,4,1,0,4,23,18,45
20210928,28SEP2021:00:00:00,UFU DURAND,101,95,157,23,16,196,184,12,184,12,27,23,28,42,34,19,17,6,0,0,110,74,184
20210928,28SEP2021:00:00:00,UFU ELIZALDE,175,162,115,212,10,337,308,29,316,21,186,96,17,27,9,2,0,0,0,0,198,110,308
20210928,28SEP2021:00:00:00,UFU FERNANDEZ,88,56,122,13,9,144,128,16,142,2,0,6,33,46,27,15,10,7,0,2,77,49,128
20210928,28SEP2021:00:00:00,UFU FERRER,94,65,77,73,9,159,159,0,159,0,0,12,28,35,40,38,3,3,0,5,113,41,159
20210928,28SEP2021:00:00:00,UFU GRIERSON,52,76,74,33,21,128,120,8,122,6,0,8,35,36,29,13,3,4,0,0,90,30,120
20210928,28SEP2021:00:00:00,UFU GUTIERREZ,210,160,221,129,20,370,342,28,364,6,230,92,19,14,12,3,0,0,0,4,222,110,342
20210928,28SEP2021:00:00:00,UFU MUÑIZ,61,89,69,66,15,150,114,36,118,32,6,11,37,34,32,20,10,0,0,0,74,40,114
20210928,28SEP2021:00:00:00,UFU PENNA,87,54,88,47,6,141,131,10,131,10,43,27,17,23,10,13,5,3,0,1,94,36,131
20210928,28SEP2021:00:00:00,UFU PIROVANO,142,69,174,26,11,211,199,12,205,6,0,13,49,48,47,22,19,13,0,0,116,83,199
20210928,28SEP2021:00:00:00,UFU PIÑERO,107,154,214,38,9,261,249,12,249,12,92,42,39,34,28,15,8,3,0,1,183,65,249
20210928,28SEP2021:00:00:00,UFU RAMOS MEJIA,141,119,181,62,17,260,232,28,260,0,30,26,40,55,44,21,33,11,0,0,143,89,232
20210928,28SEP2021:00:00:00,UFU RIVADAVIA,104,75,119,28,32,179,149,30,149,30,0,3,63,55,27,16,10,5,0,0,86,63,149
20210928,28SEP2021:00:00:00,UFU SANTOJANNI,134,82,129,73,14,216,202,14,212,4,0,41,43,42,48,15,19,8,0,1,125,76,202
20210928,28SEP2021:00:00:00,UFU TORNU,197,133,267,42,21,330,228,102,242,88,48,27,60,66,71,41,12,5,0,2,147,78,228
20210928,28SEP2021:00:00:00,UFU VELEZ SARSFIELD,115,106,164,48,9,221,217,4,219,2,0,25,44,51,46,30,16,9,0,1,156,60,217
20210928,28SEP2021:00:00:00,UFU ZUBIZARRETA,119,127,131,85,30,246,246,0,246,0,0,34,63,50,67,12,10,10,0,2,181,63,246
20210929,29SEP2021:00:00:00,UFU ALVAREZ,211,148,282,59,18,359,335,24,337,22,72,36,73,66,37,27,18,30,0,0,245,90,335
20210929,29SEP2021:00:00:00,UFU ARGERICH,69,51,84,33,3,120,88,32,88,32,14,14,24,27,16,9,7,9,0,0,48,40,88
20210929,29SEP2021:00:00:00,UFU BORDA-MOYANO,15,10,19,6,0,25,23,2,23,2,0,6,7,2,9,0,1,0,0,0,15,8,23
20210929,29SEP2021:00:00:00,UFU DURAND,123,112,210,14,11,235,219,16,219,16,23,35,35,62,46,16,10,8,0,6,119,94,219
20210929,29SEP2021:00:00:00,UFU ELIZALDE,237,173,161,249,0,410,358,52,398,12,262,102,8,14,15,9,0,0,0,1,250,107,358
20210929,29SEP2021:00:00:00,UFU FERNANDEZ,67,52,93,16,10,119,105,14,105,14,0,3,42,33,17,9,5,10,0,7,58,40,105
20210929,29SEP2021:00:00:00,UFU FERRER,103,75,111,67,0,178,168,10,174,4,0,2,30,57,41,24,16,8,0,4,121,43,168
20210929,29SEP2021:00:00:00,UFU GRIERSON,140,97,165,39,33,237,183,54,229,8,14,49,32,45,40,33,22,2,0,0,130,53,183
20210929,29SEP2021:00:00:00,UFU GUTIERREZ,146,161,196,106,5,307,295,12,305,2,226,65,0,8,3,0,5,0,0,1,200,94,295
20210929,29SEP2021:00:00:00,UFU MUÑIZ,106,98,125,59,20,204,178,26,178,26,7,21,41,38,28,41,25,3,0,1,131,46,178
20210929,29SEP2021:00:00:00,UFU PENNA,74,53,76,46,5,127,123,4,123,4,27,22,26,26,11,8,4,3,0,0,90,33,123
20210929,29SEP2021:00:00:00,UFU PIROVANO,134,108,198,22,22,242,234,8,238,4,0,24,37,82,39,30,22,8,0,7,131,96,234
20210929,29SEP2021:00:00:00,UFU PIÑERO,80,109,142,39,8,189,171,18,171,18,86,29,21,24,10,10,3,6,0,0,132,39,171
20210929,29SEP2021:00:00:00,UFU RAMOS MEJIA,115,109,159,38,27,224,200,24,208,16,28,23,42,37,40,33,10,11,0,4,122,74,200
20210929,29SEP2021:00:00:00,UFU RIVADAVIA,98,63,123,23,15,161,131,30,131,30,2,6,52,41,20,13,12,15,0,1,72,58,131
20210929,29SEP2021:00:00:00,UFU SANTOJANNI,135,90,123,93,9,225,217,8,223,2,15,23,45,45,28,34,23,12,0,0,132,85,217
20210929,29SEP2021:00:00:00,UFU TORNU,234,141,309,45,21,375,271,104,271,104,82,36,45,86,81,13,9,23,0,4,195,69,271
20210929,29SEP2021:00:00:00,UFU VELEZ SARSFIELD,97,104,158,38,5,201,199,2,199,2,0,20,38,45,27,24,34,13,0,2,141,56,199
20210929,29SEP2021:00:00:00,UFU ZUBIZARRETA,72,60,102,20,10,132,128,4,132,0,0,12,14,38,26,18,14,10,0,2,94,32,128
20210930,30SEP2021:00:00:00,UFU ALVAREZ,91,120,167,35,9,211,189,22,197,14,62,27,36,31,26,18,7,4,0,3,128,58,189
20210930,30SEP2021:00:00:00,UFU ARGERICH,50,40,63,23,4,90,66,24,66,24,17,22,16,13,14,8,0,0,0,0,37,29,66
20210930,30SEP2021:00:00:00,UFU BORDA-MOYANO,24,11,25,10,0,35,33,2,33,2,0,2,14,8,4,4,2,1,0,0,23,10,33
20210930,30SEP2021:00:00:00,UFU DURAND,103,91,170,20,4,194,186,8,190,4,28,12,31,59,35,12,4,13,0,9,104,73,186
20210930,30SEP2021:00:00:00,UFU ELIZALDE,108,127,87,146,2,235,199,36,227,8,140,53,12,15,11,2,0,2,0,6,120,73,199
20210930,30SEP2021:00:00:00,UFU FERNANDEZ,62,52,92,20,2,114,108,6,108,6,0,6,20,37,21,18,10,2,0,2,63,43,108
20210930,30SEP2021:00:00:00,UFU FERRER,70,70,74,64,2,140,136,4,140,0,0,0,25,47,32,27,9,0,0,1,96,39,136
20210930,30SEP2021:00:00:00,UFU GRIERSON,93,61,89,53,12,154,150,4,154,0,0,26,41,21,25,28,6,7,0,0,115,35,150
20210930,30SEP2021:00:00:00,UFU GUTIERREZ,113,164,193,82,2,277,265,12,275,2,190,54,6,13,10,4,0,0,0,1,189,75,265
20210930,30SEP2021:00:00:00,UFU MUÑIZ,82,82,59,95,10,164,138,26,140,24,13,8,19,36,37,24,12,15,0,1,99,38,138
20210930,30SEP2021:00:00:00,UFU PENNA,58,42,80,16,4,100,96,4,96,4,25,12,17,18,9,8,9,2,0,2,65,29,96
20210930,30SEP2021:00:00:00,UFU PIROVANO,110,123,194,24,15,233,219,14,227,6,0,11,41,70,58,31,16,6,0,0,126,93,219
20210930,30SEP2021:00:00:00,UFU PIÑERO,107,75,148,28,6,182,178,4,182,0,73,28,17,13,35,7,4,5,0,0,132,45,178
20210930,30SEP2021:00:00:00,UFU RAMOS MEJIA,100,72,127,18,27,172,170,2,172,0,10,11,30,50,26,16,21,8,0,1,104,65,170
20210930,30SEP2021:00:00:00,UFU RIVADAVIA,74,42,78,28,10,116,78,38,78,38,0,4,27,29,19,14,17,6,0,0,49,29,78
20210930,30SEP2021:00:00:00,UFU SANTOJANNI,77,55,75,57,0,132,128,4,130,2,0,27,26,26,23,11,12,7,0,1,77,50,128
20210930,30SEP2021:00:00:00,UFU TORNU,138,119,202,39,16,257,171,86,171,86,41,36,25,66,46,22,15,6,0,2,128,40,171
20210930,30SEP2021:00:00:00,UFU VELEZ SARSFIELD,104,66,139,22,9,170,162,8,168,2,0,24,22,32,49,25,16,2,0,4,108,50,162
20210930,30SEP2021:00:00:00,UFU ZUBIZARRETA,68,40,73,32,3,108,108,0,108,0,0,8,27,31,21,10,6,5,0,0,86,22,108
20211001,01OCT2021:00:00:00,UFU ALVAREZ,113,106,152,44,23,219,205,14,207,12,66,17,28,26,30,11,21,20,0,2,141,62,205
20211001,01OCT2021:00:00:00,UFU ARGERICH,45,52,40,45,12,97,71,26,73,24,8,6,12,22,16,8,16,9,0,2,41,28,71
20211001,01OCT2021:00:00:00,UFU BORDA-MOYANO,20,16,27,8,1,36,32,4,32,4,2,6,3,8,6,9,0,2,0,0,23,9,32
20211001,01OCT2021:00:00:00,UFU DURAND,97,63,120,11,29,160,154,6,154,6,7,14,31,49,23,17,4,15,0,4,93,57,154
20211001,01OCT2021:00:00:00,UFU ELIZALDE,94,105,58,118,23,199,185,14,193,6,143,35,4,4,5,2,6,0,0,1,113,71,185
20211001,01OCT2021:00:00:00,UFU FERNANDEZ,54,56,82,12,16,110,100,10,104,6,0,3,24,37,13,12,12,9,0,6,57,37,100
20211001,01OCT2021:00:00:00,UFU FERRER,64,58,78,36,8,122,118,4,118,4,0,3,13,36,32,16,14,8,0,1,84,33,118
20211001,01OCT2021:00:00:00,UFU GRIERSON,107,74,131,35,15,181,103,78,173,8,0,17,34,50,48,16,14,2,0,0,76,27,103
20211001,01OCT2021:00:00:00,UFU GUTIERREZ,102,126,153,62,13,228,212,16,224,4,143,54,3,13,7,6,2,0,0,4,158,49,212
20211001,01OCT2021:00:00:00,UFU MUÑIZ,95,99,90,67,37,194,176,18,178,16,6,13,50,42,44,22,17,0,0,1,119,56,176
20211001,01OCT2021:00:00:00,UFU PENNA,40,35,43,30,2,75,63,12,63,12,33,10,3,12,4,7,4,2,0,0,44,19,63
20220115,15JAN2022:00:00:00,UFU PIROVANO,311,239,377,106,67,550,550,0,550,0,0,16,136,132,112,96,35,23,0,236,79,235,550
20220115,15JAN2022:00:00:00,UFU PIÑERO,431,368,551,181,67,799,799,0,799,0,0,48,155,237,179,94,60,26,0,258,270,271,799
20220115,15JAN2022:00:00:00,UFU RAMOS MEJIA,490,453,703,159,81,943,943,0,943,0,20,65,190,238,182,135,73,40,0,382,171,389,943
20220115,15JAN2022:00:00:00,UFU RIVADAVIA,644,559,802,228,173,1203,1203,0,1203,0,4,42,316,309,200,182,105,45,0,468,207,527,1203
20220115,15JAN2022:00:00:00,UFU SANTOJANNI,427,391,368,389,61,818,818,0,818,0,0,48,186,221,167,122,52,22,0,373,110,334,818
20220115,15JAN2022:00:00:00,UFU TORNU,393,376,597,91,81,769,769,0,769,0,18,27,156,197,177,113,34,47,0,298,120,348,769
20220115,15JAN2022:00:00:00,UFU VELEZ SARSFIELD,303,281,407,140,37,584,584,0,584,0,0,16,126,160,124,71,68,19,0,256,87,241,584
20220115,15JAN2022:00:00:00,UFU ZUBIZARRETA,305,338,396,231,16,643,643,0,643,0,0,31,133,166,147,104,36,26,0,213,163,267,643
20220116,16JAN2022:00:00:00,UFU ALVAREZ,673,516,947,151,91,1189,1189,0,1189,0,55,93,208,265,227,177,110,54,0,442,245,502,1189
20220116,16JAN2022:00:00:00,UFU DURAND,651,543,988,129,77,1194,1194,0,1194,0,0,29,250,375,234,144,118,44,0,551,153,490,1194
20220116,16JAN2022:00:00:00,UFU ELIZALDE,222,152,110,237,27,374,374,0,374,0,191,84,20,36,25,14,2,2,0,109,72,193,374
20220116,16JAN2022:00:00:00,UFU FERNANDEZ,387,321,471,139,98,708,708,0,708,0,0,20,145,175,162,98,61,47,0,250,176,280,708
20220116,16JAN2022:00:00:00,UFU FERRER,371,324,338,321,36,695,695,0,695,0,0,11,146,182,176,92,66,22,0,263,193,239,695
20220116,16JAN2022:00:00:00,UFU GRIERSON,171,188,229,110,20,359,359,0,359,0,0,8,92,75,87,59,24,14,0,154,77,127,359
20220116,16JAN2022:00:00:00,UFU GUTIERREZ,349,270,435,132,52,619,619,0,619,0,242,218,12,56,75,15,0,1,0,153,263,202,619
20220116,16JAN2022:00:00:00,UFU MUÑIZ,357,286,319,252,72,643,643,0,643,0,0,20,120,169,175,90,45,24,0,286,88,269,643
20220116,16JAN2022:00:00:00,UFU PENNA,229,152,215,143,23,381,381,0,381,0,0,8,94,111,81,42,38,7,0,137,131,113,381
20220116,16JAN2022:00:00:00,UFU PIROVANO,385,329,478,122,114,714,714,0,714,0,18,42,134,164,164,91,50,51,0,308,104,302,714
20220116,16JAN2022:00:00:00,UFU PIÑERO,413,320,512,149,72,733,733,0,733,0,0,27,194,195,152,110,35,20,0,249,261,220,733
20220116,16JAN2022:00:00:00,UFU RAMOS MEJIA,532,477,756,160,93,1009,1009,0,1009,0,26,59,197,271,197,136,93,30,0,441,139,412,1009
20220116,16JAN2022:00:00:00,UFU RIVADAVIA,577,456,710,198,125,1033,1033,0,1033,0,0,21,221,283,223,156,93,36,0,409,191,431,1033
20220116,16JAN2022:00:00:00,UFU SANTOJANNI,414,336,331,356,63,750,750,0,750,0,2,34,114,169,208,134,53,36,0,324,106,320,750
20220116,16JAN2022:00:00:00,UFU TORNU,381,302,553,80,50,683,683,0,683,0,18,37,111,141,166,126,53,31,0,263,134,285,683
20220116,16JAN2022:00:00:00,UFU VELEZ SARSFIELD,490,405,622,213,60,895,895,0,895,0,0,23,161,242,222,120,99,28,0,363,224,308,895
20220116,16JAN2022:00:00:00,UFU ZUBIZARRETA,327,355,434,225,23,682,682,0,682,0,0,25,121,194,143,97,62,40,0,282,110,290,682
20220117,17JAN2022:00:00:00,UFU ALVAREZ,727,665,1031,224,137,1392,1392,0,1392,0,53,98,289,339,321,142,88,62,0,452,292,648,1392
20220117,17JAN2022:00:00:00,UFU ARGERICH,24,22,26,20,0,46,46,0,46,0,1,0,14,13,10,6,1,1,0,20,5,21,46
20220117,17JAN2022:00:00:00,UFU BORDA-MOYANO,426,358,400,329,55,784,784,0,784,0,6,33,152,195,189,131,61,17,0,287,161,336,784
20220117,17JAN2022:00:00:00,UFU DURAND,683,608,1075,145,71,1291,1291,0,1291,0,0,60,289,365,271,132,121,53,0,539,224,528,1291
20220117,17JAN2022:00:00:00,UFU ELIZALDE,283,229,175,314,23,512,512,0,512,0,246,112,25,72,35,10,8,4,0,146,125,241,512
20220117,17JAN2022:00:00:00,UFU FERNANDEZ,418,323,484,115,142,741,741,0,741,0,0,15,194,212,117,106,60,37,0,294,141,306,741
20220117,17JAN2022:00:00:00,UFU FERRER,271,305,215,246,115,576,576,0,576,0,0,5,144,179,128,67,36,17,0,238,130,208,576
20220117,17JAN2022:00:00:00,UFU GRIERSON,179,172,204,120,27,351,351,0,351,0,0,16,65,115,79,48,9,19,0,140,99,111,351
20220117,17JAN2022:00:00:00,UFU GUTIERREZ,329,210,304,142,93,539,539,0,539,0,209,108,35,85,72,27,3,0,0,155,188,195,539
20220117,17JAN2022:00:00:00,UFU MUÑIZ,389,444,358,348,127,833,833,0,833,0,2,25,192,230,200,110,59,15,0,318,171,344,833
20220117,17JAN2022:00:00:00,UFU PENNA,373,266,333,268,38,639,639,0,639,0,14,23,121,150,135,108,60,28,0,201,231,207,639
20220117,17JAN2022:00:00:00,UFU PIROVANO,446,471,629,149,139,917,917,0,917,0,0,31,221,252,189,100,65,59,0,401,151,364,917
20220117,17JAN2022:00:00:00,UFU PIÑERO,572,415,704,213,70,987,987,0,987,0,0,45,218,226,211,178,88,21,0,316,369,298,987
20220117,17JAN2022:00:00:00,UFU RAMOS MEJIA,682,601,813,327,143,1283,1283,0,1283,0,3,21,278,375,280,156,123,47,0,516,193,567,1283
20220117,17JAN2022:00:00:00,UFU RIVADAVIA,648,526,714,313,147,1174,1174,0,1174,0,2,32,304,338,183,155,97,63,0,447,229,495,1174
20220117,17JAN2022:00:00:00,UFU SANTOJANNI,424,431,334,338,183,855,855,0,855,0,8,33,212,216,182,136,44,24,0,353,155,347,855
20220117,17JAN2022:00:00:00,UFU TORNU,518,475,759,163,71,993,993,0,993,0,26,38,185,277,224,125,74,44,0,328,165,497,993
20220117,17JAN2022:00:00:00,UFU VELEZ SARSFIELD,420,378,580,170,48,798,798,0,798,0,0,25,163,208,177,108,85,32,0,301,208,289,798
20220117,17JAN2022:00:00:00,UFU ZUBIZARRETA,331,369,416,241,43,700,700,0,700,0,0,34,148,191,136,96,54,41,0,274,125,301,700
20220118,18JAN2022:00:00:00,UFU ALVAREZ,845,656,1045,281,243,1569,1569,0,1569,0,82,84,292,370,300,255,123,63,0,408,393,768,1569
20220118,18JAN2022:00:00:00,UFU ARGERICH,85,63,62,69,38,169,169,0,169,0,29,10,37,44,26,9,9,5,0,60,28,81,169
20220118,18JAN2022:00:00:00,UFU BORDA-MOYANO,311,400,358,295,157,810,810,0,810,0,104,41,155,157,178,129,41,5,0,257,131,422,810
20220118,18JAN2022:00:00:00,UFU DURAND,743,584,1027,153,194,1374,1374,0,1374,0,47,53,291,408,270,146,98,61,0,529,171,674,1374
20220118,18JAN2022:00:00:00,UFU ELIZALDE,246,203,151,279,84,514,514,0,514,0,301,91,21,46,34,8,9,4,0,147,97,270,514
20220118,18JAN2022:00:00:00,UFU FERNANDEZ,549,436,676,150,224,1050,1050,0,1050,0,70,30,267,223,194,134,84,48,0,302,208,539,1050
20220118,18JAN2022:00:00:00,UFU FERRER,268,200,163,255,126,544,544,0,544,0,76,8,138,117,103,55,28,19,0,159,146,239,544
20220118,18JAN2022:00:00:00,UFU GRIERSON,139,114,140,92,44,276,276,0,276,0,23,9,59,70,46,40,25,4,0,110,69,97,276
20220118,18JAN2022:00:00:00,UFU GUTIERREZ,401,282,378,166,184,728,728,0,728,0,284,172,33,77,86,38,35,3,0,138,209,377,728
20220118,18JAN2022:00:00:00,UFU MUÑIZ,410,408,401,310,200,911,911,0,911,0,94,34,150,261,172,115,54,31,0,297,163,451,911
20220118,18JAN2022:00:00:00,UFU PENNA,304,246,273,252,90,615,615,0,615,0,69,34,134,148,109,79,19,23,0,206,185,223,615
20220118,18JAN2022:00:00:00,UFU PIROVANO,579,482,723,190,222,1135,1135,0,1135,0,74,22,249,354,183,137,71,45,0,410,181,544,1135
20220118,18JAN2022:00:00:00,UFU PIÑERO,473,419,618,210,113,941,941,0,941,0,49,54,214,233,182,129,56,24,0,283,324,321,941
20220118,18JAN2022:00:00:00,UFU RAMOS MEJIA,833,689,1096,289,220,1605,1605,0,1605,0,97,57,342,347,343,209,152,58,0,516,284,803,1605
20220118,18JAN2022:00:00:00,UFU RIVADAVIA,715,584,858,260,276,1394,1394,0,1394,0,95,33,322,430,205,182,90,37,0,452,257,684,1394
20220118,18JAN2022:00:00:00,UFU SANTOJANNI,605,473,620,375,183,1178,1178,0,1178,0,100,74,251,306,196,146,79,26,0,342,177,659,1178
20220118,18JAN2022:00:00:00,UFU TORNU,642,543,927,143,146,1216,1216,0,1216,0,57,62,200,366,252,153,89,37,0,277,162,772,1216
20220105,05JAN2022:00:00:00,UFU PIÑERO,656,522,901,191,86,1178,1178,0,1178,0,0,38,454,312,197,93,60,24,0,389,385,401,1178
20220105,05JAN2022:00:00:00,UFU RAMOS MEJIA,660,571,865,252,114,1231,1231,0,1231,0,4,21,414,323,179,150,81,59,0,467,220,541,1231
20220105,05JAN2022:00:00:00,UFU RIVADAVIA,621,565,764,277,145,1186,1186,0,1186,0,0,29,425,356,166,129,62,19,0,496,213,477,1186
20220105,05JAN2022:00:00:00,UFU SANTOJANNI,553,489,574,390,78,1042,1042,0,1042,0,4,64,319,259,203,98,70,25,0,485,189,368,1042
20220105,05JAN2022:00:00:00,UFU TORNU,616,475,805,245,41,1091,1091,0,1091,0,43,66,305,272,190,112,83,20,0,288,378,421,1091
20220105,05JAN2022:00:00:00,UFU VELEZ SARSFIELD,455,410,599,230,36,865,865,0,865,0,0,52,282,181,161,107,56,26,0,291,273,301,865
20220106,06JAN2022:00:00:00,UFU ALVAREZ,782,666,982,337,129,1448,1448,0,1448,0,57,84,454,366,250,134,70,33,0,475,459,514,1448
20220106,06JAN2022:00:00:00,UFU ARGERICH,51,41,47,39,6,92,92,0,92,0,4,6,32,25,7,4,10,4,0,29,20,41,92
20220106,06JAN2022:00:00:00,UFU BORDA-MOYANO,469,380,454,329,66,849,849,0,849,0,10,54,235,228,158,104,43,17,0,269,251,329,849
20220106,06JAN2022:00:00:00,UFU DURAND,753,681,1174,173,87,1434,1434,0,1434,0,4,56,477,415,248,120,65,49,0,522,328,584,1434
20220106,06JAN2022:00:00:00,UFU ELIZALDE,329,189,230,265,23,518,518,0,518,0,231,114,45,72,33,15,8,0,0,99,152,267,518
20220106,06JAN2022:00:00:00,UFU FERNANDEZ,460,370,608,149,73,830,830,0,830,0,0,18,283,256,132,67,54,20,0,305,175,350,830
20220106,06JAN2022:00:00:00,UFU FERRER,310,361,313,273,85,671,671,0,671,0,0,15,271,186,95,69,32,3,0,180,271,220,671
20220106,06JAN2022:00:00:00,UFU GRIERSON,195,132,174,126,27,327,327,0,327,0,2,25,103,84,60,36,8,9,0,118,80,129,327
20220106,06JAN2022:00:00:00,UFU GUTIERREZ,454,304,485,199,74,758,758,0,758,0,222,242,50,116,88,30,9,1,0,168,340,245,758
20220106,06JAN2022:00:00:00,UFU MUÑIZ,495,454,464,425,60,949,949,0,949,0,4,21,324,239,181,109,55,16,0,353,193,403,949
20220106,06JAN2022:00:00:00,UFU PENNA,362,219,328,215,38,581,581,0,581,0,36,34,155,150,84,68,48,6,0,166,237,178,581
20220106,06JAN2022:00:00:00,UFU PIROVANO,435,329,536,121,107,764,764,0,764,0,0,15,225,226,137,105,33,23,0,281,166,317,764
20220106,06JAN2022:00:00:00,UFU PIÑERO,638,464,757,256,89,1102,1102,0,1102,0,2,53,389,259,166,155,54,24,0,383,333,383,1102
20220106,06JAN2022:00:00:00,UFU RAMOS MEJIA,649,525,818,253,103,1174,1174,0,1174,0,11,33,416,303,185,133,67,26,0,404,244,524,1174
20220106,06JAN2022:00:00:00,UFU RIVADAVIA,724,572,833,306,157,1296,1296,0,1296,0,0,33,499,331,199,128,70,36,0,460,274,560,1296
20220106,06JAN2022:00:00:00,UFU SANTOJANNI,523,418,483,346,112,941,941,0,941,0,3,55,281,220,203,105,56,18,0,463,171,307,941
20220106,06JAN2022:00:00:00,UFU TORNU,633,436,860,151,58,1069,1069,0,1069,0,17,48,275,302,220,119,61,27,0,330,252,485,1069
20220106,06JAN2022:00:00:00,UFU VELEZ SARSFIELD,202,195,295,78,24,397,397,0,397,0,0,14,140,82,87,44,22,8,0,110,159,128,397
20220106,06JAN2022:00:00:00,UFU ZUBIZARRETA,399,273,370,224,78,672,672,0,672,0,0,34,186,188,119,72,47,26,0,232,159,281,672
20220107,07JAN2022:00:00:00,UFU ALVAREZ,791,607,911,368,119,1398,1398,0,1398,0,33,86,489,348,204,139,78,21,0,435,474,489,1398
20220107,07JAN2022:00:00:00,UFU ARGERICH,58,45,70,30,3,103,103,0,103,0,4,2,33,21,14,5,11,13,0,42,14,46,103
20220107,07JAN2022:00:00:00,UFU BORDA-MOYANO,363,380,419,261,63,743,743,0,743,0,20,47,185,184,127,96,50,34,0,256,177,310,743
20220107,07JAN2022:00:00:00,UFU DURAND,623,601,976,181,67,1224,1224,0,1224,0,0,42,345,349,235,120,86,47,0,478,260,486,1224
20220107,07JAN2022:00:00:00,UFU ELIZALDE,319,193,224,261,27,512,512,0,512,0,226,119,40,62,34,19,7,5,0,42,122,348,512
20220107,07JAN2022:00:00:00,UFU FERNANDEZ,427,331,529,167,62,758,758,0,758,0,0,18,180,235,136,97,66,26,0,250,206,301,758
20220107,07JAN2022:00:00:00,UFU FERRER,329,366,347,260,89,696,696,0,696,0,0,20,232,197,129,72,41,5,0,250,225,221,696
20220107,07JAN2022:00:00:00,UFU GRIERSON,217,154,203,129,39,371,371,0,371,0,0,28,123,93,72,30,19,6,0,117,134,119,371
20220107,07JAN2022:00:00:00,UFU GUTIERREZ,44,34,50,26,2,78,78,0,78,0,22,19,6,10,12,7,2,0,0,19,29,30,78
20220107,07JAN2022:00:00:00,UFU MUÑIZ,438,398,398,373,65,836,836,0,836,0,6,17,271,233,161,100,37,11,0,303,187,346,836
20220107,07JAN2022:00:00:00,UFU PENNA,359,253,346,235,31,612,612,0,612,0,37,60,134,147,109,62,50,13,0,176,239,196,612
20220107,07JAN2022:00:00:00,UFU PIROVANO,368,349,484,136,97,717,717,0,717,0,0,18,230,207,105,87,43,27,0,273,149,294,717
20220107,07JAN2022:00:00:00,UFU PIÑERO,681,510,882,233,76,1191,1191,0,1191,0,0,66,443,277,222,118,55,10,0,388,402,386,1191
20220107,07JAN2022:00:00:00,UFU RAMOS MEJIA,749,608,959,273,125,1357,1357,0,1357,0,9,63,451,329,251,140,73,41,0,488,260,609,1357
20220107,07JAN2022:00:00:00,UFU RIVADAVIA,769,638,945,287,175,1407,1407,0,1407,0,2,35,491,371,235,168,80,25,0,514,309,580,1407
20220107,07JAN2022:00:00:00,UFU SANTOJANNI,521,460,497,388,96,981,981,0,981,0,13,83,299,228,179,113,54,12,0,504,155,322,981
20220107,07JAN2022:00:00:00,UFU TORNU,452,384,666,134,36,836,836,0,836,0,26,45,225,188,156,103,62,31,0,228,261,347,836
20220107,07JAN2022:00:00:00,UFU VELEZ SARSFIELD,329,249,437,114,27,578,578,0,578,0,0,13,153,153,109,86,36,28,0,200,175,203,578
20220107,07JAN2022:00:00:00,UFU ZUBIZARRETA,299,243,304,159,79,542,542,0,542,0,0,31,158,132,85,57,51,28,0,170,117,255,542
20220108,08JAN2022:00:00:00,UFU ALVAREZ,567,520,817,186,84,1087,1087,0,1087,0,25,67,268,281,205,124,70,47,0,404,221,462,1087
20220108,08JAN2022:00:00:00,UFU BORDA-MOYANO,366,328,351,309,34,694,694,0,694,0,0,42,193,150,171,73,52,13,0,234,215,245,694
20220108,08JAN2022:00:00:00,UFU DURAND,411,347,588,122,48,758,758,0,758,0,0,16,200,217,118,84,86,37,0,326,131,301,758
20220108,08JAN2022:00:00:00,UFU ELIZALDE,242,198,198,227,15,440,440,0,440,0,191,109,27,54,35,13,11,0,0,128,118,194,440
20220108,08JAN2022:00:00:00,UFU FERNANDEZ,359,320,428,162,89,679,679,0,679,0,1,22,155,219,139,76,41,26,0,266,144,267,679
20220108,08JAN2022:00:00:00,UFU FERRER,261,298,241,299,19,559,559,0,559,0,3,13,159,159,95,90,27,13,0,168,195,196,559
20220108,08JAN2022:00:00:00,UFU GRIERSON,227,176,197,174,32,403,403,0,403,0,0,15,115,114,90,44,18,7,0,142,127,132,403
20220108,08JAN2022:00:00:00,UFU GUTIERREZ,429,270,495,112,92,699,699,0,699,0,249,206,44,87,77,32,4,0,0,163,298,237,699
20220108,08JAN2022:00:00:00,UFU MUÑIZ,408,359,382,324,61,767,767,0,767,0,4,26,207,172,173,121,51,13,0,308,139,320,767
20220108,08JAN2022:00:00:00,UFU PENNA,373,347,374,303,43,720,720,0,720,0,15,39,186,213,133,86,38,10,0,239,240,241,720
20220108,08JAN2022:00:00:00,UFU PIROVANO,334,306,454,126,60,640,640,0,640,0,0,19,165,182,107,105,45,17,0,250,131,259,640
20220108,08JAN2022:00:00:00,UFU PIÑERO,478,340,551,203,64,818,818,0,818,0,0,30,249,211,157,113,43,15,0,299,252,265,818
20220108,08JAN2022:00:00:00,UFU RAMOS MEJIA,751,585,990,234,112,1336,1336,0,1336,0,50,50,404,345,231,146,64,46,0,549,203,582,1336
20220108,08JAN2022:00:00:00,UFU RIVADAVIA,674,541,826,238,151,1215,1215,0,1215,0,6,16,428,358,184,137,70,16,0,432,249,533,1215
20220108,08JAN2022:00:00:00,UFU SANTOJANNI,517,396,481,368,64,913,913,0,913,0,0,23,251,280,175,114,57,13,0,511,126,276,913
20220108,08JAN2022:00:00:00,UFU TORNU,514,431,809,103,33,945,945,0,945,0,38,62,222,198,201,123,58,43,0,271,239,433,945
20220108,08JAN2022:00:00:00,UFU VELEZ SARSFIELD,401,350,537,180,34,751,751,0,751,0,0,19,206,168,152,89,83,34,0,268,221,262,751
20210808,08AUG2021:00:00:00,UFU BORDA-MOYANO,16,17,15,14,4,33,25,8,25,8,0,0,6,9,8,5,5,0,0,0,16,9,25
20210808,08AUG2021:00:00:00,UFU DURAND,97,77,162,5,7,174,164,10,164,10,2,9,34,52,30,18,20,9,0,29,70,64,164
20210808,08AUG2021:00:00:00,UFU ELIZALDE,127,82,67,138,4,209,177,32,205,4,114,46,18,16,9,6,0,0,0,2,107,68,177
20210808,08AUG2021:00:00:00,UFU FERNANDEZ,89,56,132,8,5,145,135,10,139,6,0,9,15,46,29,23,21,2,0,11,89,35,135
20210808,08AUG2021:00:00:00,UFU FERRER,65,55,79,38,3,120,118,2,118,2,0,7,18,25,31,16,19,4,0,11,78,29,118
20210808,08AUG2021:00:00:00,UFU GRIERSON,54,45,68,21,10,99,97,2,97,2,0,5,20,25,21,14,5,9,0,3,69,25,97
20210808,08AUG2021:00:00:00,UFU GUTIERREZ,129,107,144,92,0,236,226,10,228,8,143,44,12,12,9,8,8,0,0,10,151,65,226
20210808,08AUG2021:00:00:00,UFU MUÑIZ,102,81,81,90,12,183,163,20,169,14,0,16,37,51,29,24,15,11,0,8,116,39,163
20210808,08AUG2021:00:00:00,UFU PENNA,49,31,45,35,0,80,78,2,80,0,0,3,22,24,10,14,3,4,0,0,52,26,78
20210808,08AUG2021:00:00:00,UFU PIROVANO,121,120,208,23,10,241,223,18,237,4,10,17,41,55,61,28,16,13,0,20,112,91,223
20210808,08AUG2021:00:00:00,UFU PIÑERO,80,50,101,21,8,130,124,6,124,6,0,0,25,28,21,36,17,3,0,5,90,28,124
20210808,08AUG2021:00:00:00,UFU RAMOS MEJIA,85,83,118,28,22,168,160,8,166,2,14,6,42,38,30,13,17,8,0,8,103,49,160
20210808,08AUG2021:00:00:00,UFU RIVADAVIA,79,52,89,22,20,131,127,4,127,4,0,9,25,37,24,14,18,4,0,12,67,47,127
20210808,08AUG2021:00:00:00,UFU SANTOJANNI,222,136,199,147,12,358,340,18,354,4,10,32,64,90,64,51,31,16,0,28,228,84,340
20210808,08AUG2021:00:00:00,UFU TORNU,110,78,149,23,16,188,178,10,178,10,7,11,30,35,46,29,26,4,0,5,128,45,178
20210808,08AUG2021:00:00:00,UFU VELEZ SARSFIELD,102,113,160,48,7,215,215,0,215,0,0,11,36,39,63,31,21,14,0,6,150,59,215
20210808,08AUG2021:00:00:00,UFU ZUBIZARRETA,82,72,114,40,0,154,154,0,154,0,0,9,19,43,36,25,15,7,0,8,107,39,154
20210809,09AUG2021:00:00:00,UFU ALVAREZ,186,124,239,59,12,310,234,76,238,72,28,41,67,57,57,38,9,13,0,12,164,58,234
20210809,09AUG2021:00:00:00,UFU ARGERICH,57,57,69,41,4,114,102,12,108,6,8,14,27,23,15,17,9,1,0,10,52,39,102
20210809,09AUG2021:00:00:00,UFU BORDA-MOYANO,72,39,47,56,8,111,89,22,89,22,2,20,10,22,24,22,9,2,0,2,50,37,89
20210809,09AUG2021:00:00:00,UFU DURAND,119,84,171,17,15,203,183,20,183,20,5,16,30,85,37,9,15,6,0,11,101,71,183
20210809,09AUG2021:00:00:00,UFU ELIZALDE,135,107,95,143,4,242,202,40,216,26,124,66,21,17,9,0,5,0,0,1,131,70,202
20210809,09AUG2021:00:00:00,UFU FERNANDEZ,134,72,168,16,22,206,180,26,188,18,0,13,46,64,34,12,23,14,0,5,107,68,180
20210809,09AUG2021:00:00:00,UFU FERRER,118,79,85,98,14,197,195,2,195,2,0,0,46,58,34,32,18,9,0,10,128,57,195
20210809,09AUG2021:00:00:00,UFU GRIERSON,89,95,98,55,31,184,174,10,180,4,0,17,36,42,45,22,18,4,0,13,118,43,174
20210809,09AUG2021:00:00:00,UFU GUTIERREZ,197,128,201,112,12,325,287,38,313,12,189,49,18,39,13,6,11,0,0,4,192,90,287
20210809,09AUG2021:00:00:00,UFU MUÑIZ,142,140,123,139,20,282,252,30,258,24,0,12,52,72,57,56,24,9,0,5,173,74,252
20210809,09AUG2021:00:00:00,UFU PENNA,52,71,55,68,0,123,115,8,119,4,0,4,30,40,37,3,9,0,0,2,85,28,115
20210809,09AUG2021:00:00:00,UFU PIROVANO,125,78,142,39,22,203,187,16,199,4,0,4,57,43,41,24,12,22,0,9,102,76,187
20210809,09AUG2021:00:00:00,UFU PIÑERO,96,83,137,28,14,179,173,6,175,4,8,22,32,33,41,29,8,6,0,8,116,47,173
20210809,09AUG2021:00:00:00,UFU RAMOS MEJIA,246,188,331,66,37,434,410,24,424,10,16,63,65,91,98,52,30,19,0,20,255,135,410
20210809,09AUG2021:00:00:00,UFU RIVADAVIA,119,114,169,48,16,233,199,34,199,34,0,10,71,63,30,23,19,17,0,9,108,82,199
20210809,09AUG2021:00:00:00,UFU SANTOJANNI,248,206,281,162,11,454,406,48,450,4,9,19,83,116,91,67,38,31,0,29,282,95,406
20210809,09AUG2021:00:00:00,UFU TORNU,142,122,218,33,13,264,236,28,240,24,21,21,34,63,78,26,13,8,0,7,172,54,236
20210809,09AUG2021:00:00:00,UFU VELEZ SARSFIELD,146,171,223,79,15,317,303,14,315,2,0,19,77,88,56,40,23,14,0,16,200,87,303
20210809,09AUG2021:00:00:00,UFU ZUBIZARRETA,220,150,253,97,20,370,366,4,370,0,0,25,75,82,61,64,40,23,0,17,255,94,366
20210810,10AUG2021:00:00:00,UFU ALVAREZ,201,144,287,38,20,345,323,22,325,20,24,50,72,74,41,36,23,25,0,11,229,83,323
20210810,10AUG2021:00:00:00,UFU ARGERICH,76,53,75,53,1,129,117,12,121,8,19,5,22,21,28,12,12,10,0,7,66,43,117
20210810,10AUG2021:00:00:00,UFU BORDA-MOYANO,71,46,72,34,11,117,107,10,107,10,1,2,13,18,34,36,9,4,0,4,59,44,107
20210810,10AUG2021:00:00:00,UFU DURAND,142,68,183,15,12,210,198,12,204,6,3,9,32,65,42,26,19,14,0,8,116,74,198
20210810,10AUG2021:00:00:00,UFU ELIZALDE,130,108,82,156,0,238,214,24,222,16,128,66,23,14,5,2,0,0,0,2,125,87,214
20210810,10AUG2021:00:00:00,UFU FERNANDEZ,94,79,136,30,7,173,165,8,171,2,0,5,46,43,29,20,19,11,0,5,95,65,165
20210810,10AUG2021:00:00:00,UFU FERRER,98,51,93,56,0,149,139,10,139,10,0,0,39,53,25,23,9,0,0,6,101,32,139
20210810,10AUG2021:00:00:00,UFU GRIERSON,140,82,146,58,18,222,206,16,208,14,0,22,66,43,40,29,13,9,0,2,151,53,206
20210810,10AUG2021:00:00:00,UFU GUTIERREZ,214,133,225,109,13,347,325,22,341,6,195,66,12,33,30,11,0,0,0,13,201,111,325
20210810,10AUG2021:00:00:00,UFU MUÑIZ,157,139,143,124,29,296,234,62,244,52,0,15,63,62,77,50,22,7,0,3,169,62,234
20210810,10AUG2021:00:00:00,UFU PENNA,63,78,101,37,3,141,123,18,129,12,0,8,32,42,23,15,14,7,0,5,86,32,123
20210810,10AUG2021:00:00:00,UFU PIROVANO,184,129,246,42,25,313,293,20,303,10,0,10,93,86,50,41,15,18,0,37,136,120,293
20210810,10AUG2021:00:00:00,UFU PIÑERO,96,70,111,40,15,166,162,4,162,4,0,8,50,28,25,38,11,6,0,4,117,41,162
20210810,10AUG2021:00:00:00,UFU RAMOS MEJIA,188,136,240,42,42,324,310,14,320,4,6,33,91,59,52,31,36,16,0,12,208,90,310
20210810,10AUG2021:00:00:00,UFU RIVADAVIA,164,127,190,70,31,291,283,8,283,8,3,10,77,65,52,21,38,25,0,19,153,111,283
20210810,10AUG2021:00:00:00,UFU SANTOJANNI,220,192,246,158,8,412,394,18,408,4,17,15,118,71,64,59,29,39,0,11,286,97,394
20210810,10AUG2021:00:00:00,UFU TORNU,176,105,216,39,26,281,243,38,251,30,25,30,49,59,37,46,29,6,0,12,162,68,243
20210810,10AUG2021:00:00:00,UFU VELEZ SARSFIELD,157,82,190,49,0,239,229,10,239,0,0,31,33,81,37,31,22,4,0,13,153,63,229
20210810,10AUG2021:00:00:00,UFU ZUBIZARRETA,92,82,127,44,3,174,174,0,174,0,0,16,33,34,25,33,20,13,0,16,91,67,174
20210811,11AUG2021:00:00:00,UFU ALVAREZ,172,171,265,56,22,343,325,18,327,16,53,30,68,68,41,40,31,12,0,12,212,101,325
20210811,11AUG2021:00:00:00,UFU ARGERICH,74,54,70,54,4,128,110,18,114,14,11,5,25,33,22,13,9,10,0,9,57,44,110
20210811,11AUG2021:00:00:00,UFU BORDA-MOYANO,52,50,60,39,3,102,102,0,102,0,0,2,27,30,14,14,11,4,0,2,61,39,102
20210811,11AUG2021:00:00:00,UFU DURAND,125,85,183,21,6,210,200,10,202,8,11,17,42,60,39,21,15,5,0,19,104,77,200
20210811,11AUG2021:00:00:00,UFU ELIZALDE,142,131,58,207,8,273,229,44,247,26,171,52,14,23,9,4,0,0,0,1,136,92,229
20210811,11AUG2021:00:00:00,UFU FERNANDEZ,129,67,153,21,22,196,176,20,184,12,0,4,34,70,38,32,14,4,0,12,90,74,176
20210811,11AUG2021:00:00:00,UFU FERRER,95,88,105,78,0,183,177,6,179,4,0,0,62,45,30,33,8,5,0,7,127,43,177
20210811,11AUG2021:00:00:00,UFU GRIERSON,120,75,97,74,24,195,189,6,191,4,0,12,50,33,42,30,17,11,0,6,132,51,189
20210811,11AUG2021:00:00:00,UFU GUTIERREZ,131,130,171,84,6,261,239,22,257,4,157,51,18,22,10,1,2,0,0,5,148,86,239
20210811,11AUG2021:00:00:00,UFU MUÑIZ,160,133,164,115,14,293,225,68,245,48,0,23,64,60,60,51,29,6,0,8,158,59,225
20211001,01OCT2021:00:00:00,UFU PIROVANO,117,83,159,16,25,200,178,22,198,2,4,13,23,58,55,26,5,16,0,3,99,76,178
20211001,01OCT2021:00:00:00,UFU PIÑERO,120,90,171,23,16,210,204,6,204,6,69,31,31,22,21,27,7,2,0,3,149,51,204
20211001,01OCT2021:00:00:00,UFU RAMOS MEJIA,118,86,154,24,26,204,188,16,198,6,18,22,37,44,29,27,12,15,0,0,120,68,188
20211001,01OCT2021:00:00:00,UFU RIVADAVIA,77,72,120,18,11,149,125,24,145,4,0,6,37,51,14,28,11,2,0,3,77,45,125
20211001,01OCT2021:00:00:00,UFU SANTOJANNI,82,75,85,59,13,157,145,12,153,4,14,18,23,34,24,16,22,6,0,1,82,62,145
20211001,01OCT2021:00:00:00,UFU TORNU,149,97,194,20,32,246,216,30,216,30,26,16,33,85,55,18,5,8,0,0,163,53,216
20211001,01OCT2021:00:00:00,UFU VELEZ SARSFIELD,83,74,113,35,9,157,149,8,153,4,0,16,19,37,47,14,18,6,0,1,104,44,149
20211001,01OCT2021:00:00:00,UFU ZUBIZARRETA,96,69,113,41,11,165,159,6,165,0,0,14,16,40,36,26,23,10,0,2,115,42,159
20211002,02OCT2021:00:00:00,UFU ALVAREZ,109,55,113,34,17,164,156,8,156,8,12,12,38,32,33,16,15,6,0,2,109,45,156
20211002,02OCT2021:00:00:00,UFU ARGERICH,3,0,2,1,0,3,3,0,3,0,3,0,0,0,0,0,0,0,0,0,2,1,3
20211002,02OCT2021:00:00:00,UFU BORDA-MOYANO,11,27,21,15,2,38,38,0,38,0,2,2,4,9,12,3,1,5,0,1,23,14,38
20211002,02OCT2021:00:00:00,UFU DURAND,58,48,89,4,13,106,102,4,102,4,4,12,15,33,20,5,10,7,0,2,60,40,102
20211002,02OCT2021:00:00:00,UFU ELIZALDE,109,73,44,136,2,182,174,8,182,0,132,39,1,3,5,0,2,0,0,0,113,61,174
20211002,02OCT2021:00:00:00,UFU FERNANDEZ,36,51,71,7,9,87,75,12,83,4,0,0,13,25,16,15,15,3,0,2,44,29,75
20211002,02OCT2021:00:00:00,UFU FERRER,40,21,43,13,5,61,59,2,59,2,0,0,18,7,13,15,5,3,0,2,44,13,59
20211002,02OCT2021:00:00:00,UFU GRIERSON,88,49,85,43,9,137,131,6,131,6,0,27,27,20,9,19,28,7,0,0,97,32,131
20211002,02OCT2021:00:00:00,UFU GUTIERREZ,77,121,118,69,11,198,180,18,184,14,121,51,6,10,5,5,0,0,0,1,131,47,180
20211002,02OCT2021:00:00:00,UFU MUÑIZ,84,57,72,59,10,141,103,38,103,38,4,4,25,31,34,24,13,6,0,0,82,21,103
20211002,02OCT2021:00:00:00,UFU PENNA,35,21,32,21,3,56,52,4,54,2,21,7,2,13,6,2,4,1,0,0,34,18,52
20211002,02OCT2021:00:00:00,UFU PIROVANO,109,99,169,14,25,208,196,12,200,8,0,13,45,48,51,24,17,10,0,5,113,78,196
20211002,02OCT2021:00:00:00,UFU PIÑERO,31,20,39,7,5,51,51,0,51,0,0,3,14,14,13,1,3,3,0,2,41,8,51
20211002,02OCT2021:00:00:00,UFU RAMOS MEJIA,80,59,105,16,18,139,119,20,119,20,14,14,19,20,20,23,6,23,0,3,61,55,119
20211002,02OCT2021:00:00:00,UFU RIVADAVIA,44,54,75,10,13,98,98,0,98,0,0,6,17,24,19,14,8,10,0,0,61,37,98
20211002,02OCT2021:00:00:00,UFU SANTOJANNI,98,61,90,51,18,159,152,7,156,3,0,21,22,43,28,25,12,8,0,0,88,64,152
20211002,02OCT2021:00:00:00,UFU TORNU,110,58,139,13,16,168,164,4,164,4,17,9,13,44,58,12,13,2,0,6,112,46,164
20211002,02OCT2021:00:00:00,UFU VELEZ SARSFIELD,86,58,112,24,8,144,134,10,138,6,0,13,25,18,41,25,9,13,0,3,84,47,134
20211002,02OCT2021:00:00:00,UFU ZUBIZARRETA,149,113,203,59,0,262,258,4,262,0,0,19,44,46,51,41,30,31,0,1,190,67,258
20211003,03OCT2021:00:00:00,UFU ALVAREZ,89,93,150,17,15,182,174,8,174,8,20,22,33,33,29,19,12,14,0,1,125,48,174
20211003,03OCT2021:00:00:00,UFU ARGERICH,21,14,19,15,1,35,33,2,35,0,2,0,12,9,8,2,0,2,0,0,21,12,33
20211003,03OCT2021:00:00:00,UFU BORDA-MOYANO,4,8,2,8,2,12,10,2,10,2,1,0,3,1,5,2,0,0,0,0,6,3,10
20211003,03OCT2021:00:00:00,UFU DURAND,67,63,117,8,5,130,126,4,126,4,8,20,13,29,27,13,15,5,0,4,73,49,126
20211003,03OCT2021:00:00:00,UFU ELIZALDE,108,72,56,124,0,180,160,20,174,6,105,47,9,10,9,0,0,0,0,2,110,48,160
20211003,03OCT2021:00:00:00,UFU FERNANDEZ,36,18,47,2,5,54,50,4,50,4,0,5,10,15,7,7,5,5,0,2,32,16,50
20211003,03OCT2021:00:00:00,UFU FERRER,35,22,36,15,6,57,57,0,57,0,0,0,11,16,18,8,4,0,0,5,41,11,57
20211003,03OCT2021:00:00:00,UFU GRIERSON,54,27,54,23,4,81,45,36,45,36,0,12,13,12,13,6,19,6,0,0,29,16,45
20211003,03OCT2021:00:00:00,UFU GUTIERREZ,98,85,123,47,13,183,175,8,181,2,134,25,7,0,7,8,1,1,0,0,111,62,175
20211003,03OCT2021:00:00:00,UFU MUÑIZ,43,55,50,40,8,98,84,14,88,10,0,13,15,26,23,11,2,8,0,0,64,20,84
20211003,03OCT2021:00:00:00,UFU PENNA,40,18,36,20,2,58,58,0,58,0,13,15,2,12,9,2,3,2,0,1,43,14,58
20211003,03OCT2021:00:00:00,UFU PIROVANO,103,97,148,17,35,200,178,22,192,8,22,24,35,32,44,13,24,6,0,8,103,67,178
20211003,03OCT2021:00:00:00,UFU PIÑERO,18,19,29,4,4,37,33,4,35,2,0,0,9,12,7,4,3,2,0,1,26,6,33
20211003,03OCT2021:00:00:00,UFU RAMOS MEJIA,61,46,86,6,15,107,99,8,99,8,2,12,28,18,25,6,7,9,0,2,56,40,99
20211003,03OCT2021:00:00:00,UFU RIVADAVIA,61,38,77,10,12,99,93,6,93,6,0,1,27,35,11,12,9,4,0,1,54,37,93
20211003,03OCT2021:00:00:00,UFU SANTOJANNI,75,52,68,46,13,127,115,12,125,2,5,19,15,24,29,19,7,9,0,0,70,45,115
20211003,03OCT2021:00:00:00,UFU TORNU,84,41,95,10,20,125,113,12,113,12,17,18,11,34,18,9,8,10,0,2,80,31,113
20211003,03OCT2021:00:00:00,UFU VELEZ SARSFIELD,76,41,80,24,13,117,113,4,113,4,0,9,17,29,33,16,7,6,0,2,73,38,113
20211003,03OCT2021:00:00:00,UFU ZUBIZARRETA,73,40,76,30,7,113,113,0,113,0,0,12,13,35,22,16,12,3,0,2,89,22,113
20211004,04OCT2021:00:00:00,UFU ALVAREZ,156,157,239,37,37,313,151,162,163,150,64,23,48,61,54,27,25,11,0,0,108,43,151
20211004,04OCT2021:00:00:00,UFU ARGERICH,71,52,71,38,14,123,69,54,69,54,19,12,18,24,16,12,11,11,0,0,30,37,69
20211004,04OCT2021:00:00:00,UFU BORDA-MOYANO,40,26,46,18,2,66,34,32,34,32,1,2,16,5,23,12,5,2,0,0,25,9,34
20211004,04OCT2021:00:00:00,UFU DURAND,84,102,165,8,13,186,90,96,100,86,18,19,31,49,27,18,10,14,0,2,55,33,90
20211004,04OCT2021:00:00:00,UFU ELIZALDE,165,118,76,202,5,283,93,190,239,44,189,47,11,24,8,4,0,0,0,1,65,27,93
20211004,04OCT2021:00:00:00,UFU FERNANDEZ,62,61,95,12,16,123,103,20,103,20,0,3,29,51,6,18,7,9,0,2,61,40,103
20211004,04OCT2021:00:00:00,UFU FERRER,50,40,45,41,4,90,80,10,84,6,0,0,17,19,32,12,5,5,0,0,61,19,80
20211004,04OCT2021:00:00:00,UFU GRIERSON,76,59,82,32,21,135,127,8,127,8,2,10,38,29,42,8,2,4,0,0,91,35,127
20211004,04OCT2021:00:00:00,UFU GUTIERREZ,159,169,197,126,5,328,206,122,242,86,197,83,17,17,11,3,0,0,0,0,143,63,206
20211004,04OCT2021:00:00:00,UFU MUÑIZ,104,96,91,102,7,200,180,20,184,16,3,15,46,47,47,20,16,6,0,2,135,42,180
20211004,04OCT2021:00:00:00,UFU PENNA,82,64,76,65,5,146,112,34,126,20,58,25,14,19,9,15,1,5,0,0,76,36,112
20211004,04OCT2021:00:00:00,UFU PIROVANO,146,120,203,35,28,266,252,14,264,2,0,19,38,82,58,41,17,11,0,0,143,109,252
20211004,04OCT2021:00:00:00,UFU PIÑERO,90,57,129,15,3,147,103,44,107,40,57,20,13,25,18,10,2,2,0,0,80,23,103
20211004,04OCT2021:00:00:00,UFU RAMOS MEJIA,162,104,173,66,27,266,166,100,176,90,28,23,42,41,42,25,43,22,0,0,101,65,166
20211004,04OCT2021:00:00:00,UFU RIVADAVIA,106,74,111,46,23,180,80,100,84,96,0,7,54,40,29,16,23,11,0,0,48,32,80
20211004,04OCT2021:00:00:00,UFU SANTOJANNI,98,78,113,51,12,176,154,22,166,10,15,41,13,35,23,32,14,3,0,0,94,60,154
20211004,04OCT2021:00:00:00,UFU TORNU,159,103,199,42,21,262,180,82,180,82,44,35,31,51,56,13,26,6,0,1,125,53,180
20211004,04OCT2021:00:00:00,UFU VELEZ SARSFIELD,134,113,167,71,9,247,170,77,204,43,0,36,41,44,61,35,8,22,0,2,116,52,170
20211004,04OCT2021:00:00:00,UFU ZUBIZARRETA,127,97,136,68,20,224,218,6,224,0,2,18,37,68,52,17,26,4,0,1,163,54,218
20211005,05OCT2021:00:00:00,UFU ALVAREZ,162,96,218,24,16,258,234,24,236,22,54,32,30,39,43,28,24,8,0,0,153,81,234
20220125,25JAN2022:00:00:00,UFU GRIERSON,123,129,160,80,14,254,254,0,254,0,2,8,76,68,53,26,14,7,0,48,128,78,254
20220125,25JAN2022:00:00:00,UFU GUTIERREZ,138,84,137,45,40,222,222,0,222,0,102,41,11,26,30,6,4,2,0,43,73,105,222
20220125,25JAN2022:00:00:00,UFU MUÑIZ,171,247,176,190,53,419,419,0,419,0,1,12,86,100,105,54,45,16,0,104,143,172,419
20220125,25JAN2022:00:00:00,UFU PENNA,175,173,191,146,11,348,348,0,348,0,25,16,86,74,46,58,33,10,0,82,169,97,348
20220125,25JAN2022:00:00:00,UFU PIROVANO,418,321,526,99,117,742,742,0,742,0,3,36,212,190,150,76,50,25,0,273,167,302,742
20220125,25JAN2022:00:00:00,UFU PIÑERO,220,190,318,76,16,410,410,0,410,0,0,28,89,88,76,73,35,21,0,110,179,121,410
20220125,25JAN2022:00:00:00,UFU RAMOS MEJIA,383,298,459,149,74,682,682,0,682,0,6,22,145,166,127,108,54,54,0,216,161,305,682
20220125,25JAN2022:00:00:00,UFU RIVADAVIA,453,312,526,144,97,767,767,0,767,0,4,18,207,219,105,102,63,49,0,230,209,325,767
20220125,25JAN2022:00:00:00,UFU SANTOJANNI,274,236,288,151,71,510,510,0,510,0,0,22,117,125,117,66,41,22,0,173,109,228,510
20220125,25JAN2022:00:00:00,UFU TORNU,238,238,386,49,42,477,477,0,477,0,7,26,104,110,85,63,49,33,0,180,100,196,477
20220125,25JAN2022:00:00:00,UFU VELEZ SARSFIELD,282,263,415,86,44,545,545,0,545,0,0,22,153,101,114,79,44,32,0,180,168,197,545
20220125,25JAN2022:00:00:00,UFU ZUBIZARRETA,248,260,362,127,19,508,508,0,508,0,0,25,137,107,104,52,41,42,0,116,132,260,508
20220126,26JAN2022:00:00:00,UFU ALVAREZ,378,297,506,100,69,675,675,0,675,0,16,41,136,136,131,97,66,52,0,160,251,264,675
20220126,26JAN2022:00:00:00,UFU ARGERICH,79,59,83,50,5,138,138,0,138,0,7,14,29,21,27,21,17,2,0,50,29,57,138
20220126,26JAN2022:00:00:00,UFU BORDA-MOYANO,170,157,190,113,24,327,327,0,327,0,1,19,72,48,86,63,24,14,0,80,114,133,327
20220126,26JAN2022:00:00:00,UFU DURAND,461,342,632,91,81,804,804,0,804,0,1,48,160,232,137,100,67,59,0,264,200,339,804
20220126,26JAN2022:00:00:00,UFU ELIZALDE,160,93,68,176,10,254,254,0,254,0,139,59,11,23,13,4,4,1,0,51,88,115,254
20220126,26JAN2022:00:00:00,UFU FERNANDEZ,271,231,359,60,86,505,505,0,505,0,3,18,120,149,82,58,56,19,0,148,132,225,505
20220126,26JAN2022:00:00:00,UFU FERRER,183,197,185,171,24,380,380,0,380,0,0,7,88,124,58,50,45,8,0,115,133,132,380
20220126,26JAN2022:00:00:00,UFU GRIERSON,115,127,165,70,7,242,242,0,242,0,0,16,87,52,43,21,21,2,0,50,113,79,242
20220126,26JAN2022:00:00:00,UFU GUTIERREZ,111,87,104,56,38,198,198,0,198,0,76,63,14,16,19,9,1,0,0,39,76,83,198
20220126,26JAN2022:00:00:00,UFU MUÑIZ,188,184,192,122,58,372,372,0,372,0,0,9,68,115,67,68,28,17,0,102,119,151,372
20220126,26JAN2022:00:00:00,UFU PENNA,204,147,186,143,23,352,352,0,352,0,25,17,87,85,52,52,30,4,0,66,184,102,352
20220126,26JAN2022:00:00:00,UFU PIROVANO,401,289,473,118,99,690,690,0,690,0,0,24,162,219,117,92,46,30,0,220,178,292,690
20220126,26JAN2022:00:00:00,UFU PIÑERO,201,170,272,66,34,372,372,0,372,0,1,15,98,105,64,53,17,19,0,84,183,105,372
20220126,26JAN2022:00:00:00,UFU RAMOS MEJIA,308,281,407,103,79,589,589,0,589,0,5,28,118,165,116,77,45,35,0,189,139,261,589
20220126,26JAN2022:00:00:00,UFU RIVADAVIA,412,311,502,122,100,724,724,0,724,0,1,32,210,188,86,98,77,32,0,223,196,303,724
20220126,26JAN2022:00:00:00,UFU SANTOJANNI,242,258,299,165,36,500,500,0,500,0,4,27,140,111,99,45,41,33,0,166,131,203,500
20220126,26JAN2022:00:00:00,UFU TORNU,229,203,333,68,31,432,432,0,432,0,15,28,77,122,91,44,38,17,0,119,117,193,432
20220126,26JAN2022:00:00:00,UFU VELEZ SARSFIELD,278,242,382,94,44,520,520,0,520,0,0,23,104,114,90,97,57,35,0,134,183,203,520
20220126,26JAN2022:00:00:00,UFU ZUBIZARRETA,258,205,291,137,36,464,464,0,464,0,1,22,107,114,94,65,32,29,0,84,140,240,464
20220127,27JAN2022:00:00:00,UFU ALVAREZ,288,213,374,77,50,501,501,0,501,0,18,28,115,105,89,72,50,24,0,135,140,226,501
20220127,27JAN2022:00:00:00,UFU ARGERICH,93,45,77,57,5,139,139,0,139,0,7,14,16,33,19,22,14,14,0,42,32,65,139
20220127,27JAN2022:00:00:00,UFU BORDA-MOYANO,182,176,172,152,34,358,358,0,358,0,5,22,56,85,78,53,46,13,0,92,115,151,358
20220127,27JAN2022:00:00:00,UFU DURAND,387,317,580,72,54,706,706,0,706,0,2,43,128,206,126,83,76,42,0,216,183,307,706
20220127,27JAN2022:00:00:00,UFU ELIZALDE,125,81,61,132,13,206,206,0,206,0,122,49,6,17,7,3,2,0,0,34,71,101,206
20220127,27JAN2022:00:00:00,UFU FERNANDEZ,252,146,258,66,74,398,398,0,398,0,0,19,89,113,71,58,28,20,0,85,130,183,398
20220127,27JAN2022:00:00:00,UFU FERRER,192,164,178,138,40,356,356,0,356,0,0,8,60,93,106,51,26,12,0,90,145,121,356
20220127,27JAN2022:00:00:00,UFU GRIERSON,111,89,120,69,12,201,201,0,201,0,1,20,53,49,30,22,17,9,0,35,94,72,201
20220127,27JAN2022:00:00:00,UFU GUTIERREZ,97,83,114,22,44,180,180,0,180,0,81,51,15,11,14,4,2,2,0,36,60,83,180
20220127,27JAN2022:00:00:00,UFU MUÑIZ,139,165,144,119,44,307,307,0,307,0,3,14,49,107,62,39,23,10,0,61,141,105,307
20220127,27JAN2022:00:00:00,UFU PENNA,155,130,142,134,9,285,285,0,285,0,16,11,54,58,53,59,18,16,0,59,146,80,285
20220127,27JAN2022:00:00:00,UFU PIROVANO,312,250,414,63,87,564,564,0,564,0,3,23,140,153,83,58,63,41,0,184,138,242,564
20220127,27JAN2022:00:00:00,UFU PIÑERO,213,177,299,46,45,390,390,0,390,0,0,15,73,121,68,71,22,20,0,84,192,106,390
20220127,27JAN2022:00:00:00,UFU RAMOS MEJIA,298,269,394,91,82,567,567,0,567,0,14,18,124,135,97,83,61,35,0,162,150,254,567
20220127,27JAN2022:00:00:00,UFU RIVADAVIA,371,275,414,164,72,650,650,0,650,0,4,10,139,154,111,104,100,28,0,195,184,271,650
20220127,27JAN2022:00:00:00,UFU SANTOJANNI,310,239,316,148,85,549,549,0,549,0,2,27,135,105,104,72,68,36,0,141,143,265,549
20220127,27JAN2022:00:00:00,UFU TORNU,163,133,247,32,17,296,296,0,296,0,12,31,44,85,62,28,20,14,0,89,87,119,296
20220127,27JAN2022:00:00:00,UFU VELEZ SARSFIELD,288,238,414,82,31,527,527,0,527,0,1,22,123,130,94,67,52,38,0,152,182,193,527
20220127,27JAN2022:00:00:00,UFU ZUBIZARRETA,238,177,300,94,22,416,416,0,416,0,1,26,106,100,68,46,44,25,0,111,98,207,416
20220128,28JAN2022:00:00:00,UFU ALVAREZ,270,171,339,88,15,442,442,0,442,0,22,20,86,103,93,37,38,43,0,100,150,192,442
20220128,28JAN2022:00:00:00,UFU ARGERICH,53,44,63,33,1,97,97,0,97,0,5,2,20,31,13,15,5,6,0,19,26,50,97
20220128,28JAN2022:00:00:00,UFU BORDA-MOYANO,145,112,138,101,22,261,261,0,261,0,5,10,38,52,79,36,24,17,0,62,76,123,261
20220128,28JAN2022:00:00:00,UFU DURAND,323,247,478,50,43,571,571,0,571,0,1,30,90,152,102,75,79,42,0,154,159,258,571
20220128,28JAN2022:00:00:00,UFU ELIZALDE,97,93,63,119,9,191,191,0,191,0,112,50,10,6,7,3,3,0,0,38,53,100,191
20220128,28JAN2022:00:00:00,UFU FERNANDEZ,195,173,269,34,66,369,369,0,369,0,1,10,68,104,82,50,30,24,0,64,77,227,369
20220128,28JAN2022:00:00:00,UFU FERRER,145,127,141,98,34,273,273,0,273,0,1,4,67,80,77,25,14,5,0,58,119,96,273
20220128,28JAN2022:00:00:00,UFU GRIERSON,77,69,83,52,11,146,146,0,146,0,2,3,34,39,27,28,6,7,0,43,41,62,146
20220128,28JAN2022:00:00:00,UFU GUTIERREZ,126,73,100,45,55,200,200,0,200,0,89,54,16,15,17,7,2,0,0,41,57,102,200
20220128,28JAN2022:00:00:00,UFU MUÑIZ,214,137,180,105,69,354,354,0,354,0,7,17,66,74,81,58,27,24,0,84,121,149,354
20220128,28JAN2022:00:00:00,UFU PENNA,136,119,131,114,11,256,256,0,256,0,15,7,55,57,61,28,26,7,0,55,125,76,256
20220128,28JAN2022:00:00:00,UFU PIROVANO,338,281,450,73,99,622,622,0,622,0,3,32,124,169,127,70,62,35,0,181,156,281,622
20220128,28JAN2022:00:00:00,UFU PIÑERO,239,172,294,86,31,411,411,0,411,0,0,26,110,88,65,61,47,14,0,80,205,120,411
20220108,08JAN2022:00:00:00,UFU ZUBIZARRETA,242,264,269,214,23,506,506,0,506,0,0,9,133,140,95,71,33,25,0,213,78,215,506
20220109,09JAN2022:00:00:00,UFU ALVAREZ,661,595,991,158,107,1256,1256,0,1256,0,31,77,292,291,243,171,109,42,0,422,344,490,1256
20220109,09JAN2022:00:00:00,UFU BORDA-MOYANO,321,352,400,243,30,673,673,0,673,0,0,35,157,193,141,93,46,8,0,165,225,283,673
20220109,09JAN2022:00:00:00,UFU DURAND,687,555,1048,115,79,1242,1242,0,1242,0,0,44,326,343,223,150,105,51,0,535,188,519,1242
20220109,09JAN2022:00:00:00,UFU ELIZALDE,237,196,190,219,24,433,433,0,433,0,189,118,18,59,22,19,4,4,0,108,78,247,433
20220109,09JAN2022:00:00:00,UFU FERNANDEZ,408,348,490,171,95,756,756,0,756,0,0,11,165,225,129,118,68,40,0,285,157,314,756
20220109,09JAN2022:00:00:00,UFU FERRER,256,274,229,267,34,530,530,0,530,0,0,13,105,159,105,87,35,26,0,176,169,185,530
20220109,09JAN2022:00:00:00,UFU GRIERSON,147,129,131,117,28,276,276,0,276,0,0,8,66,87,62,39,9,5,0,125,58,90,276
20220109,09JAN2022:00:00:00,UFU GUTIERREZ,390,284,509,111,54,674,674,0,674,0,223,231,32,92,66,21,9,0,0,172,280,222,674
20220109,09JAN2022:00:00:00,UFU MUÑIZ,369,300,305,309,55,669,669,0,669,0,0,26,164,200,139,78,35,27,0,263,135,271,669
20220109,09JAN2022:00:00:00,UFU PENNA,338,253,315,250,26,591,591,0,591,0,47,35,122,121,112,90,49,15,0,195,191,204,591
20220109,09JAN2022:00:00:00,UFU PIROVANO,330,279,444,108,57,609,609,0,609,0,19,22,126,164,143,71,47,17,0,265,102,241,609
20220109,09JAN2022:00:00:00,UFU PIÑERO,426,369,562,166,67,795,795,0,795,0,0,41,251,205,152,67,60,19,0,280,249,263,795
20220109,09JAN2022:00:00:00,UFU RAMOS MEJIA,735,665,981,258,161,1400,1400,0,1400,0,59,78,381,340,232,168,96,46,0,623,174,592,1400
20220109,09JAN2022:00:00:00,UFU RIVADAVIA,673,564,824,283,130,1237,1237,0,1237,0,0,24,361,346,190,162,108,46,0,496,225,516,1237
20220109,09JAN2022:00:00:00,UFU SANTOJANNI,376,335,323,309,79,711,711,0,711,0,1,22,203,180,142,91,56,16,0,403,88,220,711
20220109,09JAN2022:00:00:00,UFU TORNU,455,390,629,139,77,845,845,0,845,0,16,47,161,251,160,126,57,27,0,311,141,390,845
20220109,09JAN2022:00:00:00,UFU VELEZ SARSFIELD,447,299,510,209,27,746,746,0,746,0,0,17,182,194,147,113,76,17,0,259,253,234,746
20220109,09JAN2022:00:00:00,UFU ZUBIZARRETA,320,293,377,210,26,613,613,0,613,0,0,16,154,125,136,87,62,33,0,291,77,245,613
20220110,10JAN2022:00:00:00,UFU ALVAREZ,661,557,771,343,104,1218,1218,0,1218,0,19,32,387,306,212,119,103,40,0,470,321,427,1218
20220110,10JAN2022:00:00:00,UFU ARGERICH,48,30,58,18,2,78,78,0,78,0,4,2,15,22,5,11,11,8,0,43,4,31,78
20220110,10JAN2022:00:00:00,UFU BORDA-MOYANO,446,538,517,396,71,984,984,0,984,0,9,48,208,253,238,137,73,18,0,381,202,401,984
20220110,10JAN2022:00:00:00,UFU DURAND,662,647,976,267,66,1309,1309,0,1309,0,2,46,361,392,212,177,77,42,0,568,201,540,1309
20220110,10JAN2022:00:00:00,UFU ELIZALDE,298,223,195,304,22,521,521,0,521,0,238,101,41,55,39,29,18,0,0,157,113,251,521
20220110,10JAN2022:00:00:00,UFU FERNANDEZ,351,303,405,171,78,654,654,0,654,0,0,9,149,209,148,68,47,24,0,228,155,271,654
20220110,10JAN2022:00:00:00,UFU FERRER,294,313,288,270,49,607,607,0,607,0,0,7,217,124,120,84,42,13,0,251,143,213,607
20220110,10JAN2022:00:00:00,UFU GRIERSON,192,214,213,150,43,406,406,0,406,0,0,11,92,114,101,52,28,8,0,161,105,139,406
20220110,10JAN2022:00:00:00,UFU GUTIERREZ,220,164,232,66,86,384,384,0,384,0,141,102,27,43,49,16,6,0,0,107,158,118,384
20220110,10JAN2022:00:00:00,UFU MUÑIZ,502,523,409,458,158,1025,1025,0,1025,0,1,23,300,309,225,109,39,19,0,436,169,420,1025
20220110,10JAN2022:00:00:00,UFU PENNA,343,309,345,273,34,652,652,0,652,0,15,38,138,188,125,72,56,20,0,236,197,219,652
20220110,10JAN2022:00:00:00,UFU PIROVANO,347,380,510,118,99,727,727,0,727,0,0,16,188,209,134,79,68,33,0,312,115,300,727
20220110,10JAN2022:00:00:00,UFU PIÑERO,503,423,625,241,60,926,926,0,926,0,0,39,259,233,175,122,65,33,0,354,251,319,926
20220110,10JAN2022:00:00:00,UFU RAMOS MEJIA,679,656,925,317,93,1335,1335,0,1335,0,10,29,358,380,264,162,70,62,0,533,238,564,1335
20220110,10JAN2022:00:00:00,UFU RIVADAVIA,663,612,773,364,138,1275,1275,0,1275,0,2,27,388,384,220,151,70,33,0,537,237,501,1275
20220110,10JAN2022:00:00:00,UFU SANTOJANNI,566,466,504,409,119,1032,1032,0,1032,0,12,43,238,244,227,158,65,45,0,568,144,320,1032
20220110,10JAN2022:00:00:00,UFU TORNU,531,477,729,202,77,1008,1008,0,1008,0,31,50,253,246,213,128,57,30,0,367,162,473,1008
20220110,10JAN2022:00:00:00,UFU VELEZ SARSFIELD,334,326,483,159,18,660,660,0,660,0,0,17,150,168,120,119,73,13,0,256,186,218,660
20220110,10JAN2022:00:00:00,UFU ZUBIZARRETA,334,375,372,254,83,709,709,0,709,0,0,31,157,200,165,86,44,26,0,310,96,303,709
20220111,11JAN2022:00:00:00,UFU ALVAREZ,768,648,964,328,124,1416,1416,0,1416,0,47,91,407,401,223,152,60,35,0,498,417,501,1416
20220111,11JAN2022:00:00:00,UFU ARGERICH,44,54,42,50,6,98,98,0,98,0,0,0,24,24,21,12,15,2,0,49,7,42,98
20220111,11JAN2022:00:00:00,UFU BORDA-MOYANO,414,374,448,306,34,788,788,0,788,0,4,27,184,204,186,107,46,30,0,337,119,332,788
20220111,11JAN2022:00:00:00,UFU DURAND,724,624,1058,191,99,1348,1348,0,1348,0,0,44,359,445,237,135,79,49,0,594,196,558,1348
20220111,11JAN2022:00:00:00,UFU ELIZALDE,309,216,206,303,16,525,525,0,525,0,215,101,51,76,43,31,8,0,0,165,132,228,525
20220111,11JAN2022:00:00:00,UFU FERNANDEZ,278,182,319,98,43,460,460,0,460,0,0,6,116,122,95,54,35,32,0,182,85,192,460
20220111,11JAN2022:00:00:00,UFU FERRER,291,319,291,263,56,610,610,0,610,0,0,10,167,181,130,80,30,12,0,237,160,213,610
20220111,11JAN2022:00:00:00,UFU GRIERSON,141,141,143,109,30,282,282,0,282,0,0,8,103,68,56,34,8,5,0,119,72,91,282
20220111,11JAN2022:00:00:00,UFU GUTIERREZ,237,152,260,77,52,389,389,0,389,0,136,106,18,56,41,22,10,0,0,107,142,136,389
20220111,11JAN2022:00:00:00,UFU MUÑIZ,448,544,460,374,158,992,992,0,992,0,3,23,274,328,189,97,55,23,0,388,201,402,992
20220111,11JAN2022:00:00:00,UFU PENNA,299,230,275,219,35,529,529,0,529,0,13,15,128,147,101,67,46,12,0,190,161,178,529
20220111,11JAN2022:00:00:00,UFU PIROVANO,263,269,366,104,62,532,532,0,532,0,0,16,118,156,120,63,33,26,0,232,80,217,532
20220111,11JAN2022:00:00:00,UFU PIÑERO,367,346,504,169,40,713,713,0,713,0,0,23,242,161,161,84,28,14,0,260,224,227,713
20220111,11JAN2022:00:00:00,UFU RAMOS MEJIA,656,529,770,282,133,1185,1185,0,1185,0,3,27,302,375,220,148,68,42,0,532,162,491,1185
20220111,11JAN2022:00:00:00,UFU RIVADAVIA,379,266,415,153,77,645,645,0,645,0,0,21,184,176,106,101,40,17,0,283,109,253,645
20220111,11JAN2022:00:00:00,UFU SANTOJANNI,289,324,301,187,125,613,613,0,613,0,0,25,154,138,141,87,40,28,0,328,81,204,613
20220111,11JAN2022:00:00:00,UFU TORNU,413,490,674,168,61,903,903,0,903,0,24,44,223,242,176,111,54,29,0,323,187,390,903
20220111,11JAN2022:00:00:00,UFU VELEZ SARSFIELD,353,354,503,167,37,707,707,0,707,0,0,32,181,186,138,107,40,23,0,275,179,253,707
20220111,11JAN2022:00:00:00,UFU ZUBIZARRETA,197,216,240,142,31,413,413,0,413,0,0,6,85,110,82,70,36,24,0,158,81,174,413
20220112,12JAN2022:00:00:00,UFU ALVAREZ,681,627,965,219,124,1308,1308,0,1308,0,31,87,322,356,216,164,86,46,0,453,380,475,1308
20220112,12JAN2022:00:00:00,UFU ARGERICH,42,30,35,35,2,72,72,0,72,0,3,2,22,16,17,4,5,3,0,29,12,31,72
20220112,12JAN2022:00:00:00,UFU BORDA-MOYANO,436,377,433,307,73,813,813,0,813,0,1,44,178,219,212,102,43,14,0,290,200,323,813
20220112,12JAN2022:00:00:00,UFU DURAND,739,627,1125,141,100,1366,1366,0,1366,0,1,36,438,343,262,148,85,53,0,627,188,551,1366
20220112,12JAN2022:00:00:00,UFU ELIZALDE,287,187,178,267,29,474,474,0,474,0,216,114,42,40,35,21,6,0,0,168,103,203,474
20210811,11AUG2021:00:00:00,UFU PENNA,90,63,80,67,6,153,145,8,147,6,0,15,38,42,40,15,3,0,0,2,103,40,145
20210811,11AUG2021:00:00:00,UFU PIROVANO,169,132,246,36,19,301,295,6,299,2,0,17,62,89,64,33,25,11,0,13,160,122,295
20210811,11AUG2021:00:00:00,UFU PIÑERO,73,83,103,42,11,156,146,10,148,8,0,13,38,47,31,15,11,1,0,5,103,38,146
20210811,11AUG2021:00:00:00,UFU RAMOS MEJIA,212,188,296,60,44,400,376,24,386,14,10,26,84,80,65,73,44,18,0,15,241,119,376
20210811,11AUG2021:00:00:00,UFU RIVADAVIA,185,126,230,55,26,311,211,100,211,100,1,12,92,101,46,32,19,8,0,11,113,87,211
20210811,11AUG2021:00:00:00,UFU SANTOJANNI,201,193,224,153,17,394,384,10,390,4,27,28,91,78,58,64,33,15,0,18,269,97,384
20210811,11AUG2021:00:00:00,UFU TORNU,205,102,254,37,16,307,265,42,267,40,23,40,49,74,63,30,20,8,0,5,178,77,265
20210811,11AUG2021:00:00:00,UFU VELEZ SARSFIELD,141,162,201,85,17,303,281,22,295,8,0,31,41,52,72,63,33,11,0,12,195,74,281
20210811,11AUG2021:00:00:00,UFU ZUBIZARRETA,110,80,116,48,26,190,190,0,190,0,0,14,44,37,24,42,25,4,0,11,128,51,190
20210812,12AUG2021:00:00:00,UFU ALVAREZ,217,186,318,71,14,403,374,29,386,17,78,48,60,82,57,48,22,8,0,13,269,92,374
20210812,12AUG2021:00:00:00,UFU ARGERICH,70,55,80,40,5,125,101,24,101,24,10,18,37,16,18,14,6,6,0,7,53,41,101
20210812,12AUG2021:00:00:00,UFU BORDA-MOYANO,65,57,71,39,12,122,120,2,120,2,0,4,27,41,26,15,7,2,0,3,73,44,120
20210812,12AUG2021:00:00:00,UFU DURAND,131,110,200,26,15,241,225,16,235,6,6,6,48,67,36,44,21,13,0,18,117,90,225
20210812,12AUG2021:00:00:00,UFU ELIZALDE,176,224,135,258,7,400,340,60,382,18,254,97,14,22,9,2,1,1,0,2,207,131,340
20210812,12AUG2021:00:00:00,UFU FERNANDEZ,109,69,135,33,10,178,168,10,170,8,0,1,54,35,35,26,25,2,0,6,93,69,168
20210812,12AUG2021:00:00:00,UFU FERRER,106,80,103,77,6,186,184,2,184,2,3,4,30,74,34,34,7,0,0,9,128,47,184
20210812,12AUG2021:00:00:00,UFU GRIERSON,102,81,103,57,23,183,177,6,177,6,0,12,28,53,51,23,15,1,0,5,125,45,177
20210812,12AUG2021:00:00:00,UFU GUTIERREZ,143,153,227,62,7,296,282,14,292,4,172,49,18,18,23,16,0,0,0,3,192,87,282
20210812,12AUG2021:00:00:00,UFU MUÑIZ,138,138,122,147,7,276,236,40,246,30,0,13,61,59,71,43,19,10,0,6,166,64,236
20210812,12AUG2021:00:00:00,UFU PENNA,77,51,77,48,3,128,112,16,124,4,0,4,39,30,17,18,14,6,0,3,76,33,112
20210812,12AUG2021:00:00:00,UFU PIROVANO,201,105,251,34,21,306,286,20,302,4,0,10,67,98,57,43,13,18,0,7,168,111,286
20210812,12AUG2021:00:00:00,UFU PIÑERO,100,62,122,24,16,162,162,0,162,0,0,13,45,31,10,38,14,11,0,3,121,37,162
20210812,12AUG2021:00:00:00,UFU RAMOS MEJIA,175,152,229,64,34,327,293,34,299,28,15,18,80,68,77,29,21,19,0,8,195,90,293
20210812,12AUG2021:00:00:00,UFU RIVADAVIA,128,80,143,49,16,208,178,30,180,28,0,7,68,58,38,17,18,2,0,5,99,74,178
20210812,12AUG2021:00:00:00,UFU SANTOJANNI,247,175,207,186,29,422,388,34,404,18,12,38,93,97,74,45,45,18,0,17,265,106,388
20210812,12AUG2021:00:00:00,UFU TORNU,178,132,254,43,13,310,276,34,276,34,33,26,56,72,51,40,27,5,0,6,196,70,276
20210812,12AUG2021:00:00:00,UFU VELEZ SARSFIELD,143,130,211,49,13,273,271,2,271,2,0,14,62,54,55,45,31,12,0,12,188,71,271
20210812,12AUG2021:00:00:00,UFU ZUBIZARRETA,61,85,101,40,5,146,146,0,146,0,2,11,36,28,34,16,10,9,0,6,100,40,146
20210813,13AUG2021:00:00:00,UFU ALVAREZ,207,172,293,62,24,379,312,67,316,63,48,43,85,88,45,42,14,14,0,9,222,80,312
20210813,13AUG2021:00:00:00,UFU ARGERICH,67,55,80,40,2,122,100,22,100,22,11,7,24,29,15,13,14,9,0,5,56,39,100
20210813,13AUG2021:00:00:00,UFU BORDA-MOYANO,45,26,38,33,0,71,65,6,65,6,0,7,8,16,20,13,5,2,0,1,42,22,65
20210813,13AUG2021:00:00:00,UFU DURAND,122,96,182,16,20,218,204,14,208,10,4,12,63,66,36,19,10,8,0,9,112,83,204
20210813,13AUG2021:00:00:00,UFU ELIZALDE,158,98,99,154,3,256,206,50,244,12,143,55,20,17,13,8,0,0,0,4,117,85,206
20210813,13AUG2021:00:00:00,UFU FERNANDEZ,92,72,133,10,21,164,156,8,156,8,0,13,36,54,23,19,10,9,0,4,93,59,156
20210813,13AUG2021:00:00:00,UFU FERRER,122,96,132,63,23,218,214,4,214,4,0,3,57,62,36,30,21,9,0,1,157,56,214
20210813,13AUG2021:00:00:00,UFU GRIERSON,94,75,104,55,10,169,157,12,163,6,0,12,41,44,21,20,23,8,0,6,107,44,157
20210813,13AUG2021:00:00:00,UFU GUTIERREZ,181,149,202,120,8,330,304,26,322,8,212,59,18,14,16,5,6,0,0,1,212,90,304
20210813,13AUG2021:00:00:00,UFU MUÑIZ,120,131,93,136,22,251,209,42,217,34,0,5,44,61,80,30,20,11,0,6,147,56,209
20210813,13AUG2021:00:00:00,UFU PENNA,70,49,81,31,7,119,107,12,113,6,0,4,37,22,22,11,16,7,0,3,78,26,107
20210813,13AUG2021:00:00:00,UFU PIROVANO,148,120,220,29,19,268,250,18,262,6,0,8,63,80,53,39,11,14,0,11,135,104,250
20210813,13AUG2021:00:00:00,UFU PIÑERO,137,59,154,38,4,196,190,6,192,4,3,13,56,44,32,28,7,13,0,2,144,44,190
20210813,13AUG2021:00:00:00,UFU RAMOS MEJIA,184,144,239,54,35,328,290,38,318,10,17,30,45,80,65,43,44,4,0,10,176,104,290
20210813,13AUG2021:00:00:00,UFU RIVADAVIA,154,92,196,25,25,246,238,8,238,8,0,10,75,63,31,34,23,10,0,8,134,96,238
20210813,13AUG2021:00:00:00,UFU SANTOJANNI,261,150,212,179,20,411,391,20,409,2,18,49,92,83,55,59,39,16,0,14,282,95,391
20210813,13AUG2021:00:00:00,UFU TORNU,147,163,270,28,12,310,192,118,212,98,26,43,54,93,37,37,13,7,0,1,136,51,192
20210813,13AUG2021:00:00:00,UFU VELEZ SARSFIELD,130,117,204,34,9,247,239,8,241,6,0,27,42,62,60,38,14,4,0,13,162,64,239
20210813,13AUG2021:00:00:00,UFU ZUBIZARRETA,146,102,147,87,14,248,244,4,248,0,0,25,52,64,39,47,16,5,0,7,170,67,244
20210814,14AUG2021:00:00:00,UFU ALVAREZ,178,155,278,47,8,333,319,14,321,12,34,31,69,57,60,35,31,16,0,12,233,74,319
20210814,14AUG2021:00:00:00,UFU ARGERICH,6,2,5,2,1,8,8,0,8,0,2,0,0,0,5,0,1,0,0,1,4,3,8
20210814,14AUG2021:00:00:00,UFU BORDA-MOYANO,34,8,24,16,2,42,40,2,40,2,0,0,6,4,9,9,10,4,0,1,25,14,40
20210814,14AUG2021:00:00:00,UFU DURAND,111,64,151,15,9,175,165,10,165,10,9,12,44,44,37,21,4,4,0,12,90,63,165
20210814,14AUG2021:00:00:00,UFU ELIZALDE,102,79,74,107,0,181,159,22,173,8,112,52,5,7,1,4,0,0,0,3,95,61,159
20210814,14AUG2021:00:00:00,UFU FERNANDEZ,90,76,131,25,10,166,150,16,160,6,0,11,24,58,26,26,14,7,0,8,81,61,150
20210814,14AUG2021:00:00:00,UFU FERRER,115,50,41,122,2,165,161,4,163,2,0,8,28,45,46,20,16,2,0,6,114,41,161
20210814,14AUG2021:00:00:00,UFU GRIERSON,103,90,121,51,21,193,181,12,185,8,2,10,47,48,34,19,19,14,0,5,123,53,181
20210814,14AUG2021:00:00:00,UFU GUTIERREZ,99,88,123,59,5,187,183,4,185,2,119,33,5,11,10,9,0,0,0,1,128,54,183
20210814,14AUG2021:00:00:00,UFU MUÑIZ,107,120,109,112,6,227,187,40,193,34,0,7,54,59,60,29,16,2,0,9,131,47,187
20210814,14AUG2021:00:00:00,UFU PENNA,58,49,44,63,0,107,99,8,105,2,0,14,32,19,14,25,3,0,0,1,71,27,99
20210814,14AUG2021:00:00:00,UFU PIROVANO,197,131,254,47,27,328,320,8,320,8,0,12,62,91,83,47,18,15,0,15,164,140,320
20210814,14AUG2021:00:00:00,UFU PIÑERO,86,54,88,33,19,140,136,4,136,4,0,8,31,18,37,22,18,6,0,6,93,37,136
20210814,14AUG2021:00:00:00,UFU RAMOS MEJIA,123,120,173,35,35,243,227,16,229,14,8,8,52,48,61,36,22,8,0,11,162,54,227
20210814,14AUG2021:00:00:00,UFU RIVADAVIA,148,87,192,26,17,235,171,64,171,64,0,16,76,56,41,23,16,7,0,12,90,66,171
20210814,14AUG2021:00:00:00,UFU SANTOJANNI,212,171,195,176,12,383,377,6,377,6,0,27,67,97,86,44,29,33,0,13,263,101,377
20210814,14AUG2021:00:00:00,UFU TORNU,119,110,173,38,18,229,223,6,223,6,3,22,26,74,51,25,21,7,0,7,161,55,223
20211005,05OCT2021:00:00:00,UFU ARGERICH,59,48,59,46,2,107,91,16,93,14,18,13,20,22,14,18,2,0,0,2,48,41,91
20211005,05OCT2021:00:00:00,UFU BORDA-MOYANO,27,25,25,26,1,52,52,0,52,0,0,0,17,23,4,3,3,2,0,1,36,15,52
20211005,05OCT2021:00:00:00,UFU DURAND,133,88,201,12,8,221,207,14,207,14,24,23,37,53,45,17,13,9,0,4,113,90,207
20211005,05OCT2021:00:00:00,UFU ELIZALDE,167,177,117,216,11,344,270,74,324,20,221,85,11,12,10,2,3,0,0,0,180,90,270
20211005,05OCT2021:00:00:00,UFU FERNANDEZ,90,81,149,18,4,171,163,8,165,6,0,9,44,37,32,26,12,11,0,0,82,81,163
20211005,05OCT2021:00:00:00,UFU FERRER,102,71,88,80,5,173,173,0,173,0,0,4,55,36,52,4,15,7,0,1,120,52,173
20211005,05OCT2021:00:00:00,UFU GRIERSON,90,116,132,48,26,206,194,12,204,2,0,34,30,49,45,35,7,6,0,4,143,46,194
20211005,05OCT2021:00:00:00,UFU GUTIERREZ,169,188,215,140,2,357,325,32,347,10,189,127,5,21,9,3,3,0,0,2,203,119,325
20211005,05OCT2021:00:00:00,UFU MUÑIZ,108,112,87,119,14,220,176,44,178,42,2,14,44,39,39,46,29,7,0,0,131,45,176
20211005,05OCT2021:00:00:00,UFU PENNA,65,79,72,72,0,144,132,12,134,10,60,26,7,27,2,12,5,5,0,0,94,38,132
20211005,05OCT2021:00:00:00,UFU PIROVANO,190,147,270,52,15,337,312,25,333,4,0,16,78,81,72,31,39,20,0,4,196,112,312
20211005,05OCT2021:00:00:00,UFU PIÑERO,147,140,263,18,6,287,267,20,267,20,117,49,38,26,25,12,17,3,0,1,198,66,267
20211005,05OCT2021:00:00:00,UFU RAMOS MEJIA,167,139,217,71,18,306,276,30,276,30,50,37,38,68,54,19,24,16,0,2,170,104,276
20211005,05OCT2021:00:00:00,UFU RIVADAVIA,120,83,158,22,23,203,191,12,191,12,2,7,53,69,27,22,17,6,0,1,117,73,191
20211005,05OCT2021:00:00:00,UFU SANTOJANNI,104,83,127,55,5,187,177,10,181,6,0,32,32,33,32,25,17,16,0,0,100,77,177
20211005,05OCT2021:00:00:00,UFU TORNU,191,171,298,48,16,362,242,120,242,120,81,40,48,89,63,22,14,5,0,1,180,56,242
20211005,05OCT2021:00:00:00,UFU VELEZ SARSFIELD,121,120,194,33,14,241,231,10,235,6,0,17,46,54,51,42,17,14,0,0,101,130,231
20211005,05OCT2021:00:00:00,UFU ZUBIZARRETA,129,95,152,64,8,224,218,6,224,0,0,40,38,59,36,20,21,10,0,2,170,46,218
20211006,06OCT2021:00:00:00,UFU ALVAREZ,109,99,167,29,12,208,176,32,184,24,51,21,42,32,17,21,11,13,0,2,111,63,176
20211006,06OCT2021:00:00:00,UFU ARGERICH,59,74,77,48,8,133,99,34,99,34,32,17,21,26,13,14,8,2,0,4,52,42,99
20211006,06OCT2021:00:00:00,UFU BORDA-MOYANO,11,27,29,8,1,38,26,12,26,12,0,4,12,12,4,0,4,2,0,0,18,8,26
20211006,06OCT2021:00:00:00,UFU DURAND,111,67,154,14,10,178,166,12,166,12,18,15,28,52,22,21,12,10,0,5,97,64,166
20211006,06OCT2021:00:00:00,UFU ELIZALDE,137,119,89,160,7,256,242,14,244,12,174,67,0,7,7,1,0,0,0,0,162,80,242
20211006,06OCT2021:00:00:00,UFU FERNANDEZ,87,35,104,12,6,122,114,8,118,4,0,12,32,33,14,12,12,7,0,2,71,41,114
20211006,06OCT2021:00:00:00,UFU FERRER,79,45,73,51,0,124,122,2,122,2,0,3,26,28,35,24,5,3,0,1,92,29,122
20211006,06OCT2021:00:00:00,UFU GRIERSON,90,80,120,38,12,170,144,26,170,0,0,16,60,26,26,27,14,1,0,0,104,40,144
20211006,06OCT2021:00:00:00,UFU GUTIERREZ,169,158,181,137,9,327,295,32,319,8,214,81,12,10,5,3,2,0,0,1,202,92,295
20211006,06OCT2021:00:00:00,UFU MUÑIZ,134,90,111,98,15,224,192,32,200,24,0,24,52,48,46,41,7,6,0,0,136,56,192
20211006,06OCT2021:00:00:00,UFU PENNA,75,43,63,53,2,118,112,6,112,6,41,27,10,20,6,3,6,5,0,4,78,30,112
20211006,06OCT2021:00:00:00,UFU PIROVANO,164,101,208,33,24,265,257,8,263,2,0,9,64,91,52,34,9,6,0,4,83,170,257
20211006,06OCT2021:00:00:00,UFU PIÑERO,122,123,193,41,11,245,237,8,237,8,57,32,41,43,34,21,15,2,0,0,169,68,237
20211006,06OCT2021:00:00:00,UFU RAMOS MEJIA,130,79,155,30,24,209,169,40,173,36,22,16,60,36,27,11,24,13,0,3,103,63,169
20211006,06OCT2021:00:00:00,UFU RIVADAVIA,109,69,128,22,28,178,174,4,174,4,0,6,41,60,30,22,7,12,0,4,100,70,174
20211006,06OCT2021:00:00:00,UFU SANTOJANNI,121,105,113,104,9,226,206,20,214,12,15,16,48,43,26,31,26,21,0,6,118,82,206
20211006,06OCT2021:00:00:00,UFU TORNU,171,81,209,29,14,252,200,52,204,48,36,30,32,48,56,26,22,2,0,2,145,52,200
20211006,06OCT2021:00:00:00,UFU VELEZ SARSFIELD,100,112,159,44,9,212,212,0,212,0,0,11,37,54,45,23,26,16,0,1,154,57,212
20211006,06OCT2021:00:00:00,UFU ZUBIZARRETA,50,29,49,24,6,79,79,0,79,0,0,2,23,15,19,13,2,5,0,0,58,21,79
20211007,07OCT2021:00:00:00,UFU ALVAREZ,123,103,175,37,14,226,218,8,218,8,41,23,31,57,23,21,16,14,0,0,153,65,218
20211007,07OCT2021:00:00:00,UFU ARGERICH,36,28,37,23,4,64,58,6,60,4,2,10,13,19,9,6,4,1,0,0,33,25,58
20211007,07OCT2021:00:00:00,UFU BORDA-MOYANO,24,19,18,23,2,43,39,4,39,4,3,0,9,7,8,5,9,2,0,0,28,11,39
20211007,07OCT2021:00:00:00,UFU DURAND,84,80,147,14,3,164,156,8,156,8,18,22,39,42,16,9,10,8,0,3,88,65,156
20211007,07OCT2021:00:00:00,UFU ELIZALDE,118,100,75,137,6,218,186,32,210,8,159,51,0,4,0,4,0,0,0,0,121,65,186
20211007,07OCT2021:00:00:00,UFU FERNANDEZ,73,43,93,18,5,116,110,6,112,4,0,8,42,24,22,13,5,2,0,0,72,38,110
20211007,07OCT2021:00:00:00,UFU FERRER,95,78,127,46,0,173,173,0,173,0,0,11,35,53,46,20,3,5,0,1,129,43,173
20211007,07OCT2021:00:00:00,UFU GRIERSON,66,33,66,21,12,99,85,14,91,8,0,14,32,15,13,18,7,0,0,0,63,21,85
20211007,07OCT2021:00:00:00,UFU GUTIERREZ,114,90,126,74,4,204,170,34,196,8,138,44,8,12,0,2,0,0,0,0,110,60,170
20211007,07OCT2021:00:00:00,UFU MUÑIZ,83,91,82,74,18,174,148,26,152,22,0,7,34,33,63,25,5,7,0,0,105,42,148
20211007,07OCT2021:00:00:00,UFU PENNA,80,71,90,55,6,151,147,4,147,4,54,32,14,23,19,5,3,1,0,3,105,39,147
20211007,07OCT2021:00:00:00,UFU PIROVANO,118,90,173,22,13,208,200,8,202,6,0,10,33,54,54,27,20,10,0,4,119,77,200
20211007,07OCT2021:00:00:00,UFU PIÑERO,105,70,143,26,6,175,167,8,167,8,54,22,35,26,12,5,12,9,0,5,124,37,167
20211007,07OCT2021:00:00:00,UFU RAMOS MEJIA,96,82,135,29,14,178,174,4,176,2,12,14,31,51,36,13,15,6,0,0,102,72,174
20211007,07OCT2021:00:00:00,UFU RIVADAVIA,103,57,123,25,12,160,160,0,160,0,0,4,48,50,18,14,14,12,0,3,91,66,160
20211007,07OCT2021:00:00:00,UFU SANTOJANNI,86,55,92,43,6,141,135,6,137,4,0,16,20,28,26,30,8,13,0,1,85,49,135
20211007,07OCT2021:00:00:00,UFU TORNU,95,111,173,29,4,206,126,80,128,78,30,43,17,42,42,16,7,9,0,4,86,36,126
20211007,07OCT2021:00:00:00,UFU VELEZ SARSFIELD,72,64,103,27,6,136,134,2,134,2,0,15,41,18,23,10,14,15,0,2,94,38,134
20211007,07OCT2021:00:00:00,UFU ZUBIZARRETA,101,79,134,32,14,180,178,2,180,0,0,24,25,45,50,12,12,12,0,3,125,50,178
20211008,08OCT2021:00:00:00,UFU ALVAREZ,135,79,183,23,8,214,202,12,202,12,27,20,41,49,40,26,9,2,0,2,146,54,202
20211008,08OCT2021:00:00:00,UFU ARGERICH,23,18,31,9,1,41,41,0,41,0,0,0,13,8,6,6,4,4,0,0,22,19,41
20211008,08OCT2021:00:00:00,UFU BORDA-MOYANO,10,8,11,7,0,18,18,0,18,0,0,2,3,2,4,5,0,2,0,1,10,7,18
20211008,08OCT2021:00:00:00,UFU DURAND,67,50,105,7,5,117,117,0,117,0,0,5,13,29,26,13,24,7,0,2,67,48,117
20211008,08OCT2021:00:00:00,UFU ELIZALDE,61,63,37,87,0,124,108,16,118,6,91,22,8,0,2,0,1,0,0,1,68,39,108
20211008,08OCT2021:00:00:00,UFU FERNANDEZ,71,41,93,9,10,112,102,10,102,10,0,2,32,22,24,13,11,8,0,0,62,40,102
20211008,08OCT2021:00:00:00,UFU FERRER,74,47,49,70,2,121,109,12,113,8,0,6,18,28,40,19,5,5,0,6,82,21,109
20211008,08OCT2021:00:00:00,UFU GRIERSON,71,43,61,36,17,114,108,6,108,6,0,12,12,36,34,15,3,2,0,0,83,25,108
20211008,08OCT2021:00:00:00,UFU GUTIERREZ,77,82,93,64,2,159,145,14,149,10,113,27,2,3,7,5,2,0,0,0,102,42,145
20220118,18JAN2022:00:00:00,UFU VELEZ SARSFIELD,502,450,710,176,113,999,999,0,999,0,47,30,168,229,224,162,112,27,0,307,256,436,999
20220118,18JAN2022:00:00:00,UFU ZUBIZARRETA,441,319,442,248,121,811,811,0,811,0,51,37,152,204,161,106,61,39,0,248,113,450,811
20220119,19JAN2022:00:00:00,UFU ALVAREZ,593,492,778,199,108,1085,1085,0,1085,0,35,74,200,278,216,139,69,74,0,375,270,440,1085
20220119,19JAN2022:00:00:00,UFU ARGERICH,21,37,32,23,3,58,58,0,58,0,0,0,12,22,16,2,6,0,0,29,7,22,58
20220119,19JAN2022:00:00:00,UFU BORDA-MOYANO,301,300,292,252,57,601,601,0,601,0,7,17,119,137,141,110,52,18,0,217,159,225,601
20220119,19JAN2022:00:00:00,UFU DURAND,520,371,698,70,123,891,891,0,891,0,0,18,196,281,138,125,79,54,0,378,165,348,891
20220119,19JAN2022:00:00:00,UFU ELIZALDE,245,192,159,261,17,437,437,0,437,0,192,113,17,46,36,20,7,6,0,124,129,184,437
20220119,19JAN2022:00:00:00,UFU FERNANDEZ,321,273,392,110,92,594,594,0,594,0,0,11,126,183,115,73,45,41,0,232,135,227,594
20220119,19JAN2022:00:00:00,UFU FERRER,307,258,257,251,57,565,565,0,565,0,0,7,129,175,117,86,42,9,0,210,191,164,565
20220119,19JAN2022:00:00:00,UFU GRIERSON,192,196,234,120,34,388,388,0,388,0,0,15,94,85,104,48,33,9,0,141,126,121,388
20220119,19JAN2022:00:00:00,UFU GUTIERREZ,316,191,290,129,88,507,507,0,507,0,158,125,35,79,64,41,5,0,0,128,206,171,507
20220119,19JAN2022:00:00:00,UFU MUÑIZ,315,378,294,274,125,693,693,0,693,0,2,16,139,198,170,108,49,11,0,266,159,267,693
20220119,19JAN2022:00:00:00,UFU PENNA,274,228,272,187,43,502,502,0,502,0,14,16,114,139,105,70,33,11,0,157,205,140,502
20220119,19JAN2022:00:00:00,UFU PIROVANO,528,399,634,147,146,927,927,0,927,0,0,22,211,305,153,117,67,52,0,423,153,351,927
20220119,19JAN2022:00:00:00,UFU PIÑERO,472,354,579,169,78,826,826,0,826,0,3,50,160,228,178,129,52,26,0,245,327,251,826
20220119,19JAN2022:00:00:00,UFU RAMOS MEJIA,613,508,817,190,114,1121,1121,0,1121,0,11,49,250,288,229,137,106,51,0,423,235,460,1121
20220119,19JAN2022:00:00:00,UFU RIVADAVIA,479,374,563,183,107,853,853,0,853,0,4,16,233,223,147,117,82,31,0,362,175,310,853
20220119,19JAN2022:00:00:00,UFU SANTOJANNI,426,385,390,322,99,811,811,0,811,0,11,39,198,203,147,114,58,41,0,335,157,319,811
20220119,19JAN2022:00:00:00,UFU TORNU,289,270,425,82,52,559,559,0,559,0,10,34,87,143,145,58,59,23,0,196,117,237,559
20220119,19JAN2022:00:00:00,UFU VELEZ SARSFIELD,351,380,585,89,57,731,731,0,731,0,0,9,120,166,177,127,92,40,0,260,227,244,731
20220119,19JAN2022:00:00:00,UFU ZUBIZARRETA,354,300,416,157,81,654,654,0,654,0,0,22,134,162,148,98,57,33,0,302,93,259,654
20220120,20JAN2022:00:00:00,UFU ALVAREZ,481,421,644,156,102,902,902,0,902,0,6,42,199,232,142,117,103,61,0,250,270,382,902
20220120,20JAN2022:00:00:00,UFU ARGERICH,103,88,104,80,7,191,191,0,191,0,7,5,43,53,29,33,16,5,0,86,24,81,191
20220120,20JAN2022:00:00:00,UFU BORDA-MOYANO,263,278,303,182,56,541,541,0,541,0,11,20,117,120,98,93,68,14,0,178,150,213,541
20220120,20JAN2022:00:00:00,UFU DURAND,589,470,840,123,96,1059,1059,0,1059,0,0,49,213,310,205,147,74,61,0,433,210,416,1059
20220120,20JAN2022:00:00:00,UFU ELIZALDE,226,141,135,222,10,367,367,0,367,0,168,91,24,39,19,19,7,0,0,107,104,156,367
20220120,20JAN2022:00:00:00,UFU FERNANDEZ,454,386,526,116,198,840,840,0,840,0,3,12,182,238,172,127,69,37,0,286,217,337,840
20220120,20JAN2022:00:00:00,UFU FERRER,257,274,237,228,66,531,531,0,531,0,2,9,104,156,109,96,41,14,0,168,189,174,531
20220120,20JAN2022:00:00:00,UFU GRIERSON,142,146,162,81,45,288,288,0,288,0,0,5,60,75,61,43,33,11,0,98,104,86,288
20220120,20JAN2022:00:00:00,UFU GUTIERREZ,207,149,205,90,61,356,356,0,356,0,151,80,19,47,45,12,2,0,0,101,109,146,356
20220120,20JAN2022:00:00:00,UFU MUÑIZ,218,275,223,182,88,493,493,0,493,0,0,15,97,130,114,90,34,13,0,191,108,194,493
20220120,20JAN2022:00:00:00,UFU PENNA,267,245,253,231,28,512,512,0,512,0,16,35,110,105,102,64,64,16,0,155,213,144,512
20220120,20JAN2022:00:00:00,UFU PIROVANO,507,474,720,127,134,981,981,0,981,0,2,22,239,305,187,126,60,40,0,422,169,388,981
20220120,20JAN2022:00:00:00,UFU PIÑERO,404,313,493,170,54,717,717,0,717,0,0,40,146,160,146,123,80,22,0,190,310,214,717
20220120,20JAN2022:00:00:00,UFU RAMOS MEJIA,546,492,688,232,118,1038,1038,0,1038,0,4,41,205,273,221,153,94,47,0,381,243,414,1038
20220120,20JAN2022:00:00:00,UFU RIVADAVIA,565,402,625,216,126,967,967,0,967,0,0,16,245,297,182,106,81,40,0,353,221,391,967
20220120,20JAN2022:00:00:00,UFU SANTOJANNI,300,242,253,217,72,542,542,0,542,0,0,32,127,128,130,53,48,24,0,217,95,230,542
20220120,20JAN2022:00:00:00,UFU TORNU,277,244,424,60,37,521,521,0,521,0,18,23,82,126,112,72,54,34,0,194,98,228,521
20220120,20JAN2022:00:00:00,UFU VELEZ SARSFIELD,389,315,533,115,56,704,704,0,704,0,0,35,138,189,115,126,81,20,0,260,151,293,704
20220120,20JAN2022:00:00:00,UFU ZUBIZARRETA,368,292,429,169,62,660,660,0,660,0,0,23,159,161,142,75,58,42,0,247,146,267,660
20220121,21JAN2022:00:00:00,UFU ALVAREZ,627,420,760,178,109,1047,1047,0,1047,0,30,91,210,213,241,136,78,48,0,295,315,437,1047
20220121,21JAN2022:00:00:00,UFU ARGERICH,80,59,67,70,2,139,139,0,139,0,2,2,29,24,42,14,18,8,0,52,29,58,139
20220121,21JAN2022:00:00:00,UFU BORDA-MOYANO,208,249,241,182,34,457,457,0,457,0,4,28,82,106,96,76,41,24,0,135,137,185,457
20220121,21JAN2022:00:00:00,UFU DURAND,512,408,718,123,79,920,920,0,920,0,0,38,193,253,201,128,67,40,0,380,182,358,920
20220121,21JAN2022:00:00:00,UFU ELIZALDE,209,159,108,245,15,368,368,0,368,0,174,77,18,54,32,9,2,2,0,103,115,150,368
20220121,21JAN2022:00:00:00,UFU FERNANDEZ,400,317,450,101,166,717,717,0,717,0,0,13,148,220,132,118,61,25,0,199,192,326,717
20220121,21JAN2022:00:00:00,UFU FERRER,258,282,260,232,48,540,540,0,540,0,0,8,107,143,133,89,47,13,0,175,181,184,540
20220121,21JAN2022:00:00:00,UFU GRIERSON,168,181,201,129,19,349,349,0,349,0,0,24,70,71,78,63,27,16,0,128,112,109,349
20220121,21JAN2022:00:00:00,UFU GUTIERREZ,262,145,229,112,66,407,407,0,407,0,150,84,22,56,56,31,7,1,0,100,151,154,407
20220121,21JAN2022:00:00:00,UFU MUÑIZ,266,247,257,172,84,513,513,0,513,0,1,15,109,130,136,77,34,11,0,203,101,209,513
20220121,21JAN2022:00:00:00,UFU PENNA,271,185,219,202,35,456,456,0,456,0,17,20,108,121,79,63,38,10,0,124,198,133,456
20220121,21JAN2022:00:00:00,UFU PIROVANO,454,357,554,127,130,811,811,0,811,0,0,29,200,226,171,109,58,18,0,357,136,318,811
20220121,21JAN2022:00:00:00,UFU PIÑERO,342,251,432,119,42,593,593,0,593,0,0,24,125,142,127,107,54,14,0,155,268,170,593
20220121,21JAN2022:00:00:00,UFU RAMOS MEJIA,563,424,692,196,99,987,987,0,987,0,18,44,183,256,208,146,93,39,0,352,231,404,987
20220121,21JAN2022:00:00:00,UFU RIVADAVIA,493,310,506,210,87,803,803,0,803,0,0,7,198,228,128,105,96,41,0,284,201,316,803
20220121,21JAN2022:00:00:00,UFU SANTOJANNI,382,318,362,228,110,700,700,0,700,0,5,41,129,182,141,90,70,42,0,220,126,354,700
20220121,21JAN2022:00:00:00,UFU TORNU,298,247,431,69,45,545,545,0,545,0,11,36,86,134,127,77,40,34,0,167,118,257,545
20220121,21JAN2022:00:00:00,UFU VELEZ SARSFIELD,464,281,576,126,43,745,745,0,745,0,0,21,135,193,168,98,86,44,0,228,239,278,745
20220121,21JAN2022:00:00:00,UFU ZUBIZARRETA,363,334,452,201,44,697,697,0,697,0,0,23,133,179,145,110,55,52,0,253,124,320,697
20220122,22JAN2022:00:00:00,UFU ALVAREZ,424,356,596,101,83,780,780,0,780,0,21,45,142,160,173,106,77,56,0,207,269,304,780
20220122,22JAN2022:00:00:00,UFU ARGERICH,92,73,77,79,14,170,170,0,170,0,9,9,32,41,40,25,11,3,0,69,20,81,170
20220112,12JAN2022:00:00:00,UFU FERNANDEZ,362,341,456,154,93,703,703,0,703,0,0,26,176,237,124,72,41,27,0,257,166,277,703
20220112,12JAN2022:00:00:00,UFU FERRER,322,314,296,293,47,636,636,0,636,0,0,10,160,195,157,85,29,0,0,253,144,239,636
20220112,12JAN2022:00:00:00,UFU GRIERSON,191,150,180,129,32,341,341,0,341,0,0,14,91,89,77,30,34,6,0,127,93,119,341
20220112,12JAN2022:00:00:00,UFU GUTIERREZ,346,213,375,108,76,559,559,0,559,0,194,142,24,89,80,19,8,3,0,155,222,182,559
20220112,12JAN2022:00:00:00,UFU MUÑIZ,454,482,493,297,146,936,936,0,936,0,7,23,271,242,201,130,49,13,0,339,158,439,936
20220112,12JAN2022:00:00:00,UFU PENNA,295,216,268,209,34,511,511,0,511,0,12,6,148,162,68,61,41,13,0,192,156,163,511
20220112,12JAN2022:00:00:00,UFU PIROVANO,422,327,536,122,91,749,749,0,749,0,0,19,201,235,130,89,49,26,0,342,90,316,749
20220112,12JAN2022:00:00:00,UFU PIÑERO,467,382,586,156,107,849,849,0,849,0,0,37,262,225,165,117,35,8,0,294,291,264,849
20220112,12JAN2022:00:00:00,UFU RAMOS MEJIA,568,527,775,216,104,1095,1095,0,1095,0,14,38,274,315,191,138,83,42,0,438,187,469,1095
20220112,12JAN2022:00:00:00,UFU RIVADAVIA,733,520,809,269,175,1253,1253,0,1253,0,2,19,435,351,197,136,82,31,0,464,265,524,1253
20220112,12JAN2022:00:00:00,UFU SANTOJANNI,360,350,353,220,137,710,710,0,710,0,4,33,177,235,129,79,35,18,0,357,105,248,710
20220112,12JAN2022:00:00:00,UFU TORNU,530,479,803,144,62,1009,1009,0,1009,0,44,76,220,249,186,144,48,42,0,344,179,481,1009
20220112,12JAN2022:00:00:00,UFU VELEZ SARSFIELD,337,324,519,104,38,661,661,0,661,0,0,26,179,175,124,83,62,12,0,277,148,236,661
20220112,12JAN2022:00:00:00,UFU ZUBIZARRETA,379,317,421,230,45,696,696,0,696,0,2,38,174,194,138,92,38,20,0,282,102,312,696
20220113,13JAN2022:00:00:00,UFU ALVAREZ,732,630,976,283,103,1362,1362,0,1362,0,49,107,314,366,240,124,110,52,0,469,384,506,1362
20220113,13JAN2022:00:00:00,UFU ARGERICH,37,18,30,25,0,55,55,0,55,0,2,0,15,3,13,7,10,5,0,27,9,19,55
20220113,13JAN2022:00:00:00,UFU BORDA-MOYANO,351,340,354,263,74,691,691,0,691,0,8,21,176,193,123,114,28,28,0,260,140,290,691
20220113,13JAN2022:00:00:00,UFU DURAND,750,652,1161,166,75,1402,1402,0,1402,0,0,54,361,435,242,139,108,63,0,605,235,562,1402
20220113,13JAN2022:00:00:00,UFU ELIZALDE,206,146,150,194,8,352,352,0,352,0,174,92,23,26,24,11,2,0,0,127,72,153,352
20220113,13JAN2022:00:00:00,UFU FERNANDEZ,477,433,604,160,146,910,910,0,910,0,0,11,238,309,157,109,50,36,0,307,223,379,910
20220113,13JAN2022:00:00:00,UFU FERRER,319,295,284,257,73,614,614,0,614,0,0,14,141,185,131,98,34,11,0,234,169,211,614
20220113,13JAN2022:00:00:00,UFU GRIERSON,161,159,182,110,28,320,320,0,320,0,0,5,63,115,68,39,19,11,0,107,82,130,320
20220113,13JAN2022:00:00:00,UFU GUTIERREZ,272,177,271,126,54,451,451,0,451,0,162,127,32,43,69,18,0,0,0,111,169,168,451
20220113,13JAN2022:00:00:00,UFU MUÑIZ,406,428,374,320,140,834,834,0,834,0,0,22,208,207,209,116,54,18,0,342,156,336,834
20220113,13JAN2022:00:00:00,UFU PENNA,290,222,283,206,23,512,512,0,512,0,13,23,115,144,113,63,24,17,0,165,177,170,512
20220113,13JAN2022:00:00:00,UFU PIROVANO,384,405,528,128,133,789,789,0,789,0,2,22,227,254,138,85,43,18,0,348,110,331,789
20220113,13JAN2022:00:00:00,UFU PIÑERO,496,423,650,149,120,919,919,0,919,0,0,42,276,241,183,105,33,39,0,327,281,309,919
20220113,13JAN2022:00:00:00,UFU RAMOS MEJIA,545,504,747,206,96,1049,1049,0,1049,0,12,18,229,271,241,135,91,52,0,436,179,434,1049
20220113,13JAN2022:00:00:00,UFU RIVADAVIA,677,503,717,282,181,1180,1180,0,1180,0,0,17,373,333,192,146,106,13,0,496,212,472,1180
20220113,13JAN2022:00:00:00,UFU SANTOJANNI,512,415,439,315,173,927,927,0,927,0,9,54,245,225,186,138,56,14,0,351,165,411,927
20220113,13JAN2022:00:00:00,UFU TORNU,456,420,665,148,63,876,876,0,876,0,35,51,167,239,176,126,50,32,0,337,152,384,876
20220113,13JAN2022:00:00:00,UFU VELEZ SARSFIELD,329,323,475,135,42,652,652,0,652,0,0,39,153,160,135,85,57,23,0,270,155,227,652
20220113,13JAN2022:00:00:00,UFU ZUBIZARRETA,328,293,397,199,25,621,621,0,621,0,0,18,172,173,99,97,38,24,0,260,100,261,621
20220114,14JAN2022:00:00:00,UFU ALVAREZ,460,402,625,161,76,862,862,0,862,0,52,42,188,204,180,100,62,34,0,358,110,394,862
20220114,14JAN2022:00:00:00,UFU ARGERICH,49,49,49,49,0,98,98,0,98,0,8,2,25,28,16,15,4,0,0,36,17,45,98
20220114,14JAN2022:00:00:00,UFU BORDA-MOYANO,254,289,252,226,65,543,543,0,543,0,3,7,127,137,127,100,33,9,0,198,122,223,543
20220114,14JAN2022:00:00:00,UFU DURAND,641,538,933,161,85,1179,1179,0,1179,0,2,53,288,340,228,166,65,37,0,538,178,463,1179
20220114,14JAN2022:00:00:00,UFU ELIZALDE,193,190,137,235,11,383,383,0,383,0,172,76,32,59,24,15,4,1,0,127,71,185,383
20220114,14JAN2022:00:00:00,UFU FERNANDEZ,359,320,450,117,112,679,679,0,679,0,0,11,169,187,140,85,48,39,0,239,149,291,679
20220114,14JAN2022:00:00:00,UFU FERRER,213,208,167,182,72,421,421,0,421,0,0,7,128,128,70,60,22,6,0,169,96,156,421
20220114,14JAN2022:00:00:00,UFU GRIERSON,122,193,166,116,33,315,315,0,315,0,0,2,67,92,71,45,33,5,0,132,79,104,315
20220114,14JAN2022:00:00:00,UFU GUTIERREZ,182,118,183,74,43,300,300,0,300,0,88,68,18,54,48,17,6,1,0,80,86,134,300
20220114,14JAN2022:00:00:00,UFU MUÑIZ,334,339,337,233,103,673,673,0,673,0,2,15,176,187,118,99,50,26,0,265,119,289,673
20220114,14JAN2022:00:00:00,UFU PENNA,277,203,254,205,21,480,480,0,480,0,0,16,108,117,87,77,59,16,0,156,161,163,480
20220114,14JAN2022:00:00:00,UFU PIROVANO,415,369,577,116,91,784,784,0,784,0,0,28,158,248,171,97,54,28,0,340,114,330,784
20220114,14JAN2022:00:00:00,UFU PIÑERO,483,395,627,191,60,878,878,0,878,0,0,50,204,250,153,133,69,19,0,296,307,275,878
20220114,14JAN2022:00:00:00,UFU RAMOS MEJIA,573,502,752,199,124,1075,1075,0,1075,0,7,39,281,289,220,117,79,43,0,421,185,464,1075
20220114,14JAN2022:00:00:00,UFU RIVADAVIA,514,413,593,210,124,927,927,0,927,0,2,29,263,219,192,105,78,39,0,371,172,383,927
20220114,14JAN2022:00:00:00,UFU SANTOJANNI,261,276,248,155,134,537,537,0,537,0,2,20,130,125,110,76,53,21,0,225,88,224,537
20220114,14JAN2022:00:00:00,UFU TORNU,429,353,619,98,65,782,782,0,782,0,30,62,159,153,203,93,63,19,0,299,122,356,782
20220114,14JAN2022:00:00:00,UFU VELEZ SARSFIELD,334,316,456,132,62,650,650,0,650,0,0,25,94,177,142,116,67,29,0,258,163,229,650
20220114,14JAN2022:00:00:00,UFU ZUBIZARRETA,357,354,426,232,53,711,711,0,711,0,0,30,183,175,138,103,60,22,0,269,159,283,711
20220115,15JAN2022:00:00:00,UFU ALVAREZ,467,470,724,153,62,939,939,0,939,0,39,56,215,223,179,103,77,47,0,374,144,421,939
20220115,15JAN2022:00:00:00,UFU BORDA-MOYANO,257,267,238,245,41,524,524,0,524,0,2,21,139,126,109,65,54,8,0,175,157,192,524
20220115,15JAN2022:00:00:00,UFU DURAND,469,381,693,78,79,850,850,0,850,0,0,24,175,251,162,103,102,33,0,349,151,350,850
20220115,15JAN2022:00:00:00,UFU ELIZALDE,206,132,137,176,25,338,338,0,338,0,175,85,7,33,30,8,0,0,0,111,70,157,338
20220115,15JAN2022:00:00:00,UFU FERNANDEZ,321,285,410,126,70,606,606,0,606,0,0,11,144,162,99,79,65,46,0,221,130,255,606
20220115,15JAN2022:00:00:00,UFU FERRER,306,311,320,272,25,617,617,0,617,0,0,9,199,135,132,70,58,14,0,249,155,213,617
20220115,15JAN2022:00:00:00,UFU GRIERSON,144,165,193,87,29,309,309,0,309,0,0,9,73,87,64,38,29,9,0,130,72,106,309
20220115,15JAN2022:00:00:00,UFU GUTIERREZ,210,210,276,119,25,420,420,0,420,0,160,119,22,50,49,12,8,0,0,168,78,169,420
20220115,15JAN2022:00:00:00,UFU MUÑIZ,269,335,266,278,60,604,604,0,604,0,0,22,158,136,131,88,47,22,0,212,165,227,604
20220115,15JAN2022:00:00:00,UFU PENNA,310,225,293,220,22,535,535,0,535,0,1,24,137,159,102,64,36,12,0,176,171,187,535
20210814,14AUG2021:00:00:00,UFU VELEZ SARSFIELD,152,151,216,67,20,303,297,6,299,4,0,8,38,81,75,58,24,19,0,13,200,84,297
20210814,14AUG2021:00:00:00,UFU ZUBIZARRETA,106,83,129,55,5,189,189,0,189,0,0,25,31,36,39,30,16,12,0,4,136,49,189
20210815,15AUG2021:00:00:00,UFU ALVAREZ,142,82,199,20,5,224,214,10,214,10,24,25,21,39,34,29,33,19,0,14,138,62,214
20210815,15AUG2021:00:00:00,UFU ARGERICH,26,19,24,21,0,45,43,2,45,0,0,3,6,2,17,9,6,2,0,0,22,21,43
20210815,15AUG2021:00:00:00,UFU BORDA-MOYANO,40,45,57,19,9,85,83,2,83,2,0,4,5,5,20,28,17,6,0,7,45,31,83
20210815,15AUG2021:00:00:00,UFU DURAND,130,85,186,22,7,215,215,0,215,0,9,17,28,61,47,29,16,8,0,10,144,61,215
20210815,15AUG2021:00:00:00,UFU ELIZALDE,91,71,41,117,4,162,114,48,156,6,104,30,8,8,8,0,4,0,0,1,71,42,114
20210815,15AUG2021:00:00:00,UFU FERNANDEZ,52,50,79,9,14,102,88,14,94,8,0,3,20,31,11,23,12,2,0,3,49,34,88
20210815,15AUG2021:00:00:00,UFU FERRER,50,42,45,41,6,92,92,0,92,0,0,0,17,14,27,25,6,3,0,3,65,24,92
20210815,15AUG2021:00:00:00,UFU GRIERSON,92,77,94,72,3,169,163,6,169,0,2,18,34,20,51,25,13,6,0,6,112,44,163
20210815,15AUG2021:00:00:00,UFU GUTIERREZ,120,108,134,90,4,228,214,14,220,8,139,44,9,22,12,2,0,0,0,3,139,72,214
20210815,15AUG2021:00:00:00,UFU MUÑIZ,105,81,72,105,9,186,172,14,176,10,0,7,60,45,45,18,9,2,0,7,121,44,172
20210815,15AUG2021:00:00:00,UFU PENNA,66,40,57,41,8,106,102,4,104,2,0,3,20,39,15,14,11,4,0,5,67,30,102
20210815,15AUG2021:00:00:00,UFU PIROVANO,139,117,211,28,17,256,226,30,252,4,20,7,41,76,37,42,17,16,0,9,128,89,226
20210815,15AUG2021:00:00:00,UFU PIÑERO,57,27,61,12,11,84,82,2,82,2,0,3,19,21,14,14,13,0,0,5,57,20,82
20210815,15AUG2021:00:00:00,UFU RAMOS MEJIA,101,126,178,31,18,227,223,4,223,4,8,15,40,57,36,37,12,22,0,7,152,64,223
20210815,15AUG2021:00:00:00,UFU RIVADAVIA,123,97,175,18,27,220,208,12,208,12,0,4,44,57,32,38,34,11,0,15,102,90,208
20210815,15AUG2021:00:00:00,UFU SANTOJANNI,155,132,137,126,24,287,283,4,285,2,4,29,36,56,68,44,23,27,0,8,206,69,283
20210815,15AUG2021:00:00:00,UFU TORNU,100,54,145,8,1,154,132,22,132,22,3,19,17,30,44,24,9,8,0,5,97,30,132
20210815,15AUG2021:00:00:00,UFU VELEZ SARSFIELD,116,126,156,72,14,242,236,6,240,2,0,32,42,31,57,52,24,4,0,13,150,73,236
20210815,15AUG2021:00:00:00,UFU ZUBIZARRETA,95,56,116,32,3,151,147,4,151,0,0,22,24,22,33,29,10,11,0,7,98,42,147
20210816,16AUG2021:00:00:00,UFU ALVAREZ,196,124,289,18,13,320,310,10,312,8,43,36,50,69,49,39,26,8,0,6,223,81,310
20210816,16AUG2021:00:00:00,UFU ARGERICH,28,21,23,24,2,49,49,0,49,0,3,2,9,7,8,14,2,4,0,7,22,20,49
20210816,16AUG2021:00:00:00,UFU BORDA-MOYANO,32,18,30,19,1,50,50,0,50,0,0,6,5,6,22,7,4,0,0,2,28,20,50
20210816,16AUG2021:00:00:00,UFU DURAND,114,86,171,19,10,200,191,9,191,9,6,17,44,49,42,22,7,13,0,9,108,74,191
20210816,16AUG2021:00:00:00,UFU ELIZALDE,104,109,73,132,8,213,155,58,193,20,146,43,11,5,4,3,1,0,0,3,91,61,155
20210816,16AUG2021:00:00:00,UFU FERNANDEZ,64,93,134,18,5,157,145,12,147,10,0,9,41,24,25,22,24,12,0,12,75,57,145
20210816,16AUG2021:00:00:00,UFU FERRER,100,67,89,74,4,167,163,4,163,4,0,3,37,46,23,34,16,8,0,5,115,43,163
20210816,16AUG2021:00:00:00,UFU GRIERSON,128,95,106,113,4,223,221,2,221,2,0,26,41,40,50,33,25,8,0,3,162,56,221
20210816,16AUG2021:00:00:00,UFU GUTIERREZ,167,131,208,88,2,298,288,10,290,8,174,67,8,19,24,3,3,0,0,4,203,79,288
20210816,16AUG2021:00:00:00,UFU MUÑIZ,108,104,100,98,14,212,190,22,196,16,2,18,31,66,46,19,19,11,0,10,124,56,190
20210816,16AUG2021:00:00:00,UFU PENNA,48,38,50,28,8,86,78,8,78,8,0,3,17,27,9,12,13,5,0,2,50,26,78
20210816,16AUG2021:00:00:00,UFU PIROVANO,163,108,214,33,24,271,247,24,263,8,0,11,52,56,82,47,16,7,0,16,131,100,247
20210816,16AUG2021:00:00:00,UFU PIÑERO,75,82,116,39,2,157,153,4,155,2,15,5,36,30,29,23,13,6,0,6,102,44,153
20210816,16AUG2021:00:00:00,UFU RAMOS MEJIA,137,96,158,51,24,233,221,12,225,8,16,12,45,54,44,42,12,8,0,12,148,61,221
20210816,16AUG2021:00:00:00,UFU RIVADAVIA,149,101,190,36,24,250,216,34,216,34,0,9,80,80,28,32,13,8,0,11,114,91,216
20210816,16AUG2021:00:00:00,UFU SANTOJANNI,275,213,291,178,19,488,474,14,482,6,7,53,75,87,89,89,56,32,0,12,340,122,474
20210816,16AUG2021:00:00:00,UFU TORNU,164,145,248,38,23,309,295,14,295,14,17,25,45,70,70,49,20,13,0,7,207,80,295
20210816,16AUG2021:00:00:00,UFU VELEZ SARSFIELD,218,156,272,86,16,374,366,8,370,4,0,16,45,95,97,74,36,11,0,18,243,105,366
20210816,16AUG2021:00:00:00,UFU ZUBIZARRETA,130,91,177,42,2,221,221,0,221,0,0,25,36,50,40,27,23,20,0,9,156,56,221
20210817,17AUG2021:00:00:00,UFU ALVAREZ,294,234,424,78,26,528,496,32,500,28,50,66,90,114,93,66,30,19,0,6,367,123,496
20210817,17AUG2021:00:00:00,UFU ARGERICH,97,61,81,65,12,158,122,36,126,32,19,17,34,15,26,33,10,4,0,5,67,49,122
20210817,17AUG2021:00:00:00,UFU BORDA-MOYANO,29,31,37,20,3,60,58,2,58,2,4,2,11,13,23,7,0,0,0,0,42,16,58
20210817,17AUG2021:00:00:00,UFU DURAND,142,93,192,28,15,235,221,14,229,6,0,13,53,62,55,31,13,8,0,18,114,89,221
20210817,17AUG2021:00:00:00,UFU ELIZALDE,159,130,103,185,1,289,233,56,257,32,203,54,11,9,4,4,4,0,0,2,136,95,233
20210817,17AUG2021:00:00:00,UFU FERNANDEZ,111,78,154,27,8,189,171,18,175,14,0,4,50,49,47,13,20,6,0,7,101,63,171
20210817,17AUG2021:00:00:00,UFU FERRER,132,99,109,109,13,231,222,9,228,3,0,5,51,87,65,19,4,0,0,7,160,55,222
20210817,17AUG2021:00:00:00,UFU GRIERSON,87,93,104,63,13,180,178,2,180,0,0,8,38,35,49,39,11,0,0,6,123,49,178
20210817,17AUG2021:00:00:00,UFU GUTIERREZ,225,164,238,141,10,389,361,28,379,10,251,71,12,26,13,13,3,0,0,5,260,96,361
20210817,17AUG2021:00:00:00,UFU MUÑIZ,154,201,145,194,16,355,309,46,321,34,0,22,82,80,63,53,51,4,0,9,218,82,309
20210817,17AUG2021:00:00:00,UFU PENNA,70,57,84,35,8,127,123,4,125,2,0,4,29,29,22,23,11,9,0,4,84,35,123
20210817,17AUG2021:00:00:00,UFU PIROVANO,174,145,255,32,32,319,301,18,315,4,0,20,79,105,64,18,16,17,0,22,165,114,301
20210817,17AUG2021:00:00:00,UFU PIÑERO,105,96,154,35,12,201,199,2,199,2,0,21,49,42,53,20,14,2,0,4,145,50,199
20210817,17AUG2021:00:00:00,UFU RAMOS MEJIA,244,176,314,76,30,420,374,46,406,14,31,30,73,97,81,63,30,15,0,13,251,110,374
20210817,17AUG2021:00:00:00,UFU RIVADAVIA,143,143,205,46,35,286,278,8,278,8,0,9,90,96,38,20,24,9,0,17,153,108,278
20210817,17AUG2021:00:00:00,UFU SANTOJANNI,232,176,208,189,11,408,388,20,404,4,16,32,63,99,83,56,31,28,0,12,280,96,388
20210817,17AUG2021:00:00:00,UFU TORNU,276,242,416,66,36,518,432,86,436,82,57,49,64,131,133,53,19,12,0,9,298,123,432
20210817,17AUG2021:00:00:00,UFU VELEZ SARSFIELD,191,152,260,73,10,343,327,16,331,12,0,43,92,77,61,36,16,18,0,13,213,101,327
20210817,17AUG2021:00:00:00,UFU ZUBIZARRETA,204,135,213,103,23,339,327,12,339,0,0,36,99,76,36,56,22,14,0,13,225,89,327
20210818,18AUG2021:00:00:00,UFU ALVAREZ,270,263,437,61,35,533,495,38,497,36,92,60,103,78,98,52,30,20,0,5,354,136,495
20210818,18AUG2021:00:00:00,UFU ARGERICH,101,53,96,54,4,154,110,44,110,44,28,6,29,28,27,14,14,8,0,3,63,43,110
20210818,18AUG2021:00:00:00,UFU BORDA-MOYANO,30,55,55,26,4,85,79,6,79,6,0,7,21,19,10,16,12,0,0,0,48,31,79
20210818,18AUG2021:00:00:00,UFU DURAND,143,71,200,5,9,214,198,16,200,14,2,1,47,76,38,25,20,5,0,6,113,79,198
20210818,18AUG2021:00:00:00,UFU ELIZALDE,179,180,124,227,8,359,285,74,323,36,214,85,11,26,15,7,0,1,0,1,167,117,285
20210818,18AUG2021:00:00:00,UFU FERNANDEZ,147,121,211,44,13,268,243,25,255,13,0,13,91,47,52,27,18,20,0,8,141,93,243
20211008,08OCT2021:00:00:00,UFU MUÑIZ,68,68,53,75,8,136,114,22,114,22,0,9,24,27,28,36,3,9,0,1,78,35,114
20211008,08OCT2021:00:00:00,UFU PENNA,28,29,30,27,0,57,55,2,55,2,10,4,7,19,6,2,5,4,0,2,29,23,55
20211008,08OCT2021:00:00:00,UFU PIROVANO,116,89,171,22,12,205,195,10,199,6,0,12,29,78,47,18,9,12,0,4,113,78,195
20211008,08OCT2021:00:00:00,UFU PIÑERO,55,30,53,28,4,85,81,4,81,4,0,6,29,7,20,18,3,2,0,0,58,22,81
20211008,08OCT2021:00:00:00,UFU RAMOS MEJIA,103,57,127,21,12,160,150,10,150,10,6,6,37,38,24,10,22,17,0,1,78,71,150
20211008,08OCT2021:00:00:00,UFU RIVADAVIA,71,57,90,19,19,128,126,2,126,2,1,7,25,39,18,19,8,11,0,4,74,48,126
20211008,08OCT2021:00:00:00,UFU SANTOJANNI,126,93,112,73,34,219,203,16,211,8,0,81,22,39,29,21,14,13,0,1,119,83,203
20211008,08OCT2021:00:00:00,UFU TORNU,60,73,108,20,5,133,111,22,113,20,10,18,19,41,27,13,3,2,0,6,76,29,111
20211008,08OCT2021:00:00:00,UFU VELEZ SARSFIELD,152,85,191,39,7,237,231,6,235,2,0,18,47,62,62,20,21,7,0,3,164,64,231
20211008,08OCT2021:00:00:00,UFU ZUBIZARRETA,85,79,121,40,3,164,164,0,164,0,0,8,22,29,39,33,24,9,0,2,123,39,164
20211009,09OCT2021:00:00:00,UFU ALVAREZ,69,53,99,16,7,122,108,14,108,14,8,15,18,17,22,13,19,10,0,2,64,42,108
20211009,09OCT2021:00:00:00,UFU ARGERICH,5,0,5,0,0,5,5,0,5,0,0,0,0,2,0,0,0,3,0,0,2,3,5
20211009,09OCT2021:00:00:00,UFU BORDA-MOYANO,18,15,18,13,2,33,33,0,33,0,0,3,7,7,8,3,5,0,0,0,23,10,33
20211009,09OCT2021:00:00:00,UFU DURAND,91,50,130,5,6,141,129,12,129,12,0,12,35,30,23,17,14,10,0,3,77,49,129
20211009,09OCT2021:00:00:00,UFU ELIZALDE,65,50,44,71,0,115,111,4,113,2,71,34,2,2,4,0,2,0,0,0,68,43,111
20211009,09OCT2021:00:00:00,UFU FERNANDEZ,55,28,61,13,9,83,81,2,83,0,0,4,23,20,13,9,8,6,0,2,49,30,81
20211009,09OCT2021:00:00:00,UFU FERRER,34,19,24,29,0,53,51,2,51,2,0,0,7,18,6,9,6,7,0,0,39,12,51
20211009,09OCT2021:00:00:00,UFU GRIERSON,71,40,80,21,10,111,109,2,109,2,0,6,29,22,39,6,3,6,0,0,79,30,109
20211009,09OCT2021:00:00:00,UFU GUTIERREZ,59,72,77,54,0,131,125,6,125,6,104,14,0,8,2,3,0,0,0,1,83,40,125
20211009,09OCT2021:00:00:00,UFU MUÑIZ,30,49,30,35,14,79,49,30,55,24,0,9,5,12,23,14,6,10,0,0,30,19,49
20211009,09OCT2021:00:00:00,UFU PENNA,39,13,32,20,0,52,50,2,50,2,18,7,6,5,7,2,2,5,0,0,35,15,50
20211009,09OCT2021:00:00:00,UFU PIROVANO,100,69,139,20,10,169,165,4,167,2,0,10,33,46,30,17,25,8,0,7,98,60,165
20211009,09OCT2021:00:00:00,UFU PIÑERO,30,26,35,19,2,56,54,2,54,2,0,2,14,17,13,8,0,2,0,0,38,16,54
20211009,09OCT2021:00:00:00,UFU RAMOS MEJIA,61,52,91,14,8,113,109,4,109,4,5,5,20,17,29,11,10,16,0,0,58,51,109
20211009,09OCT2021:00:00:00,UFU RIVADAVIA,55,39,73,13,8,94,94,0,94,0,0,8,20,17,29,10,4,6,0,1,53,40,94
20211009,09OCT2021:00:00:00,UFU SANTOJANNI,89,63,84,58,10,152,150,2,152,0,0,17,29,26,33,18,20,9,0,5,84,61,150
20211009,09OCT2021:00:00:00,UFU TORNU,54,43,74,16,7,97,89,8,89,8,8,3,8,26,17,7,16,12,0,3,59,27,89
20211009,09OCT2021:00:00:00,UFU VELEZ SARSFIELD,105,99,160,32,12,204,194,10,196,8,0,1,34,43,49,46,18,13,0,4,132,58,194
20211009,09OCT2021:00:00:00,UFU ZUBIZARRETA,56,50,80,26,0,106,104,2,106,0,0,9,17,16,23,12,18,11,0,5,73,26,104
20211010,10OCT2021:00:00:00,UFU ALVAREZ,111,69,144,27,9,180,172,8,172,8,14,24,24,42,23,26,17,10,0,0,124,48,172
20211010,10OCT2021:00:00:00,UFU ARGERICH,21,30,28,19,4,51,47,4,51,0,10,4,12,16,5,2,1,1,0,1,26,20,47
20211010,10OCT2021:00:00:00,UFU BORDA-MOYANO,16,7,17,3,3,23,21,2,21,2,0,3,4,3,6,5,2,0,0,0,12,9,21
20211010,10OCT2021:00:00:00,UFU DURAND,71,31,91,6,5,102,98,4,100,2,6,7,14,26,10,16,17,6,0,10,48,40,98
20211010,10OCT2021:00:00:00,UFU ELIZALDE,60,107,46,121,0,167,127,40,157,10,127,36,2,0,2,0,0,0,0,0,85,42,127
20211010,10OCT2021:00:00:00,UFU FERNANDEZ,33,25,49,7,2,58,56,2,56,2,0,3,5,14,6,19,9,2,0,1,35,20,56
20211010,10OCT2021:00:00:00,UFU FERRER,52,34,52,28,6,86,84,2,84,2,0,0,12,28,16,14,7,9,0,2,61,21,84
20211010,10OCT2021:00:00:00,UFU GRIERSON,72,52,67,37,20,124,118,6,118,6,0,7,25,38,26,18,10,0,0,3,85,29,118
20211010,10OCT2021:00:00:00,UFU GUTIERREZ,120,98,122,94,2,218,208,10,216,2,144,59,0,8,7,0,0,0,0,2,137,69,208
20211010,10OCT2021:00:00:00,UFU MUÑIZ,78,79,62,80,15,157,133,24,135,22,0,35,11,44,28,26,4,9,0,4,91,38,133
20211010,10OCT2021:00:00:00,UFU PENNA,28,10,19,19,0,38,34,4,36,2,4,0,7,15,4,5,3,0,0,0,24,10,34
20211010,10OCT2021:00:00:00,UFU PIROVANO,106,105,172,26,13,211,185,26,199,12,35,16,19,45,42,28,24,2,0,7,113,65,185
20211010,10OCT2021:00:00:00,UFU PIÑERO,43,30,59,11,3,73,71,2,71,2,0,12,14,12,3,23,2,7,0,0,52,17,71
20211010,10OCT2021:00:00:00,UFU RAMOS MEJIA,49,39,61,20,7,88,82,6,82,6,2,2,20,17,20,19,3,5,0,1,50,31,82
20211010,10OCT2021:00:00:00,UFU RIVADAVIA,55,18,55,14,4,73,71,2,71,2,0,1,19,17,8,8,13,7,0,1,45,25,71
20211010,10OCT2021:00:00:00,UFU SANTOJANNI,93,55,85,44,19,148,144,4,148,0,0,18,21,27,27,24,21,10,0,5,80,59,144
20211010,10OCT2021:00:00:00,UFU TORNU,90,67,134,21,2,157,139,18,139,18,14,17,14,32,53,10,9,8,0,12,85,42,139
20211010,10OCT2021:00:00:00,UFU VELEZ SARSFIELD,106,50,98,52,6,156,152,4,154,2,0,11,35,25,38,30,14,3,0,6,102,44,152
20211010,10OCT2021:00:00:00,UFU ZUBIZARRETA,55,108,112,49,2,163,163,0,163,0,0,12,26,39,38,21,27,0,0,2,121,40,163
20211011,11OCT2021:00:00:00,UFU ALVAREZ,113,105,186,23,9,218,214,4,214,4,20,13,24,45,53,32,10,21,0,4,150,60,214
20211011,11OCT2021:00:00:00,UFU ARGERICH,34,31,40,23,2,65,65,0,65,0,0,2,20,17,14,7,4,1,0,3,31,31,65
20211011,11OCT2021:00:00:00,UFU BORDA-MOYANO,13,29,35,6,1,42,40,2,40,2,0,1,12,7,18,2,1,1,0,0,29,11,40
20211011,11OCT2021:00:00:00,UFU DURAND,83,62,126,11,8,145,141,4,141,4,9,10,17,35,35,15,18,6,0,2,83,56,141
20211011,11OCT2021:00:00:00,UFU ELIZALDE,100,103,55,144,4,203,159,44,183,20,148,43,2,8,2,0,0,0,0,0,100,59,159
20211011,11OCT2021:00:00:00,UFU FERNANDEZ,47,46,72,19,2,93,91,2,91,2,0,3,25,27,14,11,6,7,0,4,49,38,91
20211011,11OCT2021:00:00:00,UFU FERRER,86,46,88,32,12,132,124,8,124,8,0,4,21,25,52,9,13,8,0,2,90,32,124
20211011,11OCT2021:00:00:00,UFU GRIERSON,62,43,61,30,14,105,103,2,103,2,0,17,27,18,22,10,6,5,0,0,79,24,103
20211011,11OCT2021:00:00:00,UFU GUTIERREZ,143,146,180,104,5,289,281,8,285,4,215,58,6,7,2,1,0,0,0,4,193,84,281
20211011,11OCT2021:00:00:00,UFU MUÑIZ,78,90,84,63,21,168,146,22,146,22,2,23,39,34,32,25,8,5,0,4,101,41,146
20211011,11OCT2021:00:00:00,UFU PENNA,32,24,35,16,5,56,56,0,56,0,5,4,4,14,4,17,6,2,0,2,36,18,56
20211011,11OCT2021:00:00:00,UFU PIROVANO,150,101,200,31,20,251,237,14,245,6,0,13,50,61,57,34,29,7,0,12,126,99,237
20211011,11OCT2021:00:00:00,UFU PIÑERO,54,40,74,14,6,94,90,4,90,4,0,15,29,12,19,14,2,3,0,2,62,24,90
20211011,11OCT2021:00:00:00,UFU RAMOS MEJIA,117,83,149,30,21,200,184,16,186,14,7,18,57,35,25,21,22,15,0,8,97,78,184
20211011,11OCT2021:00:00:00,UFU RIVADAVIA,71,72,112,17,14,143,141,2,143,0,0,10,26,39,27,16,22,3,0,2,82,57,141
20211011,11OCT2021:00:00:00,UFU SANTOJANNI,141,113,118,113,23,254,226,28,246,8,23,47,41,59,37,23,13,11,0,3,134,89,226
20211011,11OCT2021:00:00:00,UFU TORNU,87,96,121,49,13,183,157,26,157,26,12,24,19,40,36,29,17,6,0,3,109,45,157
20211011,11OCT2021:00:00:00,UFU VELEZ SARSFIELD,116,86,152,36,14,202,200,2,200,2,0,14,47,38,54,19,25,5,0,1,117,82,200
20211011,11OCT2021:00:00:00,UFU ZUBIZARRETA,133,106,178,58,3,239,231,8,239,0,0,26,44,27,33,41,27,41,0,2,175,54,231
20220122,22JAN2022:00:00:00,UFU BORDA-MOYANO,217,192,194,198,28,420,420,0,420,0,11,15,97,76,104,75,34,8,0,101,180,139,420
20220122,22JAN2022:00:00:00,UFU DURAND,378,322,569,61,70,700,700,0,700,0,0,10,110,206,160,96,71,47,0,246,140,314,700
20220122,22JAN2022:00:00:00,UFU ELIZALDE,173,116,101,168,24,293,293,0,293,0,134,79,15,31,28,3,3,0,0,86,72,135,293
20220122,22JAN2022:00:00:00,UFU FERNANDEZ,271,243,364,98,55,517,517,0,517,0,5,23,95,131,102,59,57,45,0,165,116,236,517
20220122,22JAN2022:00:00:00,UFU FERRER,319,269,305,241,54,600,600,0,600,0,12,8,109,138,173,96,53,11,0,195,161,244,600
20220122,22JAN2022:00:00:00,UFU GRIERSON,193,179,197,153,25,375,375,0,375,0,3,10,93,78,84,53,33,21,0,107,137,128,375
20220122,22JAN2022:00:00:00,UFU GUTIERREZ,177,171,229,88,32,349,349,0,349,0,139,97,9,29,53,19,3,0,0,93,82,173,349
20220122,22JAN2022:00:00:00,UFU MUÑIZ,207,245,222,206,26,454,454,0,454,0,2,21,81,116,106,69,42,17,0,157,96,201,454
20220122,22JAN2022:00:00:00,UFU PENNA,296,216,267,210,38,515,515,0,515,0,31,46,99,135,72,85,28,19,0,109,227,179,515
20220122,22JAN2022:00:00:00,UFU PIROVANO,418,295,480,158,84,722,722,0,722,0,9,18,145,195,136,113,67,39,0,275,117,330,722
20220122,22JAN2022:00:00:00,UFU PIÑERO,213,155,263,69,39,371,371,0,371,0,3,17,79,94,77,63,21,17,0,114,134,121,371
20220122,22JAN2022:00:00:00,UFU RAMOS MEJIA,388,285,484,111,82,677,677,0,677,0,17,23,134,156,147,107,63,30,0,283,100,293,677
20220122,22JAN2022:00:00:00,UFU RIVADAVIA,475,348,611,130,87,828,828,0,828,0,5,9,190,234,168,95,76,51,0,284,174,370,828
20220122,22JAN2022:00:00:00,UFU SANTOJANNI,365,295,339,259,67,665,665,0,665,0,5,25,126,151,171,84,80,23,0,252,99,313,665
20220122,22JAN2022:00:00:00,UFU TORNU,235,195,374,28,28,430,430,0,430,0,5,23,70,87,119,50,48,28,0,153,68,204,430
20220122,22JAN2022:00:00:00,UFU VELEZ SARSFIELD,291,258,367,152,36,555,555,0,555,0,6,15,117,137,97,84,66,33,0,176,156,223,555
20220122,22JAN2022:00:00:00,UFU ZUBIZARRETA,330,253,351,208,25,584,584,0,584,0,1,23,96,159,115,105,51,34,0,207,113,264,584
20220123,23JAN2022:00:00:00,UFU ALVAREZ,379,298,564,76,37,677,677,0,677,0,26,43,122,120,144,99,55,68,0,180,237,260,677
20220123,23JAN2022:00:00:00,UFU ARGERICH,87,58,83,54,8,145,145,0,145,0,3,3,35,36,23,24,17,4,0,54,28,62,145
20220123,23JAN2022:00:00:00,UFU BORDA-MOYANO,225,173,178,197,23,398,398,0,398,0,0,34,64,113,85,74,25,3,0,95,180,123,398
20220123,23JAN2022:00:00:00,UFU DURAND,464,361,706,56,64,826,826,0,826,0,1,27,163,213,171,114,76,61,0,326,149,350,826
20220123,23JAN2022:00:00:00,UFU ELIZALDE,143,121,105,144,16,265,265,0,265,0,110,63,15,37,28,12,0,0,0,70,86,109,265
20220123,23JAN2022:00:00:00,UFU FERNANDEZ,284,235,376,91,53,520,520,0,520,0,1,14,98,138,115,64,52,38,0,165,147,208,520
20220123,23JAN2022:00:00:00,UFU FERRER,244,220,242,197,25,464,464,0,464,0,0,4,98,103,109,92,35,23,0,165,147,152,464
20220123,23JAN2022:00:00:00,UFU GRIERSON,163,132,179,78,40,297,297,0,297,0,2,10,57,66,70,56,30,6,0,112,93,92,297
20220123,23JAN2022:00:00:00,UFU GUTIERREZ,227,152,238,84,59,381,381,0,381,0,166,131,6,35,34,9,0,0,0,66,174,141,381
20220123,23JAN2022:00:00:00,UFU MUÑIZ,184,149,157,134,43,334,334,0,334,0,1,14,55,107,73,49,20,15,0,132,67,135,334
20220123,23JAN2022:00:00:00,UFU PENNA,200,150,183,134,33,350,350,0,350,0,3,23,70,96,85,38,25,10,0,90,154,106,350
20220123,23JAN2022:00:00:00,UFU PIROVANO,379,343,480,137,107,724,724,0,724,0,11,25,154,190,178,91,53,22,0,283,136,305,724
20220123,23JAN2022:00:00:00,UFU PIÑERO,236,180,307,75,36,418,418,0,418,0,4,20,88,103,102,60,26,15,0,124,162,124,418
20220123,23JAN2022:00:00:00,UFU RAMOS MEJIA,294,208,360,76,68,504,504,0,504,0,27,37,83,119,95,81,40,22,0,186,106,211,504
20220123,23JAN2022:00:00:00,UFU RIVADAVIA,413,364,531,140,111,782,782,0,782,0,5,16,170,218,161,105,64,43,0,264,195,319,782
20220123,23JAN2022:00:00:00,UFU SANTOJANNI,302,228,249,243,41,533,533,0,533,0,3,25,105,118,111,88,51,32,0,199,96,238,533
20220123,23JAN2022:00:00:00,UFU TORNU,186,166,289,33,30,352,352,0,352,0,3,16,64,89,79,38,47,16,0,123,75,154,352
20220123,23JAN2022:00:00:00,UFU VELEZ SARSFIELD,288,258,377,136,33,546,546,0,546,0,0,14,80,155,113,95,56,33,0,192,141,213,546
20220123,23JAN2022:00:00:00,UFU ZUBIZARRETA,279,220,323,163,15,501,501,0,501,0,2,20,110,123,101,75,44,26,0,210,6,285,501
20220124,24JAN2022:00:00:00,UFU ALVAREZ,443,341,579,137,68,784,784,0,784,0,13,49,191,183,144,99,53,52,0,192,276,316,784
20220124,24JAN2022:00:00:00,UFU ARGERICH,54,68,59,58,5,122,122,0,122,0,5,5,18,38,25,14,6,11,0,43,28,49,122
20220124,24JAN2022:00:00:00,UFU BORDA-MOYANO,249,231,254,189,37,480,480,0,480,0,5,20,97,84,76,113,53,32,0,129,149,202,480
20220124,24JAN2022:00:00:00,UFU DURAND,471,354,652,84,89,825,825,0,825,0,1,32,133,243,190,96,80,50,0,308,174,343,825
20220124,24JAN2022:00:00:00,UFU ELIZALDE,179,132,97,196,21,314,314,0,314,0,164,65,19,24,26,12,3,1,0,73,100,141,314
20220124,24JAN2022:00:00:00,UFU FERNANDEZ,269,212,318,85,78,481,481,0,481,0,0,27,127,110,88,62,39,28,0,134,119,228,481
20220124,24JAN2022:00:00:00,UFU FERRER,185,213,192,145,61,398,398,0,398,0,0,7,94,116,83,59,31,8,0,128,138,132,398
20220124,24JAN2022:00:00:00,UFU GRIERSON,134,171,190,91,24,305,305,0,305,0,0,13,65,66,78,54,16,13,0,84,101,119,305
20220124,24JAN2022:00:00:00,UFU GUTIERREZ,202,127,170,71,88,329,329,0,329,0,148,60,20,26,40,20,10,5,0,66,145,118,329
20220124,24JAN2022:00:00:00,UFU MUÑIZ,260,274,218,250,66,534,534,0,534,0,0,22,116,131,109,92,43,21,0,186,131,217,534
20220124,24JAN2022:00:00:00,UFU PENNA,254,210,235,208,21,464,464,0,464,0,19,17,102,114,85,69,39,19,0,121,205,138,464
20220124,24JAN2022:00:00:00,UFU PIROVANO,388,345,496,126,113,735,735,0,735,0,2,17,174,226,148,92,46,30,0,297,139,298,735
20220124,24JAN2022:00:00:00,UFU PIÑERO,340,245,377,158,56,591,591,0,591,0,6,44,124,148,122,88,40,19,0,145,265,179,591
20220124,24JAN2022:00:00:00,UFU RAMOS MEJIA,512,409,634,203,86,923,923,0,923,0,4,30,208,216,185,135,82,63,0,315,202,406,923
20220124,24JAN2022:00:00:00,UFU RIVADAVIA,505,383,619,162,111,892,892,0,892,0,4,10,225,289,127,117,79,41,0,276,246,364,892
20220124,24JAN2022:00:00:00,UFU SANTOJANNI,389,334,362,267,94,723,723,0,723,0,0,51,190,153,127,111,71,20,0,259,154,310,723
20220124,24JAN2022:00:00:00,UFU TORNU,234,230,365,58,41,464,464,0,464,0,11,17,97,107,81,73,40,38,0,145,122,197,464
20220124,24JAN2022:00:00:00,UFU VELEZ SARSFIELD,403,388,581,143,67,791,791,0,791,0,0,41,154,165,166,136,86,43,0,219,307,265,791
20220124,24JAN2022:00:00:00,UFU ZUBIZARRETA,357,322,428,223,30,681,681,0,681,0,4,49,152,150,136,81,67,42,0,241,142,298,681
20220125,25JAN2022:00:00:00,UFU ALVAREZ,407,288,496,123,78,697,697,0,697,0,29,43,144,164,131,104,50,32,0,168,257,271,697
20220125,25JAN2022:00:00:00,UFU ARGERICH,87,41,74,53,1,128,128,0,128,0,2,2,29,27,31,23,6,8,0,50,18,60,128
20220125,25JAN2022:00:00:00,UFU BORDA-MOYANO,153,183,162,150,27,339,339,0,339,0,4,13,57,89,87,55,26,8,0,88,107,144,339
20220125,25JAN2022:00:00:00,UFU DURAND,415,341,600,94,63,757,757,0,757,0,1,35,195,186,149,91,54,46,0,281,150,326,757
20220125,25JAN2022:00:00:00,UFU ELIZALDE,151,92,60,173,11,244,244,0,244,0,130,53,9,24,21,7,0,0,0,53,74,117,244
20220125,25JAN2022:00:00:00,UFU FERNANDEZ,294,185,336,54,89,479,479,0,479,0,2,9,134,127,94,50,31,32,0,134,131,214,479
20220125,25JAN2022:00:00:00,UFU FERRER,189,207,171,181,44,396,396,0,396,0,0,13,105,100,82,59,28,9,0,113,144,139,396
20210624,24JUN2021:00:00:00,UFU TORNU,171,136,228,53,26,307,283,24,283,24,19,11,72,66,51,42,40,6,0,35,159,81,283
20210624,24JUN2021:00:00:00,UFU VELEZ SARSFIELD,148,133,193,73,15,281,251,30,277,4,0,8,47,84,68,40,22,12,0,36,149,66,251
20210624,24JUN2021:00:00:00,UFU ZUBIZARRETA,60,87,86,44,17,147,147,0,147,0,0,1,25,41,39,20,15,6,0,20,89,38,147
20210625,25JUN2021:00:00:00,UFU ALVAREZ,165,137,186,46,70,302,264,38,280,22,20,23,74,56,54,50,16,9,0,42,136,86,264
20210625,25JUN2021:00:00:00,UFU ARGERICH,68,63,64,42,25,131,100,31,100,31,9,7,32,23,19,25,8,8,0,16,43,41,100
20210625,25JUN2021:00:00:00,UFU BORDA-MOYANO,38,24,30,16,16,62,44,18,44,18,1,7,8,14,11,10,11,0,0,8,24,12,44
20210625,25JUN2021:00:00:00,UFU DURAND,131,125,190,29,37,256,252,4,252,4,2,13,63,82,44,21,16,15,0,34,152,66,252
20210625,25JUN2021:00:00:00,UFU ELIZALDE,96,81,57,83,37,177,149,28,167,10,95,58,5,4,12,3,0,0,0,8,103,38,149
20210625,25JUN2021:00:00:00,UFU FERNANDEZ,128,56,96,36,52,184,162,22,172,12,0,3,56,36,26,29,16,18,0,10,88,63,162
20210625,25JUN2021:00:00:00,UFU FERRER,138,109,73,78,96,247,241,6,241,6,0,7,59,68,60,40,11,2,0,30,140,71,241
20210625,25JUN2021:00:00:00,UFU GRIERSON,145,137,111,101,70,282,266,16,266,16,0,10,70,64,67,31,36,4,0,46,149,71,266
20210625,25JUN2021:00:00:00,UFU GUTIERREZ,136,141,143,54,80,277,267,10,267,10,95,53,20,52,38,15,4,0,0,26,168,71,267
20210625,25JUN2021:00:00:00,UFU MUÑIZ,249,187,170,165,101,436,332,104,382,54,1,9,120,119,98,62,18,9,0,31,215,86,332
20210625,25JUN2021:00:00:00,UFU PENNA,59,54,80,20,13,113,97,16,109,4,0,0,31,31,20,18,10,3,0,12,58,27,97
20210625,25JUN2021:00:00:00,UFU PIROVANO,167,120,169,47,71,287,247,40,275,12,0,6,71,80,63,35,27,5,0,49,103,95,247
20210625,25JUN2021:00:00:00,UFU PIÑERO,80,81,96,36,29,161,149,12,153,8,2,11,47,34,29,23,9,6,0,22,80,47,149
20210625,25JUN2021:00:00:00,UFU RAMOS MEJIA,182,184,249,53,64,366,344,22,352,14,12,27,70,92,75,57,24,9,0,33,186,125,344
20210625,25JUN2021:00:00:00,UFU RIVADAVIA,133,102,119,40,76,235,215,20,217,18,1,11,79,75,30,21,11,7,0,27,103,85,215
20210625,25JUN2021:00:00:00,UFU SANTOJANNI,237,161,174,124,100,398,378,20,390,8,5,20,92,88,71,51,53,18,0,48,242,88,378
20210625,25JUN2021:00:00:00,UFU TORNU,164,95,165,43,51,259,227,32,229,30,9,12,51,61,70,24,24,8,0,22,139,65,227
20210625,25JUN2021:00:00:00,UFU VELEZ SARSFIELD,160,109,161,37,71,269,257,12,263,6,0,13,77,57,47,33,31,11,0,32,149,76,257
20210625,25JUN2021:00:00:00,UFU ZUBIZARRETA,102,79,102,66,13,181,179,2,181,0,0,21,57,45,23,21,7,7,0,19,110,50,179
20210626,26JUN2021:00:00:00,UFU ALVAREZ,162,114,210,44,22,276,268,8,268,8,11,22,72,47,49,44,23,8,0,23,173,72,268
20210626,26JUN2021:00:00:00,UFU ARGERICH,3,0,0,3,0,3,3,0,3,0,0,0,2,1,0,0,0,0,0,2,0,1,3
20210626,26JUN2021:00:00:00,UFU BORDA-MOYANO,43,22,48,15,2,65,63,2,63,2,0,2,20,22,8,10,1,2,0,2,36,25,63
20210626,26JUN2021:00:00:00,UFU DURAND,115,110,192,16,17,225,211,14,211,14,0,3,68,75,39,21,6,13,0,27,132,52,211
20210626,26JUN2021:00:00:00,UFU ELIZALDE,99,71,48,122,0,170,162,8,168,2,90,51,7,8,9,3,2,0,0,9,113,40,162
20210626,26JUN2021:00:00:00,UFU FERNANDEZ,107,69,148,9,19,176,148,28,166,10,0,5,36,52,36,31,5,11,0,15,20,113,148
20210626,26JUN2021:00:00:00,UFU FERRER,70,66,61,73,2,136,128,8,128,8,0,2,40,30,37,14,5,8,0,19,72,37,128
20210626,26JUN2021:00:00:00,UFU GRIERSON,137,127,117,88,59,264,250,14,252,12,0,12,69,54,58,45,20,6,0,29,160,59,250
20210626,26JUN2021:00:00:00,UFU GUTIERREZ,114,83,147,37,13,197,185,12,191,6,56,34,24,45,25,11,2,0,0,11,116,58,185
20210626,26JUN2021:00:00:00,UFU MUÑIZ,159,102,92,144,25,261,199,62,217,44,0,6,47,99,48,50,3,8,0,19,136,44,199
20210626,26JUN2021:00:00:00,UFU PENNA,46,26,44,26,2,72,64,8,72,0,0,4,19,17,12,11,5,4,0,8,36,20,64
20210626,26JUN2021:00:00:00,UFU PIROVANO,143,124,224,32,11,267,247,20,261,6,0,4,59,80,59,24,23,18,0,35,100,112,247
20210626,26JUN2021:00:00:00,UFU PIÑERO,108,89,122,64,11,197,197,0,197,0,0,16,58,38,34,29,18,4,0,20,121,54,197
20210626,26JUN2021:00:00:00,UFU RAMOS MEJIA,129,106,158,51,26,235,221,14,227,8,2,7,58,60,55,32,11,10,0,21,115,85,221
20210626,26JUN2021:00:00:00,UFU RIVADAVIA,89,69,118,24,16,158,150,8,154,4,0,7,44,43,19,28,13,4,0,24,70,56,150
20210626,26JUN2021:00:00:00,UFU SANTOJANNI,232,177,178,209,22,409,391,18,403,6,0,35,74,118,68,55,42,17,0,40,254,97,391
20210626,26JUN2021:00:00:00,UFU TORNU,115,113,176,36,16,228,218,10,218,10,13,16,41,67,33,27,16,15,0,24,132,60,218
20210626,26JUN2021:00:00:00,UFU VELEZ SARSFIELD,110,162,189,71,12,272,262,10,270,2,0,8,41,75,61,34,29,24,0,36,154,72,262
20210626,26JUN2021:00:00:00,UFU ZUBIZARRETA,188,121,174,135,0,309,301,8,309,0,0,25,44,81,76,32,30,21,0,28,180,93,301
20210627,27JUN2021:00:00:00,UFU ALVAREZ,113,113,165,22,39,226,216,10,218,8,7,30,51,54,39,26,19,0,0,24,138,54,216
20210627,27JUN2021:00:00:00,UFU ARGERICH,23,39,38,24,0,62,60,2,62,0,1,5,14,17,8,13,2,2,0,15,22,23,60
20210627,27JUN2021:00:00:00,UFU BORDA-MOYANO,13,14,13,5,9,27,21,6,21,6,0,2,1,6,4,6,6,2,0,1,11,9,21
20210627,27JUN2021:00:00:00,UFU DURAND,155,126,210,29,42,281,271,10,271,10,8,10,66,70,64,42,16,5,0,38,162,71,271
20210627,27JUN2021:00:00:00,UFU ELIZALDE,90,55,52,78,15,145,115,30,141,4,68,36,14,14,10,1,1,1,0,4,78,33,115
20210627,27JUN2021:00:00:00,UFU FERNANDEZ,75,45,86,12,22,120,82,38,114,6,0,0,24,33,26,19,11,7,0,19,9,54,82
20210627,27JUN2021:00:00:00,UFU FERRER,63,60,54,25,44,123,121,2,121,2,0,0,31,42,32,8,10,0,0,24,68,29,121
20210627,27JUN2021:00:00:00,UFU GRIERSON,109,103,92,56,64,212,204,8,204,8,1,11,46,51,54,35,13,1,0,16,140,48,204
20210627,27JUN2021:00:00:00,UFU GUTIERREZ,125,92,105,37,75,217,209,8,215,2,76,18,33,49,25,14,2,0,0,13,148,48,209
20210627,27JUN2021:00:00:00,UFU MUÑIZ,118,85,68,73,62,203,159,44,161,42,0,22,39,53,46,22,20,1,0,22,99,38,159
20210627,27JUN2021:00:00:00,UFU PENNA,32,14,31,13,2,46,42,4,44,2,0,1,1,18,8,5,9,4,0,7,24,11,42
20210627,27JUN2021:00:00:00,UFU PIROVANO,130,98,148,11,69,228,208,20,226,2,9,8,50,56,44,31,19,11,0,29,101,78,208
20210627,27JUN2021:00:00:00,UFU PIÑERO,84,51,76,34,25,135,133,2,135,0,3,1,32,41,31,16,7,4,0,18,81,33,133
20210627,27JUN2021:00:00:00,UFU RAMOS MEJIA,87,80,112,17,38,167,153,14,159,8,12,12,41,41,25,24,10,2,0,40,58,55,153
20210627,27JUN2021:00:00:00,UFU RIVADAVIA,80,74,100,22,32,154,144,10,146,8,0,2,40,57,25,11,15,4,0,15,60,62,144
20210627,27JUN2021:00:00:00,UFU SANTOJANNI,204,158,166,117,79,362,356,6,360,2,0,16,57,75,81,67,42,24,0,35,243,78,356
20210627,27JUN2021:00:00:00,UFU TORNU,91,71,100,30,32,162,144,18,144,18,5,12,28,46,42,11,10,8,0,17,97,30,144
20210627,27JUN2021:00:00:00,UFU VELEZ SARSFIELD,133,96,107,49,73,229,223,6,227,2,0,17,41,77,60,22,11,1,0,34,128,61,223
20210627,27JUN2021:00:00:00,UFU ZUBIZARRETA,64,37,70,27,4,101,101,0,101,0,0,10,13,31,24,16,5,2,0,10,63,28,101
20210628,28JUN2021:00:00:00,UFU ALVAREZ,152,172,192,47,85,324,302,22,314,10,24,12,84,90,30,45,28,11,0,38,186,78,302
20210628,28JUN2021:00:00:00,UFU ARGERICH,67,56,66,18,39,123,107,16,111,12,12,4,20,29,24,11,11,12,0,18,40,49,107
20210628,28JUN2021:00:00:00,UFU BORDA-MOYANO,34,34,27,10,31,68,60,8,60,8,2,4,10,19,12,15,4,2,0,1,35,24,60
20210628,28JUN2021:00:00:00,UFU DURAND,173,100,174,41,58,273,265,8,267,6,4,17,70,93,47,21,12,9,0,39,157,69,265
20210628,28JUN2021:00:00:00,UFU ELIZALDE,166,104,86,131,53,270,230,40,258,12,122,90,6,24,19,8,0,1,0,9,150,71,230
20210818,18AUG2021:00:00:00,UFU FERRER,132,97,113,111,5,229,215,14,217,12,2,0,61,64,48,38,12,4,0,6,156,53,215
20210818,18AUG2021:00:00:00,UFU GRIERSON,141,82,140,68,15,223,217,6,217,6,0,15,58,46,46,44,8,6,0,6,157,54,217
20210818,18AUG2021:00:00:00,UFU GUTIERREZ,232,169,241,143,17,401,363,38,393,8,238,92,9,25,20,5,5,7,0,5,252,106,363
20210818,18AUG2021:00:00:00,UFU MUÑIZ,137,145,131,141,10,282,214,68,222,60,0,23,62,62,71,46,13,5,0,5,147,62,214
20210818,18AUG2021:00:00:00,UFU PENNA,82,72,83,71,0,154,146,8,150,4,0,4,29,50,30,14,21,6,0,5,101,40,146
20210818,18AUG2021:00:00:00,UFU PIROVANO,227,141,287,49,32,368,342,26,364,4,0,11,94,108,70,35,27,23,0,10,193,139,342
20210818,18AUG2021:00:00:00,UFU PIÑERO,103,98,150,46,5,201,189,12,197,4,6,15,72,38,27,27,11,5,0,5,134,48,189
20210818,18AUG2021:00:00:00,UFU RAMOS MEJIA,219,147,271,43,52,366,322,44,328,38,13,25,102,70,72,45,25,14,0,10,217,95,322
20210818,18AUG2021:00:00:00,UFU RIVADAVIA,159,91,192,25,33,250,184,66,184,66,0,14,93,60,29,23,20,11,0,6,107,71,184
20210818,18AUG2021:00:00:00,UFU SANTOJANNI,272,214,251,215,20,486,458,28,468,18,28,41,64,119,96,73,37,28,0,11,328,119,458
20210818,18AUG2021:00:00:00,UFU TORNU,254,212,405,42,19,466,391,75,395,71,47,41,89,105,89,41,42,12,0,15,265,107,391
20210818,18AUG2021:00:00:00,UFU VELEZ SARSFIELD,203,181,332,48,4,384,364,20,380,4,0,37,62,84,98,55,36,12,0,9,254,101,364
20210818,18AUG2021:00:00:00,UFU ZUBIZARRETA,147,147,203,69,22,294,294,0,294,0,0,27,64,63,62,52,9,17,0,12,202,80,294
20210819,19AUG2021:00:00:00,UFU ALVAREZ,250,200,348,79,23,450,416,34,426,24,83,49,102,92,60,32,26,6,0,4,288,124,416
20210819,19AUG2021:00:00:00,UFU ARGERICH,77,58,86,45,4,135,87,48,87,48,20,19,27,22,28,9,8,2,0,4,44,39,87
20210819,19AUG2021:00:00:00,UFU BORDA-MOYANO,35,15,27,21,2,50,50,0,50,0,0,5,18,3,6,8,6,4,0,0,33,17,50
20210819,19AUG2021:00:00:00,UFU DURAND,131,119,225,19,6,250,236,14,238,12,12,25,67,48,52,24,11,11,0,7,129,100,236
20210819,19AUG2021:00:00:00,UFU ELIZALDE,187,181,109,255,4,368,318,50,350,18,241,78,8,27,7,4,3,0,0,7,186,125,318
20210819,19AUG2021:00:00:00,UFU FERNANDEZ,38,36,67,5,2,74,68,6,68,6,0,0,16,19,22,9,6,2,0,1,40,27,68
20210819,19AUG2021:00:00:00,UFU FERRER,118,66,99,82,3,184,172,12,172,12,0,15,53,30,29,31,17,9,0,1,127,44,172
20210819,19AUG2021:00:00:00,UFU GRIERSON,113,69,105,67,10,182,156,26,156,26,0,17,45,53,25,23,18,1,0,6,117,32,156
20210819,19AUG2021:00:00:00,UFU GUTIERREZ,174,124,214,76,8,298,284,14,292,6,209,60,4,14,6,5,0,0,0,6,194,83,284
20210819,19AUG2021:00:00:00,UFU MUÑIZ,133,135,126,121,21,268,208,60,234,34,0,22,57,68,42,53,20,6,0,3,151,54,208
20210819,19AUG2021:00:00:00,UFU PENNA,79,52,80,42,9,131,129,2,131,0,0,3,29,53,16,19,5,6,0,2,91,36,129
20210819,19AUG2021:00:00:00,UFU PIROVANO,195,156,281,45,25,351,335,16,347,4,0,20,77,102,63,59,14,16,0,25,174,136,335
20210819,19AUG2021:00:00:00,UFU PIÑERO,169,145,242,57,15,314,282,32,300,14,29,30,58,67,39,59,23,9,0,5,204,67,282
20210819,19AUG2021:00:00:00,UFU RAMOS MEJIA,257,149,310,55,41,406,374,32,384,22,37,41,79,66,81,63,20,19,0,18,256,100,374
20210819,19AUG2021:00:00:00,UFU RIVADAVIA,179,122,223,42,36,301,209,92,211,90,0,5,103,84,50,28,24,7,0,15,114,80,209
20210819,19AUG2021:00:00:00,UFU SANTOJANNI,264,206,237,208,25,470,456,14,466,4,39,42,102,94,97,31,47,18,0,16,332,108,456
20210819,19AUG2021:00:00:00,UFU TORNU,267,194,376,64,21,461,383,78,387,74,38,58,63,126,93,40,30,13,0,5,267,108,383
20210819,19AUG2021:00:00:00,UFU VELEZ SARSFIELD,216,164,307,51,22,380,364,16,376,4,0,28,58,112,93,39,33,17,0,6,261,97,364
20210819,19AUG2021:00:00:00,UFU ZUBIZARRETA,106,102,147,47,14,208,200,8,208,0,0,29,37,47,60,19,13,3,0,7,141,52,200
20210820,20AUG2021:00:00:00,UFU ALVAREZ,238,172,321,70,21,412,340,72,344,68,69,56,83,92,54,34,16,8,0,8,241,91,340
20210820,20AUG2021:00:00:00,UFU ARGERICH,84,62,89,57,0,146,112,34,116,30,22,10,20,33,23,14,13,11,0,0,64,46,112
20210820,20AUG2021:00:00:00,UFU BORDA-MOYANO,45,31,52,22,2,76,74,2,74,2,2,15,4,27,13,10,3,2,0,0,52,22,74
20210820,20AUG2021:00:00:00,UFU DURAND,141,107,223,11,14,248,226,22,232,16,6,22,44,56,54,31,18,17,0,8,128,90,226
20210820,20AUG2021:00:00:00,UFU ELIZALDE,123,101,55,164,5,224,132,92,172,52,159,35,13,10,5,0,2,0,0,2,82,48,132
20210820,20AUG2021:00:00:00,UFU FERNANDEZ,131,111,199,28,15,242,224,18,224,18,0,6,57,64,39,29,20,27,0,7,144,73,224
20210820,20AUG2021:00:00:00,UFU FERRER,118,84,122,72,8,202,196,6,196,6,0,11,34,53,43,40,13,8,0,9,140,47,196
20210820,20AUG2021:00:00:00,UFU GRIERSON,124,84,116,51,41,208,200,8,202,6,0,31,61,33,46,21,13,3,0,3,142,55,200
20210820,20AUG2021:00:00:00,UFU GUTIERREZ,135,151,174,110,2,286,280,6,286,0,198,51,5,15,12,2,3,0,0,3,201,73,280
20210820,20AUG2021:00:00:00,UFU MUÑIZ,110,122,114,105,13,232,192,40,194,38,0,10,42,52,44,57,19,8,0,6,134,52,192
20210820,20AUG2021:00:00:00,UFU PENNA,78,57,93,42,0,135,129,6,129,6,0,3,32,44,26,20,6,4,0,3,92,34,129
20210820,20AUG2021:00:00:00,UFU PIROVANO,159,129,222,35,31,288,268,20,276,12,0,22,61,85,45,37,25,13,0,27,135,106,268
20210820,20AUG2021:00:00:00,UFU PIÑERO,107,84,129,36,26,191,179,12,179,12,0,17,56,30,40,37,4,7,0,4,127,44,179
20210820,20AUG2021:00:00:00,UFU RAMOS MEJIA,207,140,225,91,31,347,335,12,341,6,17,30,73,85,60,25,40,17,0,15,213,107,335
20210820,20AUG2021:00:00:00,UFU RIVADAVIA,165,112,215,40,22,277,275,2,275,2,1,11,83,77,43,38,17,7,0,4,166,105,275
20210820,20AUG2021:00:00:00,UFU SANTOJANNI,293,218,291,193,27,511,479,32,505,6,64,51,93,93,81,53,47,29,0,16,341,122,479
20210820,20AUG2021:00:00:00,UFU TORNU,228,137,308,34,23,365,269,96,277,88,24,41,51,102,67,54,19,7,0,8,191,70,269
20210820,20AUG2021:00:00:00,UFU VELEZ SARSFIELD,167,99,191,58,17,266,250,16,266,0,0,21,55,69,69,31,8,13,0,4,136,110,250
20210820,20AUG2021:00:00:00,UFU ZUBIZARRETA,145,105,169,58,23,250,244,6,250,0,0,32,45,66,30,42,20,15,0,9,176,59,244
20210821,21AUG2021:00:00:00,UFU ALVAREZ,273,170,365,64,14,443,423,20,423,20,33,59,62,103,53,63,45,25,0,8,299,116,423
20210821,21AUG2021:00:00:00,UFU ARGERICH,2,1,2,1,0,3,3,0,3,0,1,0,0,0,0,2,0,0,0,0,2,1,3
20210821,21AUG2021:00:00:00,UFU BORDA-MOYANO,65,31,60,33,3,96,90,6,90,6,0,3,19,20,21,25,5,3,0,0,59,31,90
20210821,21AUG2021:00:00:00,UFU DURAND,144,89,202,19,12,233,229,4,229,4,0,13,61,56,53,28,10,12,0,8,127,93,229
20210821,21AUG2021:00:00:00,UFU ELIZALDE,115,107,61,161,0,222,170,52,206,16,172,24,11,10,2,3,0,0,0,0,100,70,170
20210821,21AUG2021:00:00:00,UFU FERNANDEZ,158,107,226,13,26,265,237,28,247,18,0,10,59,58,62,40,21,15,0,8,162,67,237
20210821,21AUG2021:00:00:00,UFU FERRER,109,66,85,77,13,175,167,8,167,8,0,9,44,54,39,24,5,0,0,6,118,43,167
20210821,21AUG2021:00:00:00,UFU GRIERSON,92,90,85,72,25,182,174,8,174,8,0,17,48,54,22,28,8,5,0,4,126,44,174
20210821,21AUG2021:00:00:00,UFU GUTIERREZ,165,135,192,102,6,300,286,14,290,10,205,62,5,8,18,2,0,0,0,6,184,96,286
20210821,21AUG2021:00:00:00,UFU MUÑIZ,127,122,95,132,22,249,215,34,217,32,2,6,48,76,56,39,11,11,0,1,160,54,215
20210821,21AUG2021:00:00:00,UFU PENNA,66,40,60,35,11,106,100,6,102,4,0,4,26,46,13,5,6,6,0,3,65,32,100
20210821,21AUG2021:00:00:00,UFU PIROVANO,154,131,243,28,14,285,276,9,278,7,0,13,58,82,53,42,19,18,0,8,146,122,276
20210821,21AUG2021:00:00:00,UFU PIÑERO,95,74,101,57,11,169,165,4,165,4,0,9,33,45,35,26,14,7,0,5,114,44,165
20211012,12OCT2021:00:00:00,UFU ALVAREZ,223,153,300,50,26,376,320,56,344,32,40,45,63,80,77,27,27,17,0,2,235,83,320
20211012,12OCT2021:00:00:00,UFU ARGERICH,76,58,82,51,1,134,114,20,124,10,31,10,16,28,17,15,9,8,0,0,75,39,114
20211012,12OCT2021:00:00:00,UFU BORDA-MOYANO,33,32,54,11,0,65,63,2,63,2,6,2,6,19,10,14,2,6,0,0,40,23,63
20211012,12OCT2021:00:00:00,UFU DURAND,152,88,214,16,10,240,236,4,236,4,22,16,50,52,49,19,14,18,0,8,139,89,236
20211012,12OCT2021:00:00:00,UFU ELIZALDE,132,110,105,135,2,242,230,12,238,4,170,53,3,8,3,2,3,0,0,2,149,79,230
20211012,12OCT2021:00:00:00,UFU FERNANDEZ,112,68,134,31,15,180,168,12,170,10,0,10,40,50,41,25,13,1,0,1,100,67,168
20211012,12OCT2021:00:00:00,UFU FERRER,94,83,113,60,4,177,171,6,171,6,0,12,25,46,50,21,17,6,0,1,127,43,171
20211012,12OCT2021:00:00:00,UFU GRIERSON,103,76,110,58,11,179,179,0,179,0,0,23,48,46,42,14,3,3,0,3,126,50,179
20211012,12OCT2021:00:00:00,UFU GUTIERREZ,143,146,128,159,2,289,265,24,283,6,176,76,10,15,12,0,0,0,0,0,175,90,265
20211012,12OCT2021:00:00:00,UFU MUÑIZ,63,106,71,81,17,169,145,24,149,20,3,3,25,40,56,17,14,11,0,0,103,42,145
20211012,12OCT2021:00:00:00,UFU PENNA,82,49,65,62,4,131,115,16,115,16,48,10,9,29,11,17,4,3,0,0,72,43,115
20211012,12OCT2021:00:00:00,UFU PIROVANO,190,138,269,40,19,328,304,24,314,14,0,25,64,97,53,46,22,21,0,11,174,119,304
20211012,12OCT2021:00:00:00,UFU PIÑERO,161,120,240,36,5,281,267,14,269,12,88,49,40,21,33,27,16,7,0,1,199,66,267
20211012,12OCT2021:00:00:00,UFU RAMOS MEJIA,163,116,192,66,21,279,215,64,221,58,36,15,58,55,50,22,30,13,0,7,115,92,215
20211012,12OCT2021:00:00:00,UFU RIVADAVIA,134,85,139,49,31,219,209,10,209,10,0,11,56,57,43,15,24,13,0,5,121,83,209
20211012,12OCT2021:00:00:00,UFU SANTOJANNI,132,84,133,65,18,216,204,12,214,2,2,58,31,31,24,35,15,20,0,1,117,85,204
20211012,12OCT2021:00:00:00,UFU TORNU,200,184,346,21,17,384,318,66,322,62,64,45,55,79,71,36,13,21,0,5,226,83,318
20211012,12OCT2021:00:00:00,UFU VELEZ SARSFIELD,136,112,207,30,11,248,242,6,242,6,0,17,53,74,34,28,30,12,0,5,162,75,242
20211012,12OCT2021:00:00:00,UFU ZUBIZARRETA,119,98,125,72,20,217,207,10,217,0,0,36,27,45,50,24,27,8,0,2,152,53,207
20211013,13OCT2021:00:00:00,UFU ALVAREZ,194,214,305,59,44,408,376,32,384,24,64,59,64,77,58,54,28,4,0,0,268,108,376
20211013,13OCT2021:00:00:00,UFU ARGERICH,73,42,84,29,2,115,103,12,103,12,5,20,18,27,18,14,7,6,0,0,60,42,103
20211013,13OCT2021:00:00:00,UFU BORDA-MOYANO,20,42,40,20,2,62,58,4,58,4,2,4,12,15,15,12,2,0,0,0,38,20,58
20211013,13OCT2021:00:00:00,UFU DURAND,131,81,187,14,11,212,202,10,202,10,9,18,44,77,35,4,15,10,0,9,110,83,202
20211013,13OCT2021:00:00:00,UFU ELIZALDE,116,156,75,191,6,272,244,28,254,18,205,49,3,5,4,6,0,0,0,1,165,78,244
20211013,13OCT2021:00:00:00,UFU FERNANDEZ,93,59,124,15,13,152,132,20,138,14,0,7,46,47,25,12,7,8,0,3,80,48,132
20211013,13OCT2021:00:00:00,UFU FERRER,66,59,77,39,9,125,117,8,119,6,0,0,34,27,25,20,16,3,0,1,84,32,117
20211013,13OCT2021:00:00:00,UFU GRIERSON,111,76,120,56,11,187,155,32,183,4,0,30,45,46,32,20,12,2,0,1,114,40,155
20211013,13OCT2021:00:00:00,UFU GUTIERREZ,156,160,167,147,2,316,298,18,314,2,226,73,5,2,5,2,3,0,0,0,206,92,298
20211013,13OCT2021:00:00:00,UFU MUÑIZ,154,131,141,132,12,285,241,44,251,34,3,41,40,47,67,25,37,25,0,0,170,71,241
20211013,13OCT2021:00:00:00,UFU PENNA,63,58,71,50,0,121,119,2,121,0,42,25,10,17,4,6,13,4,0,0,84,35,119
20211013,13OCT2021:00:00:00,UFU PIROVANO,142,135,224,29,24,277,265,12,271,6,0,11,66,76,52,26,15,31,0,5,144,111,265
20211013,13OCT2021:00:00:00,UFU PIÑERO,143,97,205,29,6,240,230,10,234,6,91,52,23,38,13,12,8,3,0,0,169,58,230
20211013,13OCT2021:00:00:00,UFU RAMOS MEJIA,113,104,162,42,13,217,155,62,171,46,21,18,40,45,40,28,20,5,0,2,94,59,155
20211013,13OCT2021:00:00:00,UFU RIVADAVIA,109,105,132,46,36,214,188,26,190,24,2,9,82,50,20,28,16,7,0,1,117,70,188
20211013,13OCT2021:00:00:00,UFU SANTOJANNI,170,110,175,93,12,280,246,34,276,4,33,63,43,44,28,28,13,28,0,9,134,103,246
20211013,13OCT2021:00:00:00,UFU TORNU,114,114,171,39,18,228,194,34,194,34,22,29,33,39,59,25,19,2,0,0,149,43,194
20211013,13OCT2021:00:00:00,UFU VELEZ SARSFIELD,160,121,229,42,10,281,255,26,277,4,2,34,65,69,51,12,33,15,0,4,175,76,255
20211013,13OCT2021:00:00:00,UFU ZUBIZARRETA,105,51,87,58,11,156,144,12,156,0,0,16,20,45,38,13,21,3,0,2,102,40,144
20211014,14OCT2021:00:00:00,UFU ALVAREZ,131,112,189,32,22,243,235,8,237,6,34,26,46,56,31,23,18,9,0,0,165,70,235
20211014,14OCT2021:00:00:00,UFU ARGERICH,62,60,86,32,4,122,88,34,90,32,18,11,16,27,18,14,8,10,0,2,45,40,88
20211014,14OCT2021:00:00:00,UFU BORDA-MOYANO,40,30,59,7,4,70,68,2,68,2,0,4,15,16,12,9,12,2,0,0,42,26,68
20211014,14OCT2021:00:00:00,UFU DURAND,130,96,202,9,15,226,212,14,216,10,20,18,50,57,29,19,16,17,0,4,122,86,212
20211014,14OCT2021:00:00:00,UFU ELIZALDE,124,109,81,149,3,233,197,36,221,12,173,40,7,5,5,0,0,3,0,1,114,82,197
20211014,14OCT2021:00:00:00,UFU FERNANDEZ,97,54,135,11,5,151,137,14,143,8,0,4,56,45,18,8,4,16,0,2,77,58,137
20211014,14OCT2021:00:00:00,UFU FERRER,74,42,63,50,3,116,114,2,114,2,0,0,40,27,34,6,4,5,0,0,88,26,114
20211014,14OCT2021:00:00:00,UFU GRIERSON,82,64,75,57,14,146,142,4,142,4,0,30,25,32,26,21,8,4,0,1,103,38,142
20211014,14OCT2021:00:00:00,UFU GUTIERREZ,118,101,149,68,2,219,207,12,215,4,134,64,9,5,4,3,0,0,0,0,135,72,207
20211014,14OCT2021:00:00:00,UFU MUÑIZ,70,103,81,85,7,173,123,50,133,40,4,9,43,34,40,20,18,5,0,0,95,28,123
20211014,14OCT2021:00:00:00,UFU PENNA,58,43,45,55,1,101,97,4,97,4,38,15,4,14,10,6,5,9,0,0,68,29,97
20211014,14OCT2021:00:00:00,UFU PIROVANO,161,124,225,24,36,285,265,20,277,8,0,9,65,82,60,25,28,16,0,5,153,107,265
20211014,14OCT2021:00:00:00,UFU PIÑERO,118,92,166,37,7,210,204,6,204,6,58,20,51,26,19,15,12,9,0,0,147,55,204
20211014,14OCT2021:00:00:00,UFU RAMOS MEJIA,97,81,132,26,20,178,140,38,140,38,3,12,39,46,35,18,18,7,0,5,80,55,140
20211014,14OCT2021:00:00:00,UFU RIVADAVIA,80,65,112,21,12,145,111,34,111,34,0,3,43,38,14,31,10,6,0,2,68,41,111
20211014,14OCT2021:00:00:00,UFU SANTOJANNI,120,76,122,62,12,196,188,8,192,4,0,28,38,24,43,35,16,12,0,4,115,69,188
20211014,14OCT2021:00:00:00,UFU TORNU,123,118,187,41,13,241,195,46,199,42,33,15,30,70,52,14,20,7,0,2,134,56,195
20211014,14OCT2021:00:00:00,UFU VELEZ SARSFIELD,130,80,164,39,7,210,196,14,204,6,0,12,57,47,39,36,9,10,0,2,142,52,196
20211014,14OCT2021:00:00:00,UFU ZUBIZARRETA,158,118,197,67,12,276,276,0,276,0,0,24,51,78,49,26,29,19,0,3,210,63,276
20211015,15OCT2021:00:00:00,UFU ALVAREZ,125,89,165,36,13,214,208,6,208,6,30,33,43,46,33,13,13,3,0,2,140,66,208
20211015,15OCT2021:00:00:00,UFU ARGERICH,58,34,62,24,6,92,75,17,75,17,14,2,21,18,14,8,6,9,0,0,35,40,75
20211015,15OCT2021:00:00:00,UFU BORDA-MOYANO,31,23,38,16,0,54,50,4,50,4,1,8,11,11,14,4,5,0,0,0,30,20,50
20211015,15OCT2021:00:00:00,UFU DURAND,100,63,149,6,8,163,157,6,157,6,0,5,47,67,19,13,7,5,0,4,94,59,157
20211015,15OCT2021:00:00:00,UFU ELIZALDE,79,64,35,103,5,143,133,10,139,4,108,31,1,0,3,0,0,0,0,0,89,44,133
20211015,15OCT2021:00:00:00,UFU FERNANDEZ,86,64,119,21,10,150,138,12,144,6,0,2,29,54,22,17,12,14,0,2,78,58,138
20211015,15OCT2021:00:00:00,UFU FERRER,75,59,71,57,6,134,132,2,132,2,0,0,50,42,24,9,9,0,0,1,94,37,132
20211015,15OCT2021:00:00:00,UFU GRIERSON,91,65,105,37,14,156,116,40,154,2,0,12,38,30,32,26,16,2,0,0,86,29,116
20211118,18NOV2021:00:00:00,UFU ZUBIZARRETA,111,71,140,33,9,182,169,13,182,0,0,22,29,25,47,35,9,15,0,6,118,45,169
20211119,19NOV2021:00:00:00,UFU ALVAREZ,186,140,276,36,14,326,314,12,314,12,31,20,65,66,56,51,24,13,0,5,221,88,314
20211119,19NOV2021:00:00:00,UFU ARGERICH,55,35,59,26,5,90,74,16,82,8,0,0,19,18,15,12,10,16,0,4,40,30,74
20211119,19NOV2021:00:00:00,UFU BORDA-MOYANO,37,45,42,32,8,82,76,6,76,6,0,20,20,14,14,14,0,0,0,0,48,28,76
20211119,19NOV2021:00:00:00,UFU DURAND,142,69,179,14,18,211,191,20,191,20,0,12,43,47,46,19,25,19,0,14,103,74,191
20211119,19NOV2021:00:00:00,UFU ELIZALDE,69,86,27,124,4,155,125,30,139,16,116,24,5,5,3,2,0,0,0,2,69,54,125
20211119,19NOV2021:00:00:00,UFU FERNANDEZ,88,47,108,22,5,135,129,6,133,2,0,0,24,44,24,24,11,8,0,4,78,46,129
20211119,19NOV2021:00:00:00,UFU FERRER,46,66,81,27,4,112,112,0,112,0,0,3,39,32,24,7,3,4,0,4,82,26,112
20211119,19NOV2021:00:00:00,UFU GRIERSON,113,88,150,38,13,201,147,54,193,8,0,17,64,33,40,20,17,10,0,8,100,38,147
20211119,19NOV2021:00:00:00,UFU GUTIERREZ,84,98,92,84,6,182,156,26,180,2,119,37,8,9,7,0,2,0,0,2,91,63,156
20211119,19NOV2021:00:00:00,UFU MUÑIZ,114,118,104,102,26,232,208,24,212,20,8,8,52,51,43,30,34,6,0,4,147,57,208
20211119,19NOV2021:00:00:00,UFU PENNA,50,22,34,37,1,72,72,0,72,0,21,5,10,4,10,13,4,5,0,3,52,17,72
20211119,19NOV2021:00:00:00,UFU PIROVANO,173,106,222,18,39,279,261,18,273,6,0,9,53,77,73,24,27,16,0,10,142,109,261
20211119,19NOV2021:00:00:00,UFU PIÑERO,116,91,150,29,28,207,191,16,197,10,64,22,23,37,31,13,7,10,0,1,141,49,191
20211119,19NOV2021:00:00:00,UFU RAMOS MEJIA,106,94,159,24,17,200,190,10,192,8,27,9,39,48,30,27,15,5,0,1,116,73,190
20211119,19NOV2021:00:00:00,UFU RIVADAVIA,145,97,175,30,37,242,232,10,232,10,0,2,81,63,49,14,19,14,0,13,126,93,232
20211119,19NOV2021:00:00:00,UFU SANTOJANNI,137,102,130,93,16,239,223,16,231,8,2,40,32,43,40,35,21,26,0,3,128,92,223
20211119,19NOV2021:00:00:00,UFU TORNU,100,86,150,29,7,186,160,26,168,18,23,30,29,42,33,14,6,9,0,8,104,45,160
20211119,19NOV2021:00:00:00,UFU VELEZ SARSFIELD,146,109,189,50,16,255,241,14,249,6,0,17,48,44,65,32,27,22,0,7,166,68,241
20211119,19NOV2021:00:00:00,UFU ZUBIZARRETA,81,68,102,41,6,149,133,16,145,4,0,8,29,39,20,24,22,7,0,8,96,29,133
20211120,20NOV2021:00:00:00,UFU ALVAREZ,117,111,180,32,16,228,202,26,202,26,22,10,41,56,31,19,30,19,0,3,139,60,202
20211120,20NOV2021:00:00:00,UFU ARGERICH,1,6,7,0,0,7,7,0,7,0,4,2,1,0,0,0,0,0,0,0,3,4,7
20211120,20NOV2021:00:00:00,UFU BORDA-MOYANO,14,7,17,4,0,21,21,0,21,0,1,6,1,4,2,5,2,0,0,1,14,6,21
20211120,20NOV2021:00:00:00,UFU DURAND,92,64,136,13,7,156,152,4,152,4,2,12,29,41,37,14,8,13,0,8,81,63,152
20211120,20NOV2021:00:00:00,UFU ELIZALDE,63,63,58,64,4,126,94,32,124,2,104,20,0,2,0,0,0,0,0,0,54,40,94
20211120,20NOV2021:00:00:00,UFU FERNANDEZ,69,42,88,11,12,111,97,14,103,8,0,3,24,28,33,12,6,5,0,4,61,32,97
20211120,20NOV2021:00:00:00,UFU FERRER,36,40,65,11,0,76,70,6,70,6,0,5,2,19,30,6,12,2,0,2,57,11,70
20211120,20NOV2021:00:00:00,UFU GRIERSON,58,68,87,31,8,126,126,0,126,0,0,0,33,28,15,27,20,3,0,5,93,28,126
20211120,20NOV2021:00:00:00,UFU GUTIERREZ,75,91,117,46,3,166,157,8,163,2,119,34,2,6,3,2,0,0,0,2,111,43,157
20211120,20NOV2021:00:00:00,UFU MUÑIZ,105,73,88,71,19,178,146,32,160,18,2,23,25,50,31,23,21,3,0,8,100,38,146
20211120,20NOV2021:00:00:00,UFU PENNA,19,28,25,22,0,47,45,2,45,2,12,4,7,8,8,3,0,5,0,2,30,13,45
20211120,20NOV2021:00:00:00,UFU PIROVANO,114,75,163,11,15,189,183,6,183,6,0,7,34,63,38,25,17,5,0,7,106,70,183
20211120,20NOV2021:00:00:00,UFU PIÑERO,55,52,78,17,12,107,105,2,105,2,0,4,12,27,18,35,11,0,0,5,75,25,105
20211120,20NOV2021:00:00:00,UFU RAMOS MEJIA,46,41,66,19,2,87,74,13,74,13,6,7,21,20,18,8,3,4,0,1,41,32,74
20211120,20NOV2021:00:00:00,UFU RIVADAVIA,88,54,110,13,19,142,142,0,142,0,0,0,41,55,15,14,9,8,0,7,76,59,142
20211120,20NOV2021:00:00:00,UFU SANTOJANNI,105,67,105,62,5,172,156,16,164,8,0,20,16,40,39,19,21,17,0,9,83,63,156
20211120,20NOV2021:00:00:00,UFU TORNU,85,77,145,11,6,162,148,14,148,14,12,10,12,43,36,29,9,11,0,11,89,48,148
20211120,20NOV2021:00:00:00,UFU VELEZ SARSFIELD,117,88,159,36,10,205,201,4,201,4,0,6,44,41,48,30,15,21,0,9,129,63,201
20211120,20NOV2021:00:00:00,UFU ZUBIZARRETA,149,126,209,61,5,275,275,0,275,0,0,67,23,45,64,35,31,10,0,5,198,72,275
20211121,21NOV2021:00:00:00,UFU ALVAREZ,87,79,125,36,5,166,152,14,154,12,14,7,24,35,25,33,9,19,0,5,109,38,152
20211121,21NOV2021:00:00:00,UFU ARGERICH,7,14,13,8,0,21,19,2,21,0,16,5,0,0,0,0,0,0,0,0,9,10,19
20211121,21NOV2021:00:00:00,UFU BORDA-MOYANO,14,9,14,3,6,23,17,6,17,6,0,0,5,4,3,3,6,2,0,0,10,7,17
20211121,21NOV2021:00:00:00,UFU DURAND,57,60,111,2,4,117,111,6,111,6,6,10,23,24,24,16,9,5,0,8,59,44,111
20211121,21NOV2021:00:00:00,UFU ELIZALDE,59,44,34,69,0,103,79,24,99,4,81,22,0,0,0,0,0,0,0,1,46,32,79
20211121,21NOV2021:00:00:00,UFU FERNANDEZ,36,34,64,4,2,70,56,14,56,14,0,0,12,25,9,16,0,8,0,5,26,25,56
20211121,21NOV2021:00:00:00,UFU FERRER,51,55,61,43,2,106,96,10,102,4,0,0,16,32,14,19,22,3,0,6,61,29,96
20211121,21NOV2021:00:00:00,UFU GRIERSON,62,51,65,41,7,113,103,10,103,10,0,10,32,31,14,17,6,3,0,4,72,27,103
20211121,21NOV2021:00:00:00,UFU GUTIERREZ,45,89,76,56,2,134,116,18,132,2,91,29,3,0,5,6,0,0,0,1,79,36,116
20211121,21NOV2021:00:00:00,UFU MUÑIZ,95,83,106,56,16,178,130,48,134,44,0,30,32,51,30,28,2,5,0,5,89,36,130
20211121,21NOV2021:00:00:00,UFU PENNA,21,22,35,8,0,43,41,2,41,2,8,3,12,8,2,0,6,4,0,0,29,12,41
20211121,21NOV2021:00:00:00,UFU PIROVANO,130,76,172,24,10,206,173,33,195,11,5,4,30,52,50,20,26,19,0,12,85,76,173
20211121,21NOV2021:00:00:00,UFU PIÑERO,40,28,51,13,4,68,64,4,64,4,3,10,18,10,8,15,4,0,0,6,39,19,64
20211121,21NOV2021:00:00:00,UFU RAMOS MEJIA,36,44,53,9,18,80,74,6,76,4,2,5,19,15,15,6,12,6,0,6,35,33,74
20211121,21NOV2021:00:00:00,UFU RIVADAVIA,53,25,64,6,8,78,68,10,70,8,0,1,24,21,15,7,8,2,0,2,41,25,68
20211121,21NOV2021:00:00:00,UFU SANTOJANNI,83,67,86,60,4,150,144,6,150,0,0,5,19,34,29,23,17,23,0,17,63,64,144
20211121,21NOV2021:00:00:00,UFU TORNU,73,62,120,12,3,135,115,20,115,20,13,29,18,20,32,12,3,8,0,3,81,31,115
20211121,21NOV2021:00:00:00,UFU VELEZ SARSFIELD,84,91,125,40,10,175,171,4,171,4,0,5,21,45,34,19,25,26,0,6,116,49,171
20211121,21NOV2021:00:00:00,UFU ZUBIZARRETA,120,75,144,45,6,195,191,4,195,0,0,5,25,28,51,31,29,26,0,7,129,55,191
20211122,22NOV2021:00:00:00,UFU ALVAREZ,120,109,199,15,15,229,213,16,217,12,19,19,25,52,42,22,24,26,0,13,130,70,213
20211122,22NOV2021:00:00:00,UFU ARGERICH,26,40,41,23,2,66,66,0,66,0,7,4,5,22,9,13,0,6,0,8,35,23,66
20211122,22NOV2021:00:00:00,UFU BORDA-MOYANO,9,3,3,9,0,12,8,4,8,4,0,9,0,1,0,0,0,2,0,0,5,3,8
20211122,22NOV2021:00:00:00,UFU DURAND,109,61,154,11,5,170,167,3,167,3,7,9,43,29,39,23,19,1,0,13,88,66,167
20211122,22NOV2021:00:00:00,UFU ELIZALDE,55,62,27,90,0,117,111,6,111,6,100,12,2,0,0,0,3,0,0,0,58,53,111
20211122,22NOV2021:00:00:00,UFU FERNANDEZ,55,21,64,12,0,76,70,6,70,6,0,4,10,26,16,6,5,9,0,1,41,28,70
20211122,22NOV2021:00:00:00,UFU FERRER,52,37,55,32,2,89,83,6,83,6,0,3,11,12,21,34,5,3,0,4,60,19,83
20211122,22NOV2021:00:00:00,UFU GRIERSON,100,90,131,45,14,190,188,2,188,2,0,13,36,37,37,35,24,8,0,2,132,53,188
20210628,28JUN2021:00:00:00,UFU FERNANDEZ,83,63,81,12,53,146,128,18,138,8,0,6,35,36,16,27,20,6,0,17,72,39,128
20210628,28JUN2021:00:00:00,UFU FERRER,109,91,76,48,76,200,188,12,188,12,0,3,43,75,51,23,5,0,0,18,132,38,188
20210628,28JUN2021:00:00:00,UFU GRIERSON,103,108,85,52,74,211,211,0,211,0,0,8,65,58,42,29,8,1,0,31,121,59,211
20210628,28JUN2021:00:00:00,UFU GUTIERREZ,136,148,122,76,86,284,270,14,284,0,112,49,33,31,34,14,11,0,0,13,176,77,270
20210628,28JUN2021:00:00:00,UFU MUÑIZ,159,181,128,114,98,340,270,70,298,42,1,8,79,113,69,42,20,8,0,18,184,68,270
20210628,28JUN2021:00:00:00,UFU PENNA,69,43,84,11,17,112,100,12,106,6,0,4,27,26,5,28,13,9,0,9,64,27,100
20210628,28JUN2021:00:00:00,UFU PIROVANO,172,120,181,26,85,292,274,18,286,6,0,8,58,88,67,30,24,17,0,29,138,107,274
20210628,28JUN2021:00:00:00,UFU PIÑERO,108,86,137,26,31,194,182,12,190,4,22,8,47,47,30,27,9,4,0,12,130,40,182
20210628,28JUN2021:00:00:00,UFU RAMOS MEJIA,185,173,246,35,77,358,254,104,342,16,17,15,76,109,57,35,27,22,0,35,114,104,254
20210628,28JUN2021:00:00:00,UFU RIVADAVIA,117,79,113,27,56,196,180,16,180,16,0,2,55,51,38,35,12,3,0,29,83,68,180
20210628,28JUN2021:00:00:00,UFU SANTOJANNI,174,150,146,81,97,324,308,16,318,6,6,24,68,90,79,39,11,7,0,48,192,68,308
20210628,28JUN2021:00:00:00,UFU TORNU,106,100,122,27,57,206,194,12,202,4,14,10,56,50,30,32,10,4,0,21,123,48,194
20210628,28JUN2021:00:00:00,UFU VELEZ SARSFIELD,125,161,151,41,94,286,250,36,280,6,2,11,62,93,63,26,15,14,0,29,159,62,250
20210628,28JUN2021:00:00:00,UFU ZUBIZARRETA,131,121,118,126,8,252,250,2,252,0,0,14,75,43,51,18,33,18,0,27,158,65,250
20210629,29JUN2021:00:00:00,UFU ALVAREZ,175,133,228,64,16,308,288,20,288,20,19,27,61,89,56,33,12,11,0,37,168,83,288
20210629,29JUN2021:00:00:00,UFU ARGERICH,74,50,78,42,4,124,112,12,120,4,8,8,24,25,23,20,10,6,0,20,40,50,112
20210629,29JUN2021:00:00:00,UFU BORDA-MOYANO,23,22,27,12,6,45,33,12,33,12,0,0,16,9,8,10,0,2,0,3,22,8,33
20210629,29JUN2021:00:00:00,UFU DURAND,92,69,134,18,9,161,145,16,145,16,4,21,41,27,47,12,9,0,0,23,69,53,145
20210629,29JUN2021:00:00:00,UFU ELIZALDE,127,93,71,129,20,220,182,38,212,8,111,71,16,5,13,2,2,0,0,3,135,44,182
20210629,29JUN2021:00:00:00,UFU FERNANDEZ,67,75,111,16,15,142,126,16,134,8,0,10,38,40,19,19,7,9,0,10,71,45,126
20210629,29JUN2021:00:00:00,UFU FERRER,78,49,44,71,12,127,125,2,125,2,0,1,47,32,32,11,2,2,0,14,79,32,125
20210629,29JUN2021:00:00:00,UFU GRIERSON,99,81,61,90,29,180,180,0,180,0,0,8,46,43,52,19,9,3,0,16,115,48,180
20210629,29JUN2021:00:00:00,UFU GUTIERREZ,146,117,187,45,31,263,255,8,259,4,91,55,40,34,35,8,0,0,0,19,159,77,255
20210629,29JUN2021:00:00:00,UFU MUÑIZ,108,168,127,97,52,276,224,52,240,36,0,3,54,87,75,36,13,8,0,28,140,56,224
20210629,29JUN2021:00:00:00,UFU PENNA,41,52,64,20,9,93,83,10,87,6,0,2,19,28,17,18,9,0,0,7,51,25,83
20210629,29JUN2021:00:00:00,UFU PIROVANO,127,97,151,38,35,224,206,18,220,4,0,7,35,77,40,31,21,13,0,28,89,89,206
20210629,29JUN2021:00:00:00,UFU PIÑERO,79,73,87,41,24,152,140,12,148,4,6,8,32,44,39,21,2,0,0,11,89,38,140
20210629,29JUN2021:00:00:00,UFU RAMOS MEJIA,165,155,208,69,43,320,292,28,304,16,20,20,76,65,52,47,32,8,0,31,157,99,292
20210629,29JUN2021:00:00:00,UFU RIVADAVIA,109,66,119,28,28,175,171,4,171,4,0,5,56,51,23,26,9,5,0,19,85,67,171
20210629,29JUN2021:00:00:00,UFU SANTOJANNI,114,123,111,103,23,237,221,16,235,2,2,9,49,54,59,27,30,7,0,22,147,52,221
20210629,29JUN2021:00:00:00,UFU TORNU,134,124,173,57,28,258,216,42,228,30,19,24,60,67,45,19,12,12,0,20,138,53,216
20210629,29JUN2021:00:00:00,UFU VELEZ SARSFIELD,118,116,169,46,19,234,220,14,228,6,0,5,52,49,47,53,19,9,0,36,126,58,220
20210629,29JUN2021:00:00:00,UFU ZUBIZARRETA,133,110,109,107,27,243,243,0,243,0,0,11,51,51,54,44,28,4,0,28,150,65,243
20210630,30JUN2021:00:00:00,UFU ALVAREZ,225,157,301,60,21,382,364,18,368,14,33,21,85,99,66,40,24,14,0,38,224,102,364
20210630,30JUN2021:00:00:00,UFU ARGERICH,68,88,85,63,8,156,144,12,144,12,7,14,37,28,33,18,9,10,0,15,61,65,144
20210630,30JUN2021:00:00:00,UFU BORDA-MOYANO,31,47,40,33,5,78,74,4,74,4,0,6,13,16,16,19,6,2,0,3,41,30,74
20210630,30JUN2021:00:00:00,UFU DURAND,110,69,145,19,15,179,175,4,175,4,9,10,36,54,43,13,9,5,0,28,83,64,175
20210630,30JUN2021:00:00:00,UFU ELIZALDE,139,84,108,107,8,223,211,12,213,10,125,52,7,17,15,5,2,0,0,11,150,50,211
20210630,30JUN2021:00:00:00,UFU FERNANDEZ,93,64,118,23,16,157,139,18,141,16,0,4,48,34,21,14,21,15,0,16,75,48,139
20210630,30JUN2021:00:00:00,UFU FERRER,88,61,80,55,14,149,141,8,141,8,0,1,49,28,34,26,5,6,0,24,83,34,141
20210630,30JUN2021:00:00:00,UFU GRIERSON,125,128,121,122,10,253,247,6,249,4,0,7,81,68,47,24,26,0,0,26,145,76,247
20210630,30JUN2021:00:00:00,UFU GUTIERREZ,153,158,200,95,16,311,291,20,309,2,116,60,46,33,39,17,0,0,0,21,182,86,291
20210630,30JUN2021:00:00:00,UFU MUÑIZ,115,131,123,109,14,246,158,88,208,38,0,7,76,66,53,21,19,4,0,8,111,39,158
20210630,30JUN2021:00:00:00,UFU PENNA,70,51,104,12,5,121,115,6,121,0,0,6,41,20,18,15,14,7,0,13,68,34,115
20210630,30JUN2021:00:00:00,UFU PIROVANO,146,120,203,41,22,266,244,22,264,2,0,4,52,82,68,35,14,11,0,39,107,98,244
20210630,30JUN2021:00:00:00,UFU PIÑERO,90,100,137,43,10,190,178,12,180,10,0,8,51,39,47,27,9,9,0,15,115,45,178
20210630,30JUN2021:00:00:00,UFU RAMOS MEJIA,127,146,217,33,23,273,225,48,239,34,13,22,53,76,43,26,28,12,0,17,132,75,225
20210630,30JUN2021:00:00:00,UFU RIVADAVIA,128,83,130,54,27,211,139,72,139,72,0,2,60,79,30,25,7,8,0,14,72,53,139
20210630,30JUN2021:00:00:00,UFU SANTOJANNI,123,108,133,96,2,231,221,10,229,2,14,14,45,54,53,27,24,0,0,31,138,52,221
20210630,30JUN2021:00:00:00,UFU TORNU,110,57,119,35,13,167,161,6,161,6,3,10,38,36,42,27,9,2,0,15,101,43,161
20210630,30JUN2021:00:00:00,UFU VELEZ SARSFIELD,153,131,191,69,24,284,270,14,282,2,0,10,59,86,59,36,28,6,0,29,167,74,270
20210630,30JUN2021:00:00:00,UFU ZUBIZARRETA,115,83,117,75,6,198,198,0,198,0,0,10,67,45,43,13,14,6,0,20,121,57,198
20210701,01JUL2021:00:00:00,UFU ALVAREZ,128,112,186,46,8,240,212,28,212,28,16,24,49,77,37,22,6,9,0,26,117,69,212
20210701,01JUL2021:00:00:00,UFU ARGERICH,53,50,57,44,2,103,93,10,93,10,3,4,19,26,13,19,15,4,0,13,42,38,93
20210701,01JUL2021:00:00:00,UFU BORDA-MOYANO,47,27,65,9,0,74,64,10,64,10,2,13,11,19,6,10,5,8,0,3,42,19,64
20210701,01JUL2021:00:00:00,UFU DURAND,102,80,162,12,8,182,166,16,166,16,10,7,46,52,27,14,19,7,0,31,69,66,166
20210701,01JUL2021:00:00:00,UFU ELIZALDE,145,127,138,132,2,272,266,6,270,2,135,88,8,28,4,9,0,0,0,11,176,79,266
20210701,01JUL2021:00:00:00,UFU FERNANDEZ,114,75,130,48,11,189,161,28,177,12,0,5,37,73,37,15,13,9,0,25,71,65,161
20210701,01JUL2021:00:00:00,UFU FERRER,134,83,115,99,3,217,213,4,213,4,0,0,68,63,49,22,15,0,0,24,126,63,213
20210701,01JUL2021:00:00:00,UFU GRIERSON,127,118,128,112,5,245,235,10,243,2,0,17,53,87,48,26,10,4,0,18,151,66,235
20210701,01JUL2021:00:00:00,UFU GUTIERREZ,107,102,167,35,7,209,189,20,209,0,87,21,21,45,15,17,3,0,0,15,119,54,189
20210701,01JUL2021:00:00:00,UFU MUÑIZ,133,177,146,124,40,310,232,78,246,64,0,5,64,95,71,35,27,13,0,14,152,66,232
20210701,01JUL2021:00:00:00,UFU PENNA,59,50,86,21,2,109,89,20,103,6,0,7,29,24,16,22,6,5,0,10,53,26,89
20210701,01JUL2021:00:00:00,UFU PIROVANO,143,105,191,29,28,248,220,28,248,0,0,5,72,78,58,18,11,6,0,37,91,92,220
20210701,01JUL2021:00:00:00,UFU PIÑERO,100,106,135,55,16,206,196,10,202,4,0,13,66,36,37,24,18,12,0,15,123,53,196
20210821,21AUG2021:00:00:00,UFU RAMOS MEJIA,155,111,172,66,28,266,252,14,258,8,6,17,55,70,47,32,28,11,0,10,176,66,252
20210821,21AUG2021:00:00:00,UFU RIVADAVIA,133,95,178,32,18,228,188,40,188,40,0,2,63,66,53,19,16,9,0,10,100,78,188
20210821,21AUG2021:00:00:00,UFU SANTOJANNI,244,201,256,156,33,445,433,12,439,6,0,41,82,86,95,76,39,26,0,8,316,109,433
20210821,21AUG2021:00:00:00,UFU TORNU,134,126,212,32,16,260,210,50,210,50,13,13,56,64,62,17,23,12,0,8,149,53,210
20210821,21AUG2021:00:00:00,UFU VELEZ SARSFIELD,197,114,246,56,9,311,309,2,311,0,0,21,42,72,77,46,39,14,0,6,222,81,309
20210821,21AUG2021:00:00:00,UFU ZUBIZARRETA,123,77,162,35,3,200,192,8,200,0,0,22,30,46,37,41,18,6,0,8,129,55,192
20210822,22AUG2021:00:00:00,UFU ALVAREZ,281,182,384,46,33,463,433,30,433,30,69,59,51,82,99,65,26,12,0,6,313,114,433
20210822,22AUG2021:00:00:00,UFU ARGERICH,28,25,37,16,0,53,53,0,53,0,2,6,8,9,10,5,9,4,0,2,23,28,53
20210822,22AUG2021:00:00:00,UFU BORDA-MOYANO,27,43,52,14,4,70,70,0,70,0,0,9,9,9,21,10,8,4,0,0,50,20,70
20210822,22AUG2021:00:00:00,UFU DURAND,150,92,219,14,9,242,230,12,232,10,8,14,31,66,48,30,24,21,0,13,122,95,230
20210822,22AUG2021:00:00:00,UFU ELIZALDE,131,120,66,183,2,251,197,54,247,4,149,47,19,19,14,3,0,0,0,3,110,84,197
20210822,22AUG2021:00:00:00,UFU FERNANDEZ,117,96,183,15,15,213,194,19,200,13,0,13,32,62,49,29,21,7,0,10,125,59,194
20210822,22AUG2021:00:00:00,UFU FERRER,96,63,88,71,0,159,155,4,155,4,0,3,34,58,18,17,22,7,0,4,113,38,155
20210822,22AUG2021:00:00:00,UFU GRIERSON,134,101,142,75,18,235,207,28,207,28,1,21,56,59,49,43,4,2,0,4,153,49,207
20210822,22AUG2021:00:00:00,UFU GUTIERREZ,134,143,206,67,4,277,269,8,269,8,176,61,8,9,15,5,3,0,0,6,183,80,269
20210822,22AUG2021:00:00:00,UFU MUÑIZ,103,90,84,92,17,193,177,16,179,14,0,2,64,37,33,23,23,11,0,2,133,42,177
20210822,22AUG2021:00:00:00,UFU PENNA,66,57,91,27,5,123,119,4,119,4,2,2,9,36,36,9,17,12,0,2,83,34,119
20210822,22AUG2021:00:00:00,UFU PIROVANO,221,144,308,35,22,365,319,46,351,14,30,29,71,80,71,45,22,17,0,34,158,127,319
20210822,22AUG2021:00:00:00,UFU PIÑERO,81,37,87,20,11,118,114,4,116,2,0,17,16,20,49,13,3,0,0,1,80,33,114
20210822,22AUG2021:00:00:00,UFU RAMOS MEJIA,159,144,218,41,44,303,277,26,277,26,13,16,61,65,62,45,25,16,0,7,199,71,277
20210822,22AUG2021:00:00:00,UFU RIVADAVIA,137,90,191,24,12,227,223,4,223,4,0,0,61,86,35,20,24,1,0,4,127,92,223
20210822,22AUG2021:00:00:00,UFU SANTOJANNI,290,158,277,142,29,448,432,16,436,12,2,43,87,98,90,72,45,11,0,8,315,109,432
20210822,22AUG2021:00:00:00,UFU TORNU,111,101,172,27,13,212,194,18,194,18,16,28,24,53,33,37,19,2,0,1,149,44,194
20210822,22AUG2021:00:00:00,UFU VELEZ SARSFIELD,189,113,238,47,17,302,300,2,300,2,0,14,48,60,92,48,30,10,0,6,211,83,300
20210822,22AUG2021:00:00:00,UFU ZUBIZARRETA,101,46,124,23,0,147,147,0,147,0,0,5,26,45,32,19,13,7,0,2,110,35,147
20210823,23AUG2021:00:00:00,UFU ALVAREZ,288,219,393,91,23,507,471,36,479,28,88,51,110,115,67,44,18,14,0,4,345,122,471
20210823,23AUG2021:00:00:00,UFU ARGERICH,91,82,109,60,4,173,159,14,163,10,56,12,21,44,20,12,7,1,0,3,84,71,159
20210823,23AUG2021:00:00:00,UFU BORDA-MOYANO,29,19,18,30,0,48,46,2,46,2,0,0,6,13,11,13,5,0,0,0,29,17,46
20210823,23AUG2021:00:00:00,UFU DURAND,161,129,247,29,14,290,272,18,274,16,16,19,72,66,49,30,29,9,0,12,147,113,272
20210823,23AUG2021:00:00:00,UFU ELIZALDE,180,143,103,216,4,323,295,28,311,12,208,73,13,9,12,5,3,0,0,0,186,109,295
20210823,23AUG2021:00:00:00,UFU FERNANDEZ,173,105,224,39,15,278,240,38,256,22,0,8,73,68,53,34,25,17,0,9,134,97,240
20210823,23AUG2021:00:00:00,UFU FERRER,170,112,146,126,10,282,272,10,274,8,0,0,77,75,56,26,40,8,0,4,200,68,272
20210823,23AUG2021:00:00:00,UFU GRIERSON,178,98,155,111,10,276,264,12,274,2,0,13,75,66,34,55,25,8,0,4,192,68,264
20210823,23AUG2021:00:00:00,UFU GUTIERREZ,207,160,207,160,0,367,349,18,361,6,238,86,14,13,12,4,0,0,0,1,228,119,349
20210823,23AUG2021:00:00:00,UFU MUÑIZ,155,166,142,166,13,321,269,52,277,44,3,20,75,58,74,45,36,10,0,6,181,82,269
20210823,23AUG2021:00:00:00,UFU PENNA,89,90,107,72,0,179,177,2,177,2,0,5,55,45,25,20,21,8,0,7,120,50,177
20210823,23AUG2021:00:00:00,UFU PIROVANO,240,181,342,53,26,421,395,26,411,10,0,13,97,113,101,42,31,24,0,9,224,162,395
20210823,23AUG2021:00:00:00,UFU PIÑERO,151,127,218,37,23,278,268,10,268,10,2,25,58,77,62,21,17,16,0,6,184,78,268
20210823,23AUG2021:00:00:00,UFU RAMOS MEJIA,264,231,374,83,38,495,479,16,489,6,45,47,103,118,67,63,31,21,0,5,325,148,479
20210823,23AUG2021:00:00:00,UFU RIVADAVIA,134,79,155,41,17,213,197,16,199,14,0,13,35,54,37,33,29,12,0,4,109,84,197
20210823,23AUG2021:00:00:00,UFU SANTOJANNI,308,217,303,205,17,525,519,6,525,0,37,50,82,118,102,82,32,22,0,8,377,134,519
20210823,23AUG2021:00:00:00,UFU TORNU,251,239,391,69,30,490,388,102,388,102,76,54,61,139,74,52,19,15,0,5,269,108,388
20210823,23AUG2021:00:00:00,UFU VELEZ SARSFIELD,177,175,290,55,7,352,336,16,346,6,2,24,56,99,73,38,35,25,0,3,236,97,336
20210823,23AUG2021:00:00:00,UFU ZUBIZARRETA,245,210,271,135,49,455,445,10,455,0,0,32,89,96,98,57,39,44,0,10,329,106,445
20210824,24AUG2021:00:00:00,UFU ALVAREZ,299,226,394,90,41,525,475,50,475,50,129,87,71,99,58,40,36,5,0,7,353,115,475
20210824,24AUG2021:00:00:00,UFU ARGERICH,101,81,102,71,9,182,162,20,164,18,45,22,34,25,22,16,14,4,0,3,87,70,162
20210824,24AUG2021:00:00:00,UFU BORDA-MOYANO,44,26,52,15,3,70,68,2,68,2,2,0,5,20,15,16,9,3,0,0,46,22,68
20210824,24AUG2021:00:00:00,UFU DURAND,143,155,254,26,18,298,284,14,286,12,17,27,52,98,35,37,17,15,0,9,161,114,284
20210824,24AUG2021:00:00:00,UFU ELIZALDE,157,127,97,183,4,284,268,16,274,10,165,72,13,21,5,2,4,2,0,1,166,101,268
20210824,24AUG2021:00:00:00,UFU FERNANDEZ,136,100,169,46,21,236,202,34,218,18,0,8,64,61,55,27,11,10,0,9,121,72,202
20210824,24AUG2021:00:00:00,UFU FERRER,101,77,87,84,7,178,178,0,178,0,0,3,45,45,31,27,18,9,0,3,135,40,178
20210824,24AUG2021:00:00:00,UFU GRIERSON,163,140,186,102,15,303,293,10,295,8,0,47,72,56,45,41,17,25,0,12,205,74,293
20210824,24AUG2021:00:00:00,UFU GUTIERREZ,209,191,266,128,6,400,394,6,400,0,246,93,20,29,5,3,4,0,0,0,281,113,394
20210824,24AUG2021:00:00:00,UFU MUÑIZ,157,158,134,157,24,315,249,66,257,58,2,20,75,66,69,35,29,19,0,5,163,81,249
20210824,24AUG2021:00:00:00,UFU PENNA,64,56,88,32,0,120,116,4,116,4,5,10,29,35,18,15,3,5,0,8,76,32,116
20210824,24AUG2021:00:00:00,UFU PIROVANO,219,163,287,52,43,382,328,54,374,8,0,18,87,112,62,59,24,20,0,20,172,136,328
20210824,24AUG2021:00:00:00,UFU PIÑERO,137,96,175,37,21,233,229,4,229,4,0,13,41,56,46,31,38,8,0,3,169,52,229
20210824,24AUG2021:00:00:00,UFU RAMOS MEJIA,227,180,282,63,62,407,383,24,383,24,26,47,77,99,67,52,27,12,0,1,279,103,383
20210824,24AUG2021:00:00:00,UFU RIVADAVIA,176,150,234,56,36,326,318,8,318,8,2,39,87,80,42,45,21,10,0,16,172,130,318
20210824,24AUG2021:00:00:00,UFU SANTOJANNI,213,206,265,135,19,419,401,18,415,4,4,49,101,96,67,52,33,17,0,4,295,102,401
20210824,24AUG2021:00:00:00,UFU TORNU,284,202,410,49,27,486,400,86,402,84,47,74,40,105,109,70,15,26,0,10,292,97,400
20210824,24AUG2021:00:00:00,UFU VELEZ SARSFIELD,208,147,289,57,9,355,343,12,351,4,0,34,62,76,89,57,24,13,0,5,243,95,343
20210824,24AUG2021:00:00:00,UFU ZUBIZARRETA,108,75,119,54,10,183,183,0,183,0,0,24,43,49,26,21,10,10,0,1,132,50,183
20210825,25AUG2021:00:00:00,UFU ALVAREZ,272,218,392,83,15,490,454,36,454,36,113,57,78,82,64,55,17,24,0,8,324,122,454
20211015,15OCT2021:00:00:00,UFU GUTIERREZ,127,92,108,108,3,219,209,10,219,0,127,63,7,3,12,5,2,0,0,0,140,69,209
20211015,15OCT2021:00:00:00,UFU MUÑIZ,73,84,71,80,6,157,133,24,139,18,3,3,40,42,26,24,6,13,0,0,100,33,133
20211015,15OCT2021:00:00:00,UFU PENNA,47,49,49,45,2,96,94,2,94,2,23,21,12,19,5,12,4,0,0,1,64,28,94
20211015,15OCT2021:00:00:00,UFU PIROVANO,161,142,247,33,23,303,267,36,295,8,0,23,68,98,55,32,17,10,0,7,154,106,267
20211015,15OCT2021:00:00:00,UFU PIÑERO,98,112,181,29,0,210,202,8,202,8,66,31,32,27,29,10,10,5,0,1,154,46,202
20211015,15OCT2021:00:00:00,UFU RAMOS MEJIA,91,71,122,27,13,162,146,16,148,14,19,10,25,30,22,33,18,5,0,0,87,59,146
20211015,15OCT2021:00:00:00,UFU RIVADAVIA,128,97,153,34,38,225,219,6,219,6,0,12,50,77,46,21,11,8,0,6,126,87,219
20211015,15OCT2021:00:00:00,UFU SANTOJANNI,147,78,153,59,13,225,213,12,215,10,21,65,37,30,26,23,18,5,0,1,126,86,213
20211015,15OCT2021:00:00:00,UFU TORNU,147,73,161,50,9,220,177,43,181,39,18,31,33,62,35,25,12,4,0,5,119,49,177
20211015,15OCT2021:00:00:00,UFU VELEZ SARSFIELD,134,107,175,48,18,241,233,8,239,2,0,16,70,45,57,29,13,11,0,0,165,68,233
20211015,15OCT2021:00:00:00,UFU ZUBIZARRETA,79,73,104,33,15,152,152,0,152,0,0,32,38,22,20,18,17,5,0,2,110,40,152
20211016,16OCT2021:00:00:00,UFU ALVAREZ,129,67,173,13,10,196,186,10,186,10,9,12,40,47,37,25,17,9,0,4,118,64,186
20211016,16OCT2021:00:00:00,UFU BORDA-MOYANO,23,21,32,12,0,44,44,0,44,0,0,4,10,10,10,3,2,5,0,0,30,14,44
20211016,16OCT2021:00:00:00,UFU DURAND,87,61,125,6,17,148,142,6,142,6,2,7,27,39,26,36,3,8,0,8,78,56,142
20211016,16OCT2021:00:00:00,UFU ELIZALDE,78,68,39,107,0,146,114,32,138,8,104,27,10,3,0,0,2,0,0,2,73,39,114
20211016,16OCT2021:00:00:00,UFU FERNANDEZ,43,39,65,13,4,82,78,4,78,4,0,4,15,14,17,17,4,11,0,0,47,31,78
20211016,16OCT2021:00:00:00,UFU FERRER,50,30,35,45,0,80,74,6,74,6,0,0,21,19,19,16,3,2,0,0,56,18,74
20211016,16OCT2021:00:00:00,UFU GRIERSON,74,46,74,23,23,120,112,8,116,4,0,12,35,29,11,22,7,4,0,2,77,31,112
20211016,16OCT2021:00:00:00,UFU GUTIERREZ,100,88,102,80,6,188,170,18,172,16,122,43,3,7,6,7,0,0,0,0,118,52,170
20211016,16OCT2021:00:00:00,UFU MUÑIZ,68,59,79,42,6,127,109,18,109,18,3,10,20,30,21,20,14,9,0,0,80,29,109
20211016,16OCT2021:00:00:00,UFU PENNA,45,26,30,39,2,71,67,4,67,4,13,8,19,7,9,1,12,2,0,2,43,22,67
20211016,16OCT2021:00:00:00,UFU PIROVANO,146,85,195,19,17,231,219,12,225,6,0,8,32,57,43,37,24,30,0,6,126,87,219
20211016,16OCT2021:00:00:00,UFU PIÑERO,51,23,59,11,4,74,74,0,74,0,0,6,10,19,22,10,7,0,0,0,56,17,74
20211016,16OCT2021:00:00:00,UFU RAMOS MEJIA,64,68,92,22,18,132,126,6,126,6,9,9,20,26,29,22,6,11,0,0,66,60,126
20211016,16OCT2021:00:00:00,UFU RIVADAVIA,83,55,101,21,16,138,138,0,138,0,0,4,41,39,25,13,8,8,0,6,72,58,138
20211016,16OCT2021:00:00:00,UFU SANTOJANNI,131,107,139,78,21,238,232,6,232,6,0,27,42,39,37,37,27,29,0,2,14,215,232
20211016,16OCT2021:00:00:00,UFU TORNU,118,96,179,24,11,214,190,24,190,24,6,32,20,54,37,37,21,7,0,5,131,54,190
20211016,16OCT2021:00:00:00,UFU VELEZ SARSFIELD,139,133,199,48,25,272,258,14,264,8,0,32,48,47,38,50,33,24,0,7,167,84,258
20211016,16OCT2021:00:00:00,UFU ZUBIZARRETA,188,150,262,65,11,338,336,2,338,0,0,27,60,72,79,34,50,16,0,4,244,88,336
20211017,17OCT2021:00:00:00,UFU ALVAREZ,73,63,107,22,7,136,128,8,128,8,28,5,17,12,33,25,10,6,0,2,81,45,128
20211017,17OCT2021:00:00:00,UFU ARGERICH,23,14,26,11,0,37,35,2,37,0,5,2,3,9,4,6,2,6,0,0,20,15,35
20211017,17OCT2021:00:00:00,UFU BORDA-MOYANO,4,2,0,6,0,6,6,0,6,0,0,0,0,2,2,0,2,0,0,0,4,2,6
20211017,17OCT2021:00:00:00,UFU DURAND,64,50,102,7,5,114,102,12,102,12,0,10,26,35,25,15,2,1,0,3,57,42,102
20211017,17OCT2021:00:00:00,UFU ELIZALDE,65,58,47,76,0,123,89,34,119,4,107,11,1,4,0,0,0,0,0,0,64,25,89
20211017,17OCT2021:00:00:00,UFU FERNANDEZ,44,27,56,13,2,71,61,10,61,10,0,2,5,21,11,8,9,15,0,2,35,24,61
20211017,17OCT2021:00:00:00,UFU FERRER,39,20,36,19,4,59,59,0,59,0,0,3,9,21,9,1,16,0,0,0,45,14,59
20211017,17OCT2021:00:00:00,UFU GRIERSON,53,36,48,19,22,89,75,14,75,14,0,8,22,17,16,14,6,6,0,2,52,21,75
20211017,17OCT2021:00:00:00,UFU GUTIERREZ,109,78,113,72,2,187,179,8,179,8,110,49,7,8,8,5,0,0,0,1,123,55,179
20211017,17OCT2021:00:00:00,UFU MUÑIZ,53,42,59,30,6,95,61,34,67,28,2,5,21,25,13,11,8,10,0,0,43,18,61
20211017,17OCT2021:00:00:00,UFU PENNA,26,18,25,17,2,44,42,2,42,2,8,3,10,10,4,9,0,0,0,1,28,13,42
20211017,17OCT2021:00:00:00,UFU PIROVANO,81,76,131,20,6,157,147,10,155,2,3,8,31,31,26,27,18,13,0,4,84,59,147
20211017,17OCT2021:00:00:00,UFU PIÑERO,45,27,52,9,11,72,70,2,70,2,0,3,25,7,13,17,5,2,0,4,52,14,70
20211017,17OCT2021:00:00:00,UFU RAMOS MEJIA,57,37,67,18,9,94,82,12,82,12,0,19,19,26,16,5,7,2,0,2,48,32,82
20211017,17OCT2021:00:00:00,UFU RIVADAVIA,99,54,130,12,11,153,141,12,141,12,0,7,50,33,21,21,8,13,0,3,81,57,141
20211017,17OCT2021:00:00:00,UFU SANTOJANNI,12,13,11,11,3,25,23,2,23,2,0,0,6,3,6,5,0,5,0,0,15,8,23
20211017,17OCT2021:00:00:00,UFU TORNU,89,72,145,11,5,161,139,22,139,22,15,8,12,53,44,14,7,8,0,1,100,37,139
20211017,17OCT2021:00:00:00,UFU VELEZ SARSFIELD,117,134,178,56,17,251,243,8,249,2,0,11,41,32,63,66,24,14,0,4,166,73,243
20211017,17OCT2021:00:00:00,UFU ZUBIZARRETA,95,70,117,45,3,165,165,0,165,0,0,16,23,27,36,31,19,13,0,3,119,43,165
20211018,18OCT2021:00:00:00,UFU ALVAREZ,206,118,263,51,10,324,294,30,298,26,36,24,65,68,46,36,30,19,0,2,199,93,294
20211018,18OCT2021:00:00:00,UFU ARGERICH,74,60,78,50,6,134,115,19,115,19,19,8,28,24,5,21,16,13,0,0,73,42,115
20211018,18OCT2021:00:00:00,UFU BORDA-MOYANO,32,21,35,11,7,53,37,16,37,16,0,8,8,24,12,1,0,0,0,1,24,12,37
20211018,18OCT2021:00:00:00,UFU DURAND,142,79,197,21,3,221,211,10,213,8,9,19,42,49,40,34,18,10,0,6,119,86,211
20211018,18OCT2021:00:00:00,UFU ELIZALDE,114,153,86,175,6,267,253,14,259,8,191,70,2,3,1,0,0,0,0,2,148,103,253
20211018,18OCT2021:00:00:00,UFU FERNANDEZ,95,65,138,20,2,160,150,10,152,8,0,3,34,42,24,24,15,18,0,1,90,59,150
20211018,18OCT2021:00:00:00,UFU FERRER,81,46,70,53,4,127,111,16,123,4,0,6,39,25,29,13,7,8,0,2,73,36,111
20211018,18OCT2021:00:00:00,UFU GRIERSON,123,87,132,60,18,210,170,40,208,2,29,23,48,47,25,25,9,4,0,0,127,43,170
20211018,18OCT2021:00:00:00,UFU GUTIERREZ,166,164,198,130,2,330,314,16,316,14,223,83,8,10,6,0,0,0,0,1,206,106,314
20211018,18OCT2021:00:00:00,UFU MUÑIZ,95,116,102,101,8,211,199,12,203,8,4,17,25,56,52,39,13,5,0,5,139,55,199
20211018,18OCT2021:00:00:00,UFU PENNA,112,70,106,70,6,182,172,10,176,6,53,25,17,28,14,18,4,23,0,0,111,61,172
20211018,18OCT2021:00:00:00,UFU PIROVANO,191,112,241,37,25,303,287,16,295,8,0,13,41,109,66,31,28,15,0,3,165,119,287
20211018,18OCT2021:00:00:00,UFU PIÑERO,126,108,197,29,8,234,226,8,228,6,120,48,26,15,12,8,2,3,0,1,163,62,226
20211018,18OCT2021:00:00:00,UFU RAMOS MEJIA,149,96,190,40,15,245,227,18,237,8,20,22,60,46,45,22,17,13,0,1,133,93,227
20211018,18OCT2021:00:00:00,UFU RIVADAVIA,111,96,125,61,21,207,203,4,203,4,0,2,46,74,21,30,22,12,0,2,117,84,203
20211018,18OCT2021:00:00:00,UFU SANTOJANNI,95,65,94,60,6,160,146,14,148,12,0,31,24,43,28,19,12,3,0,6,84,56,146
20211018,18OCT2021:00:00:00,UFU TORNU,160,149,254,41,14,309,245,64,245,64,41,25,61,72,54,26,19,11,0,0,165,75,245
20211018,18OCT2021:00:00:00,UFU VELEZ SARSFIELD,194,140,242,67,25,334,304,30,332,2,2,30,84,87,59,30,24,18,0,5,209,90,304
20211122,22NOV2021:00:00:00,UFU GUTIERREZ,80,60,66,72,2,140,132,8,138,2,99,19,15,4,0,3,0,0,0,0,82,50,132
20211122,22NOV2021:00:00:00,UFU MUÑIZ,57,79,65,63,8,136,112,24,120,16,1,5,28,32,34,20,10,6,0,0,84,28,112
20211122,22NOV2021:00:00:00,UFU PENNA,40,5,38,6,1,45,43,2,43,2,0,4,11,13,3,3,6,5,0,0,30,13,43
20211122,22NOV2021:00:00:00,UFU PIROVANO,116,85,168,16,17,201,189,12,195,6,0,11,44,30,47,28,18,23,0,10,100,78,189
20211122,22NOV2021:00:00:00,UFU PIÑERO,47,13,49,8,3,60,60,0,60,0,0,9,8,7,17,10,9,0,0,1,41,18,60
20211122,22NOV2021:00:00:00,UFU RAMOS MEJIA,50,36,60,12,14,86,78,8,80,6,0,7,12,16,13,22,6,10,0,4,39,35,78
20211122,22NOV2021:00:00:00,UFU RIVADAVIA,64,49,65,30,18,113,111,2,111,2,0,1,16,30,29,19,13,5,0,5,60,46,111
20211122,22NOV2021:00:00:00,UFU SANTOJANNI,97,92,110,62,17,189,175,14,179,10,4,14,40,47,24,23,13,24,0,19,80,74,175
20211122,22NOV2021:00:00:00,UFU TORNU,103,44,124,17,6,147,117,30,117,30,13,17,15,30,34,12,13,13,0,3,67,47,117
20211122,22NOV2021:00:00:00,UFU VELEZ SARSFIELD,71,113,141,43,0,184,178,6,178,6,0,10,37,37,33,30,17,20,0,4,125,49,178
20211122,22NOV2021:00:00:00,UFU ZUBIZARRETA,97,59,118,35,3,156,156,0,156,0,0,2,39,36,34,25,12,8,0,4,109,43,156
20211123,23NOV2021:00:00:00,UFU ALVAREZ,232,149,326,31,24,381,345,36,353,28,37,30,68,88,71,32,37,18,0,6,251,88,345
20211123,23NOV2021:00:00:00,UFU ARGERICH,67,40,51,50,6,107,81,26,97,10,18,7,18,19,16,8,13,8,0,3,45,33,81
20211123,23NOV2021:00:00:00,UFU BORDA-MOYANO,20,22,24,14,4,42,40,2,40,2,2,2,6,8,11,4,9,0,0,0,25,15,40
20211123,23NOV2021:00:00:00,UFU DURAND,154,86,218,14,8,240,230,10,230,10,15,26,43,67,34,34,17,4,0,15,115,100,230
20211123,23NOV2021:00:00:00,UFU ELIZALDE,91,118,45,162,2,209,121,88,195,14,154,46,3,5,0,1,0,0,0,0,69,52,121
20211123,23NOV2021:00:00:00,UFU FERNANDEZ,103,75,125,40,13,178,168,10,170,8,0,11,45,40,29,29,15,9,0,9,96,62,168
20211123,23NOV2021:00:00:00,UFU FERRER,85,29,69,40,5,114,110,4,112,2,0,4,26,24,27,20,11,2,0,2,80,28,110
20211123,23NOV2021:00:00:00,UFU GRIERSON,117,81,126,58,14,198,190,8,190,8,3,17,60,36,27,30,16,9,0,5,133,50,190
20211123,23NOV2021:00:00:00,UFU GUTIERREZ,150,105,141,108,6,255,207,48,249,6,173,50,12,12,8,0,0,0,0,4,117,86,207
20211123,23NOV2021:00:00:00,UFU MUÑIZ,112,128,110,113,17,240,206,34,212,28,4,8,61,56,50,18,27,16,0,1,146,58,206
20211123,23NOV2021:00:00:00,UFU PENNA,78,73,89,57,5,151,125,26,149,2,22,9,24,26,20,26,7,17,0,4,95,26,125
20211123,23NOV2021:00:00:00,UFU PIROVANO,164,124,230,32,26,288,272,16,276,12,0,13,68,65,56,50,23,13,0,29,134,109,272
20211123,23NOV2021:00:00:00,UFU PIÑERO,105,97,149,40,13,202,192,10,192,10,65,29,33,24,21,13,11,6,0,1,141,47,192
20211123,23NOV2021:00:00:00,UFU RAMOS MEJIA,128,98,176,32,18,226,214,12,216,10,7,8,37,44,44,32,22,32,0,6,110,98,214
20211123,23NOV2021:00:00:00,UFU RIVADAVIA,152,104,197,38,21,256,248,8,248,8,0,7,69,78,34,33,22,13,0,13,134,101,248
20211123,23NOV2021:00:00:00,UFU SANTOJANNI,138,79,134,68,15,217,201,16,209,8,0,10,38,45,45,35,21,23,0,9,112,80,201
20211123,23NOV2021:00:00:00,UFU TORNU,154,124,219,48,11,278,240,38,240,38,11,21,49,66,70,26,17,18,0,15,136,88,240
20211123,23NOV2021:00:00:00,UFU VELEZ SARSFIELD,122,124,180,59,7,246,246,0,246,0,0,12,21,82,55,42,9,25,0,8,178,60,246
20211123,23NOV2021:00:00:00,UFU ZUBIZARRETA,170,146,215,71,30,316,314,2,314,2,0,35,71,58,48,45,38,21,0,6,225,83,314
20211124,24NOV2021:00:00:00,UFU ALVAREZ,171,148,237,52,30,319,301,18,301,18,27,37,72,56,47,30,29,21,0,11,213,77,301
20211124,24NOV2021:00:00:00,UFU ARGERICH,72,45,77,35,5,117,76,41,84,33,12,5,16,27,30,9,8,10,0,1,45,30,76
20211124,24NOV2021:00:00:00,UFU BORDA-MOYANO,19,24,24,10,9,43,35,8,35,8,0,6,2,9,11,10,5,0,0,2,20,13,35
20211124,24NOV2021:00:00:00,UFU DURAND,144,105,224,22,3,249,247,2,247,2,6,27,60,69,35,28,13,11,0,11,134,102,247
20211124,24NOV2021:00:00:00,UFU ELIZALDE,80,81,44,110,7,161,131,30,157,4,111,39,8,3,0,0,0,0,0,0,74,57,131
20211124,24NOV2021:00:00:00,UFU FERNANDEZ,84,74,137,16,5,158,152,6,152,6,0,4,52,39,27,11,20,5,0,5,88,59,152
20211124,24NOV2021:00:00:00,UFU FERRER,90,50,78,53,9,140,140,0,140,0,0,5,22,36,37,13,20,7,0,1,106,33,140
20211124,24NOV2021:00:00:00,UFU GRIERSON,114,90,128,65,11,204,196,8,202,2,2,32,31,73,23,31,7,5,0,10,135,51,196
20211124,24NOV2021:00:00:00,UFU GUTIERREZ,125,93,133,80,5,218,194,24,210,8,144,50,7,4,5,5,3,0,0,2,102,90,194
20211124,24NOV2021:00:00:00,UFU MUÑIZ,157,143,124,151,25,300,264,36,266,34,27,20,43,77,44,60,12,17,0,3,182,70,264
20211124,24NOV2021:00:00:00,UFU PENNA,69,40,50,49,10,109,97,12,99,10,29,19,20,14,8,6,7,6,0,2,67,28,97
20211124,24NOV2021:00:00:00,UFU PIROVANO,204,122,268,35,23,326,302,24,318,8,1,13,67,88,67,48,22,20,0,7,173,122,302
20211124,24NOV2021:00:00:00,UFU PIÑERO,139,139,218,35,25,278,270,8,270,8,81,30,45,47,17,39,10,9,0,3,200,64,270
20211124,24NOV2021:00:00:00,UFU RAMOS MEJIA,128,81,150,36,23,209,183,26,183,26,10,8,43,48,45,27,15,13,0,3,96,84,183
20211124,24NOV2021:00:00:00,UFU RIVADAVIA,154,86,166,48,26,240,208,32,218,22,0,3,55,69,52,27,23,11,0,5,120,83,208
20211124,24NOV2021:00:00:00,UFU SANTOJANNI,143,101,149,80,15,244,226,18,238,6,3,28,37,47,55,28,29,17,0,7,129,90,226
20211124,24NOV2021:00:00:00,UFU TORNU,131,109,213,25,2,240,194,46,194,46,11,28,46,40,52,39,12,12,0,15,115,64,194
20211124,24NOV2021:00:00:00,UFU VELEZ SARSFIELD,161,132,230,53,10,293,267,26,291,2,0,16,65,74,59,40,28,11,0,13,176,78,267
20211124,24NOV2021:00:00:00,UFU ZUBIZARRETA,121,126,158,66,23,247,243,4,245,2,0,24,57,63,45,22,21,15,0,5,178,60,243
20211125,25NOV2021:00:00:00,UFU ALVAREZ,186,159,269,35,41,345,329,16,331,14,27,34,51,82,48,38,35,30,0,4,231,94,329
20211125,25NOV2021:00:00:00,UFU ARGERICH,60,45,71,32,2,105,93,12,93,12,4,3,24,28,21,14,9,2,0,2,49,42,93
20211125,25NOV2021:00:00:00,UFU BORDA-MOYANO,49,32,46,28,7,81,71,10,71,10,2,2,30,14,11,18,2,2,0,0,45,26,71
20211125,25NOV2021:00:00:00,UFU DURAND,129,117,226,11,9,246,220,26,222,24,26,21,50,58,45,19,22,5,0,11,127,82,220
20211125,25NOV2021:00:00:00,UFU ELIZALDE,87,79,42,123,1,166,148,18,158,8,128,28,2,6,0,2,0,0,0,0,78,70,148
20211125,25NOV2021:00:00:00,UFU FERNANDEZ,79,64,111,23,9,143,125,18,135,8,0,2,40,33,32,10,18,8,0,6,72,47,125
20211125,25NOV2021:00:00:00,UFU FERRER,62,48,62,43,5,110,101,9,105,5,0,3,27,34,29,10,4,3,0,7,73,21,101
20211125,25NOV2021:00:00:00,UFU GRIERSON,104,107,142,57,12,211,195,16,209,2,0,6,45,44,43,41,19,13,0,7,124,64,195
20211125,25NOV2021:00:00:00,UFU GUTIERREZ,79,85,89,71,4,164,150,14,156,8,111,30,7,7,4,5,0,0,0,2,92,56,150
20211125,25NOV2021:00:00:00,UFU MUÑIZ,147,129,161,92,23,276,228,48,236,40,13,35,62,65,32,34,22,13,0,8,152,68,228
20211125,25NOV2021:00:00:00,UFU PENNA,70,48,76,36,6,118,106,12,108,10,10,13,22,20,18,22,11,2,0,0,79,27,106
20211125,25NOV2021:00:00:00,UFU PIROVANO,175,145,258,37,25,320,308,12,314,6,0,15,48,91,81,38,26,21,0,14,168,126,308
20211125,25NOV2021:00:00:00,UFU PIÑERO,76,43,95,19,5,119,111,8,111,8,20,26,15,15,18,11,9,5,0,5,77,28,111
20211125,25NOV2021:00:00:00,UFU RAMOS MEJIA,91,80,144,13,14,171,163,8,165,6,0,12,35,47,40,14,15,8,0,9,84,70,163
20211125,25NOV2021:00:00:00,UFU RIVADAVIA,154,86,184,35,21,240,178,62,188,52,0,13,55,50,49,36,17,20,0,4,98,76,178
20211125,25NOV2021:00:00:00,UFU SANTOJANNI,130,101,144,73,14,231,219,12,231,0,0,15,27,57,59,29,25,19,0,16,119,84,219
20210701,01JUL2021:00:00:00,UFU RAMOS MEJIA,145,88,172,33,28,233,217,16,223,10,14,6,59,71,47,24,4,8,0,22,122,73,217
20210701,01JUL2021:00:00:00,UFU RIVADAVIA,100,89,126,51,12,189,183,6,187,2,0,2,69,45,40,20,11,2,0,28,80,75,183
20210701,01JUL2021:00:00:00,UFU SANTOJANNI,207,180,196,182,9,387,375,12,381,6,10,45,78,106,84,44,15,5,0,40,232,103,375
20210701,01JUL2021:00:00:00,UFU TORNU,172,125,235,50,12,297,281,16,283,14,13,11,57,75,62,45,17,17,0,18,177,82,281
20210701,01JUL2021:00:00:00,UFU VELEZ SARSFIELD,114,118,178,33,21,232,224,8,230,2,0,6,60,82,45,20,16,3,0,22,141,61,224
20210701,01JUL2021:00:00:00,UFU ZUBIZARRETA,84,44,73,46,9,128,128,0,128,0,0,3,22,55,21,18,8,1,0,9,85,34,128
20210702,02JUL2021:00:00:00,UFU ALVAREZ,147,139,212,65,9,286,272,14,272,14,18,9,78,63,47,32,22,17,0,38,150,84,272
20210702,02JUL2021:00:00:00,UFU ARGERICH,70,45,74,33,8,115,93,22,95,20,7,3,16,34,26,10,11,8,0,8,45,38,93
20210702,02JUL2021:00:00:00,UFU BORDA-MOYANO,50,34,39,37,8,84,82,2,82,2,1,0,14,15,27,14,6,7,0,7,50,25,82
20210702,02JUL2021:00:00:00,UFU DURAND,80,68,117,19,12,148,136,12,136,12,2,4,30,55,26,13,13,5,0,19,61,56,136
20210702,02JUL2021:00:00:00,UFU ELIZALDE,105,64,74,87,8,169,151,18,157,12,78,62,4,12,10,1,2,0,0,8,104,39,151
20210702,02JUL2021:00:00:00,UFU FERNANDEZ,110,82,137,38,17,192,178,14,182,10,0,11,48,61,30,22,10,10,0,18,87,73,178
20210702,02JUL2021:00:00:00,UFU FERRER,116,82,99,84,15,198,188,10,188,10,0,0,51,64,48,22,9,4,0,16,119,53,188
20210702,02JUL2021:00:00:00,UFU GRIERSON,144,109,126,118,9,253,235,18,247,6,0,15,65,60,66,24,12,11,0,20,140,73,235
20210702,02JUL2021:00:00:00,UFU GUTIERREZ,111,131,172,50,20,242,228,14,238,4,88,43,27,49,17,15,0,3,0,16,153,59,228
20210702,02JUL2021:00:00:00,UFU MUÑIZ,117,178,134,141,20,295,237,58,267,28,2,7,86,82,50,41,22,5,0,17,162,58,237
20210702,02JUL2021:00:00:00,UFU PENNA,66,66,94,31,7,132,122,10,130,2,0,9,26,36,24,22,10,5,0,15,70,37,122
20210702,02JUL2021:00:00:00,UFU PIROVANO,129,116,200,28,17,245,225,20,241,4,0,9,68,66,39,30,17,16,0,28,108,89,225
20210702,02JUL2021:00:00:00,UFU PIÑERO,89,58,104,38,5,147,141,6,145,2,2,13,38,29,30,22,11,2,0,16,93,32,141
20210702,02JUL2021:00:00:00,UFU RAMOS MEJIA,165,118,190,66,27,283,248,35,270,13,13,17,61,77,41,45,11,18,0,31,119,98,248
20210702,02JUL2021:00:00:00,UFU RIVADAVIA,122,83,136,39,30,205,195,10,197,8,0,3,60,55,41,21,13,12,0,26,82,87,195
20210702,02JUL2021:00:00:00,UFU SANTOJANNI,131,138,140,116,13,269,239,30,261,8,13,18,63,70,35,36,26,8,0,30,151,58,239
20210702,02JUL2021:00:00:00,UFU TORNU,139,100,188,33,18,239,219,20,225,14,14,17,41,74,42,19,28,4,0,15,151,51,219
20210702,02JUL2021:00:00:00,UFU VELEZ SARSFIELD,122,125,184,52,11,247,235,12,243,4,0,12,50,64,55,38,20,8,0,22,146,67,235
20210702,02JUL2021:00:00:00,UFU ZUBIZARRETA,68,40,51,40,17,108,108,0,108,0,0,3,30,37,13,7,16,2,0,13,66,29,108
20210703,03JUL2021:00:00:00,UFU ALVAREZ,202,141,291,37,15,343,323,20,323,20,34,33,85,77,50,34,14,16,0,25,203,95,323
20210703,03JUL2021:00:00:00,UFU BORDA-MOYANO,90,25,99,14,2,115,107,8,107,8,0,2,19,19,18,18,25,14,0,0,69,38,107
20210703,03JUL2021:00:00:00,UFU DURAND,69,62,115,14,2,131,127,4,127,4,1,4,30,45,25,15,4,7,0,19,58,50,127
20210703,03JUL2021:00:00:00,UFU ELIZALDE,113,78,89,97,5,191,175,16,191,0,100,54,7,13,13,4,0,0,0,9,114,52,175
20210703,03JUL2021:00:00:00,UFU FERNANDEZ,71,56,97,24,6,127,111,16,123,4,0,2,29,46,22,11,13,4,0,19,46,46,111
20210703,03JUL2021:00:00:00,UFU FERRER,97,60,62,87,8,157,151,6,151,6,0,3,29,47,42,20,13,3,0,23,86,42,151
20210703,03JUL2021:00:00:00,UFU GRIERSON,137,98,101,100,34,235,223,12,225,10,0,13,43,82,63,16,8,10,0,24,117,81,223
20210703,03JUL2021:00:00:00,UFU GUTIERREZ,139,104,169,61,13,243,231,12,235,8,85,36,44,22,30,20,4,2,0,14,149,66,231
20210703,03JUL2021:00:00:00,UFU MUÑIZ,104,144,62,176,10,248,194,54,204,44,0,7,79,61,32,38,22,9,0,29,118,47,194
20210703,03JUL2021:00:00:00,UFU PENNA,40,28,50,16,2,68,58,10,62,6,12,0,18,14,11,5,7,1,0,6,35,17,58
20210703,03JUL2021:00:00:00,UFU PIROVANO,147,133,213,41,26,280,255,25,273,7,0,14,47,90,63,28,29,9,0,35,116,104,255
20210703,03JUL2021:00:00:00,UFU PIÑERO,87,80,111,53,3,167,165,2,165,2,0,4,47,54,36,17,7,2,0,19,104,41,165
20210703,03JUL2021:00:00:00,UFU RAMOS MEJIA,92,67,115,26,18,159,123,36,131,28,6,11,35,45,27,17,7,11,0,11,66,46,123
20210703,03JUL2021:00:00:00,UFU RIVADAVIA,127,70,149,32,16,197,189,8,189,8,0,9,60,64,37,13,8,6,0,20,88,80,189
20210703,03JUL2021:00:00:00,UFU SANTOJANNI,221,181,198,198,6,402,388,14,398,4,0,24,86,114,70,46,38,24,0,33,253,102,388
20210703,03JUL2021:00:00:00,UFU TORNU,101,59,117,30,13,160,150,10,150,10,0,8,36,33,17,30,23,13,0,13,95,42,150
20210703,03JUL2021:00:00:00,UFU VELEZ SARSFIELD,160,117,199,71,7,277,273,4,275,2,0,3,50,98,59,34,21,12,0,39,150,84,273
20210703,03JUL2021:00:00:00,UFU ZUBIZARRETA,185,116,185,110,6,301,297,4,301,0,0,17,68,72,68,40,21,15,0,28,181,88,297
20210704,04JUL2021:00:00:00,UFU ALVAREZ,147,135,238,25,19,282,270,12,272,10,17,26,59,69,33,34,21,23,0,27,170,73,270
20210704,04JUL2021:00:00:00,UFU ARGERICH,37,39,38,29,9,76,66,10,76,0,0,5,13,16,18,7,15,2,0,12,26,27,66
20210704,04JUL2021:00:00:00,UFU BORDA-MOYANO,27,23,23,23,4,50,46,4,46,4,0,8,10,13,6,8,5,0,0,2,27,17,46
20210704,04JUL2021:00:00:00,UFU DURAND,97,83,150,18,12,180,164,16,164,16,2,3,37,67,23,26,14,8,0,28,74,62,164
20210704,04JUL2021:00:00:00,UFU ELIZALDE,92,53,67,75,3,145,127,18,143,2,51,54,6,22,8,4,0,0,0,10,77,40,127
20210704,04JUL2021:00:00:00,UFU FERNANDEZ,32,38,62,8,0,70,68,2,68,2,0,0,16,20,17,7,3,7,0,11,28,29,68
20210704,04JUL2021:00:00:00,UFU FERRER,71,41,57,52,3,112,112,0,112,0,0,0,18,36,21,24,7,6,0,15,65,32,112
20210704,04JUL2021:00:00:00,UFU GRIERSON,93,102,119,37,39,195,187,8,187,8,1,16,44,40,47,32,14,1,0,19,121,47,187
20210704,04JUL2021:00:00:00,UFU GUTIERREZ,145,88,147,68,18,233,216,17,222,11,56,47,53,41,24,9,3,0,0,14,139,63,216
20210704,04JUL2021:00:00:00,UFU MUÑIZ,127,118,112,127,6,245,207,38,211,34,0,9,60,65,61,26,23,1,0,17,142,48,207
20210704,04JUL2021:00:00:00,UFU PENNA,31,28,42,11,6,59,47,12,51,8,0,2,17,16,8,14,0,2,0,6,28,13,47
20210704,04JUL2021:00:00:00,UFU PIROVANO,137,88,168,38,19,225,201,24,213,12,4,6,50,54,60,26,19,6,0,33,87,81,201
20210704,04JUL2021:00:00:00,UFU PIÑERO,68,50,83,30,5,118,112,6,112,6,0,0,30,37,21,17,11,2,0,12,71,28,112
20210704,04JUL2021:00:00:00,UFU RAMOS MEJIA,136,112,177,45,26,248,232,16,238,10,17,16,42,90,29,33,12,9,0,27,122,83,232
20210704,04JUL2021:00:00:00,UFU RIVADAVIA,70,71,106,27,8,141,129,12,131,10,0,7,36,27,29,21,15,6,0,22,52,55,129
20210704,04JUL2021:00:00:00,UFU SANTOJANNI,145,143,143,133,12,288,274,14,284,4,3,14,49,69,75,44,22,12,0,25,171,78,274
20210704,04JUL2021:00:00:00,UFU TORNU,109,68,129,34,14,177,169,8,169,8,7,20,26,28,44,31,12,9,0,11,113,45,169
20210704,04JUL2021:00:00:00,UFU VELEZ SARSFIELD,111,124,169,58,8,235,229,6,235,0,0,10,57,46,51,39,31,1,0,29,136,64,229
20210704,04JUL2021:00:00:00,UFU ZUBIZARRETA,81,63,84,59,1,144,144,0,144,0,0,8,36,32,24,13,24,7,0,14,86,44,144
20210705,05JUL2021:00:00:00,UFU ALVAREZ,192,150,254,60,28,342,324,18,326,16,24,28,96,91,50,43,7,3,0,24,217,83,324
20210705,05JUL2021:00:00:00,UFU ARGERICH,87,64,76,68,7,151,147,4,147,4,9,18,36,29,27,18,8,6,0,15,71,59,147
20210705,05JUL2021:00:00:00,UFU BORDA-MOYANO,91,39,73,53,4,130,126,4,126,4,0,8,34,23,33,23,6,3,0,5,74,47,126
20210825,25AUG2021:00:00:00,UFU ARGERICH,110,62,104,66,2,172,154,18,154,18,56,18,23,28,14,24,6,3,0,4,74,74,154
20210825,25AUG2021:00:00:00,UFU BORDA-MOYANO,31,35,32,27,7,66,64,2,64,2,0,15,13,6,15,15,2,0,0,3,42,19,64
20210825,25AUG2021:00:00:00,UFU DURAND,147,120,233,19,15,267,263,4,263,4,31,20,50,70,41,31,18,6,0,8,144,111,263
20210825,25AUG2021:00:00:00,UFU ELIZALDE,166,107,103,161,9,273,245,28,251,22,169,65,6,19,14,0,0,0,0,0,143,102,245
20210825,25AUG2021:00:00:00,UFU FERNANDEZ,130,81,160,38,13,211,189,22,193,18,0,14,45,58,41,25,19,9,0,4,120,64,189
20210825,25AUG2021:00:00:00,UFU FERRER,128,71,109,81,9,199,189,10,191,8,0,3,41,49,53,18,23,12,0,6,131,52,189
20210825,25AUG2021:00:00:00,UFU GRIERSON,154,118,180,84,8,272,270,2,270,2,3,32,60,64,73,27,10,3,0,4,196,69,270
20210825,25AUG2021:00:00:00,UFU GUTIERREZ,224,171,255,138,2,395,351,44,383,12,276,71,8,23,6,5,6,0,0,3,227,121,351
20210825,25AUG2021:00:00:00,UFU MUÑIZ,170,151,171,134,16,321,261,60,263,58,9,26,68,86,62,28,27,15,0,3,183,75,261
20210825,25AUG2021:00:00:00,UFU PENNA,103,79,89,89,4,182,180,2,180,2,12,14,47,33,37,21,15,3,0,4,122,54,180
20210825,25AUG2021:00:00:00,UFU PIROVANO,163,152,240,30,45,315,273,42,303,12,0,12,85,72,66,45,19,16,0,24,137,112,273
20210825,25AUG2021:00:00:00,UFU PIÑERO,124,95,181,25,13,219,209,10,213,6,2,22,39,43,56,21,22,14,0,3,153,52,209
20210825,25AUG2021:00:00:00,UFU RAMOS MEJIA,234,137,271,51,49,371,331,40,351,20,28,37,57,96,78,39,19,17,0,7,231,93,331
20210825,25AUG2021:00:00:00,UFU RIVADAVIA,179,97,210,44,22,276,202,74,202,74,4,27,80,60,46,44,10,5,0,10,111,81,202
20210825,25AUG2021:00:00:00,UFU SANTOJANNI,290,232,315,170,37,522,514,8,520,2,49,41,101,122,101,46,44,18,0,9,374,131,514
20210825,25AUG2021:00:00:00,UFU TORNU,264,179,357,58,28,443,347,96,349,94,49,65,43,92,96,52,16,30,0,2,245,96,347
20210825,25AUG2021:00:00:00,UFU VELEZ SARSFIELD,221,194,317,74,24,415,389,26,411,4,2,48,75,76,104,52,35,23,0,7,279,103,389
20210825,25AUG2021:00:00:00,UFU ZUBIZARRETA,51,45,54,26,16,96,94,2,96,0,0,14,16,23,20,12,11,0,0,6,60,28,94
20210826,26AUG2021:00:00:00,UFU ALVAREZ,138,121,198,44,17,259,241,18,251,8,66,11,53,41,42,21,12,13,0,4,139,98,241
20210826,26AUG2021:00:00:00,UFU ARGERICH,72,56,75,53,0,128,110,18,110,18,17,11,31,30,15,14,6,4,0,3,61,46,110
20210826,26AUG2021:00:00:00,UFU BORDA-MOYANO,35,47,67,14,1,82,76,6,76,6,7,12,5,21,22,6,9,0,0,0,51,25,76
20210826,26AUG2021:00:00:00,UFU DURAND,152,134,254,23,9,286,264,22,266,20,20,27,71,88,35,29,12,4,0,7,150,107,264
20210826,26AUG2021:00:00:00,UFU ELIZALDE,209,215,171,243,10,424,322,102,410,14,293,95,13,11,9,3,0,0,0,1,193,128,322
20210826,26AUG2021:00:00:00,UFU FERNANDEZ,118,83,171,16,14,201,185,16,191,10,0,19,56,46,32,23,12,13,0,4,112,69,185
20210826,26AUG2021:00:00:00,UFU FERRER,114,88,105,89,8,202,196,6,198,4,0,0,57,69,30,15,16,15,0,2,145,49,196
20210826,26AUG2021:00:00:00,UFU GRIERSON,138,99,141,69,27,237,233,4,235,2,0,35,64,46,34,36,12,10,0,5,167,59,233
20210826,26AUG2021:00:00:00,UFU GUTIERREZ,232,196,304,121,3,428,378,50,424,4,283,101,10,21,7,6,0,0,0,0,259,119,378
20210826,26AUG2021:00:00:00,UFU MUÑIZ,176,142,192,109,17,318,247,71,259,59,2,23,72,69,42,55,41,14,0,0,180,67,247
20210826,26AUG2021:00:00:00,UFU PENNA,100,64,87,74,3,164,158,6,158,6,6,3,46,42,29,20,10,8,0,4,112,42,158
20210826,26AUG2021:00:00:00,UFU PIROVANO,187,146,273,25,35,333,311,22,325,8,0,26,65,101,67,41,23,10,0,23,158,130,311
20210826,26AUG2021:00:00:00,UFU PIÑERO,133,77,179,20,11,210,208,2,208,2,2,17,57,45,41,25,17,6,0,4,148,54,208
20210826,26AUG2021:00:00:00,UFU RAMOS MEJIA,186,126,236,55,21,312,296,16,302,10,13,30,63,74,60,28,29,15,0,3,204,89,296
20210826,26AUG2021:00:00:00,UFU RIVADAVIA,180,104,201,39,44,284,252,32,256,28,2,14,85,78,33,39,22,11,0,4,154,94,252
20210826,26AUG2021:00:00:00,UFU SANTOJANNI,242,185,260,158,9,427,423,4,425,2,37,47,97,81,68,42,40,15,0,10,313,100,423
20210826,26AUG2021:00:00:00,UFU TORNU,222,169,314,54,23,391,333,58,333,58,25,46,92,68,84,34,33,9,0,10,227,96,333
20210826,26AUG2021:00:00:00,UFU VELEZ SARSFIELD,179,138,236,65,16,317,307,10,315,2,0,17,68,69,83,42,20,18,0,11,209,87,307
20210826,26AUG2021:00:00:00,UFU ZUBIZARRETA,61,51,87,25,0,112,110,2,112,0,0,19,22,22,32,8,9,0,0,3,77,30,110
20210827,27AUG2021:00:00:00,UFU ALVAREZ,149,185,277,33,24,334,302,32,304,30,84,35,56,75,44,22,8,10,0,2,203,97,302
20210827,27AUG2021:00:00:00,UFU ARGERICH,71,40,66,41,4,111,73,38,73,38,27,23,14,31,11,2,2,1,0,4,44,25,73
20210827,27AUG2021:00:00:00,UFU BORDA-MOYANO,30,30,25,32,3,60,60,0,60,0,2,2,8,6,22,15,5,0,0,1,39,20,60
20210827,27AUG2021:00:00:00,UFU DURAND,156,89,215,15,15,245,233,12,233,12,0,15,51,61,55,39,15,9,0,6,129,98,233
20210827,27AUG2021:00:00:00,UFU ELIZALDE,131,120,95,154,2,251,195,56,205,46,164,64,5,7,1,10,0,0,0,1,123,71,195
20210827,27AUG2021:00:00:00,UFU FERNANDEZ,169,107,222,39,15,276,254,22,258,18,0,8,78,57,60,42,20,11,0,8,173,73,254
20210827,27AUG2021:00:00:00,UFU FERRER,124,76,107,87,6,200,188,12,194,6,0,0,37,69,46,22,21,5,0,2,134,52,188
20210827,27AUG2021:00:00:00,UFU GRIERSON,124,98,146,65,11,222,210,12,216,6,0,31,67,53,28,21,13,9,0,5,153,52,210
20210827,27AUG2021:00:00:00,UFU GUTIERREZ,217,156,250,119,4,373,365,8,373,0,268,72,9,10,14,0,0,0,0,2,257,106,365
20210827,27AUG2021:00:00:00,UFU MUÑIZ,149,148,149,139,9,297,229,68,249,48,0,42,63,73,50,51,13,5,0,4,155,70,229
20210827,27AUG2021:00:00:00,UFU PENNA,99,59,76,73,9,158,142,16,150,8,3,28,45,26,23,23,5,5,0,1,100,41,142
20210827,27AUG2021:00:00:00,UFU PIROVANO,211,145,310,25,21,356,346,10,352,4,0,13,74,113,84,31,33,8,0,13,191,142,346
20210827,27AUG2021:00:00:00,UFU PIÑERO,117,80,146,44,7,197,193,4,193,4,2,35,30,52,35,26,6,11,0,3,141,49,193
20210827,27AUG2021:00:00:00,UFU RAMOS MEJIA,235,160,272,86,37,395,375,20,389,6,33,22,70,117,61,37,30,25,0,1,258,115,375
20210827,27AUG2021:00:00:00,UFU RIVADAVIA,185,113,217,51,30,298,288,10,288,10,1,30,89,63,45,31,30,9,0,14,156,118,288
20210827,27AUG2021:00:00:00,UFU SANTOJANNI,293,199,297,175,20,492,466,26,486,6,61,64,97,81,76,51,43,19,0,3,351,112,466
20210827,27AUG2021:00:00:00,UFU TORNU,226,171,317,60,20,397,337,60,339,58,37,54,52,82,88,42,27,15,0,6,176,152,337
20210827,27AUG2021:00:00:00,UFU VELEZ SARSFIELD,172,163,277,46,12,335,329,6,331,4,0,16,90,76,71,38,22,22,0,5,227,97,329
20210827,27AUG2021:00:00:00,UFU ZUBIZARRETA,139,107,137,88,21,246,240,6,246,0,0,31,40,73,26,34,20,22,0,7,173,60,240
20210828,28AUG2021:00:00:00,UFU ALVAREZ,147,104,210,27,16,253,231,22,233,20,25,3,37,73,59,27,15,14,0,6,151,74,231
20210828,28AUG2021:00:00:00,UFU ARGERICH,3,0,2,1,0,3,3,0,3,0,0,0,1,0,0,2,0,0,0,0,2,1,3
20210828,28AUG2021:00:00:00,UFU BORDA-MOYANO,47,7,42,12,0,54,46,8,46,8,0,2,13,13,9,13,4,0,0,1,31,14,46
20210828,28AUG2021:00:00:00,UFU DURAND,116,77,165,17,11,193,177,16,177,16,2,13,33,63,43,14,17,8,0,8,93,76,177
20210828,28AUG2021:00:00:00,UFU ELIZALDE,112,91,78,121,6,205,169,36,183,22,136,42,11,4,8,4,0,0,0,2,104,63,169
20210828,28AUG2021:00:00:00,UFU FERNANDEZ,74,51,108,7,10,125,105,20,115,10,0,6,24,28,18,24,11,14,0,6,58,40,105
20210828,28AUG2021:00:00:00,UFU FERRER,127,67,107,81,8,196,180,16,184,12,2,6,25,90,33,25,15,0,0,8,129,43,180
20210828,28AUG2021:00:00:00,UFU GRIERSON,147,62,115,69,27,211,201,10,203,8,4,13,34,56,55,23,24,2,0,6,144,51,201
20211018,18OCT2021:00:00:00,UFU ZUBIZARRETA,181,137,192,92,34,318,306,12,318,0,0,38,83,62,64,39,17,15,0,0,220,86,306
20211019,19OCT2021:00:00:00,UFU ALVAREZ,198,155,275,45,33,353,243,110,247,106,48,35,98,50,39,45,17,21,0,1,173,69,243
20211019,19OCT2021:00:00:00,UFU ARGERICH,73,57,65,49,16,130,48,82,58,72,42,21,14,26,10,9,4,4,0,2,29,17,48
20211019,19OCT2021:00:00:00,UFU BORDA-MOYANO,17,6,17,4,2,23,19,4,19,4,0,2,8,0,6,2,0,5,0,0,11,8,19
20211019,19OCT2021:00:00:00,UFU DURAND,129,115,197,23,24,244,122,122,150,94,21,25,45,55,37,17,23,21,0,2,70,49,122
20211019,19OCT2021:00:00:00,UFU ELIZALDE,154,142,85,178,33,296,120,176,192,104,215,65,2,5,7,2,0,0,0,0,91,29,120
20211019,19OCT2021:00:00:00,UFU FERNANDEZ,102,73,136,14,25,175,93,82,95,80,0,6,36,60,28,20,14,11,0,1,60,32,93
20211019,19OCT2021:00:00:00,UFU FERRER,72,45,66,28,23,117,45,72,45,72,0,1,39,26,21,17,7,6,0,0,31,14,45
20211019,19OCT2021:00:00:00,UFU GRIERSON,59,81,78,39,23,140,78,62,78,62,0,42,23,21,25,11,11,7,0,0,57,21,78
20211019,19OCT2021:00:00:00,UFU GUTIERREZ,156,170,177,115,36,328,182,146,220,108,228,70,15,6,2,7,0,0,0,0,113,69,182
20211019,19OCT2021:00:00:00,UFU MUÑIZ,109,103,102,83,29,214,110,104,118,96,4,14,34,62,52,24,15,9,0,1,75,34,110
20211019,19OCT2021:00:00:00,UFU PENNA,53,88,74,59,12,145,83,62,87,58,49,31,12,20,10,12,9,2,0,0,58,25,83
20211019,19OCT2021:00:00:00,UFU PIROVANO,174,120,225,35,36,296,196,100,200,96,2,26,67,64,78,26,19,14,0,2,116,77,196
20211019,19OCT2021:00:00:00,UFU PIÑERO,120,121,171,55,15,241,163,78,163,78,68,38,33,38,31,13,15,5,0,0,119,44,163
20211019,19OCT2021:00:00:00,UFU RAMOS MEJIA,106,88,116,48,30,194,114,80,114,80,4,12,58,38,30,20,20,12,0,2,65,47,114
20211019,19OCT2021:00:00:00,UFU RIVADAVIA,112,69,121,28,32,181,115,66,115,66,0,10,59,35,35,15,17,10,0,1,67,47,115
20211019,19OCT2021:00:00:00,UFU SANTOJANNI,98,61,95,47,19,161,87,74,89,72,2,23,26,38,36,14,12,10,0,0,53,34,87
20211019,19OCT2021:00:00:00,UFU TORNU,241,126,282,58,27,367,205,162,211,156,69,50,42,76,67,37,10,16,0,7,129,66,205
20211019,19OCT2021:00:00:00,UFU VELEZ SARSFIELD,113,107,154,42,24,220,138,82,142,78,0,17,32,65,55,25,13,13,0,1,94,43,138
20211019,19OCT2021:00:00:00,UFU ZUBIZARRETA,150,113,164,85,14,263,263,0,263,0,0,22,57,63,56,37,24,4,0,2,191,70,263
20211020,20OCT2021:00:00:00,UFU ALVAREZ,238,137,282,71,22,375,331,44,357,18,55,36,88,84,32,36,29,15,0,6,226,99,331
20211020,20OCT2021:00:00:00,UFU ARGERICH,44,41,64,19,2,85,71,14,73,12,10,11,9,19,10,5,10,11,0,0,40,31,71
20211020,20OCT2021:00:00:00,UFU BORDA-MOYANO,24,16,18,16,6,40,32,8,32,8,0,4,11,9,8,6,0,2,0,0,18,14,32
20211020,20OCT2021:00:00:00,UFU DURAND,133,83,177,22,17,216,192,24,210,6,11,24,48,39,39,33,11,11,0,4,112,76,192
20211020,20OCT2021:00:00:00,UFU ELIZALDE,127,145,96,165,11,272,218,54,236,36,202,59,3,2,0,6,0,0,0,0,148,70,218
20211020,20OCT2021:00:00:00,UFU FERNANDEZ,93,72,128,21,16,165,151,14,153,12,0,4,46,52,20,17,12,14,0,1,90,60,151
20211020,20OCT2021:00:00:00,UFU FERRER,53,30,25,56,2,83,81,2,81,2,0,5,17,29,20,9,3,0,0,2,60,19,81
20211020,20OCT2021:00:00:00,UFU GRIERSON,122,55,130,24,23,177,139,38,171,6,0,24,47,48,19,18,7,14,0,2,100,37,139
20211020,20OCT2021:00:00:00,UFU GUTIERREZ,146,151,172,118,7,297,281,16,297,0,206,68,7,12,0,4,0,0,0,2,186,91,281
20211020,20OCT2021:00:00:00,UFU MUÑIZ,94,91,79,99,7,185,159,26,159,26,2,17,34,38,35,42,10,7,0,1,109,49,159
20211020,20OCT2021:00:00:00,UFU PENNA,69,63,64,65,3,132,126,6,126,6,39,28,19,18,10,5,11,2,0,6,84,36,126
20211020,20OCT2021:00:00:00,UFU PIROVANO,150,157,234,42,31,307,303,4,305,2,0,20,88,85,49,42,14,9,0,8,173,122,303
20211020,20OCT2021:00:00:00,UFU PIÑERO,145,82,194,17,16,227,213,14,215,12,86,38,33,26,19,9,8,8,0,1,157,55,213
20211020,20OCT2021:00:00:00,UFU RAMOS MEJIA,108,106,143,41,30,214,170,44,184,30,16,12,40,63,29,26,15,13,0,2,99,69,170
20211020,20OCT2021:00:00:00,UFU RIVADAVIA,167,109,192,32,52,276,218,58,218,58,0,19,95,63,32,30,23,14,0,8,121,89,218
20211020,20OCT2021:00:00:00,UFU SANTOJANNI,103,106,121,78,10,209,197,12,203,6,4,45,38,52,23,14,24,9,0,2,112,83,197
20211020,20OCT2021:00:00:00,UFU TORNU,203,130,272,38,23,333,287,46,289,44,27,65,43,58,46,50,17,27,0,7,185,93,287
20211020,20OCT2021:00:00:00,UFU VELEZ SARSFIELD,178,138,236,51,29,316,282,34,308,8,0,27,67,67,55,41,45,14,0,4,198,80,282
20211020,20OCT2021:00:00:00,UFU ZUBIZARRETA,21,5,19,7,0,26,14,12,26,0,0,3,7,2,2,4,5,3,0,0,10,4,14
20211021,21OCT2021:00:00:00,UFU ALVAREZ,178,149,238,65,24,327,303,24,307,20,55,37,58,75,47,19,13,23,0,2,216,85,303
20211021,21OCT2021:00:00:00,UFU ARGERICH,46,45,54,28,9,91,77,14,77,14,12,30,7,20,8,5,7,2,0,0,46,31,77
20211021,21OCT2021:00:00:00,UFU BORDA-MOYANO,49,42,54,27,10,91,79,12,79,12,0,2,30,21,11,17,9,1,0,0,51,28,79
20211021,21OCT2021:00:00:00,UFU DURAND,121,64,156,10,19,185,177,8,177,8,11,9,29,82,23,15,13,3,0,8,101,68,177
20211021,21OCT2021:00:00:00,UFU ELIZALDE,142,107,91,155,3,249,229,20,235,14,180,55,3,5,3,0,3,0,0,5,141,83,229
20211021,21OCT2021:00:00:00,UFU FERNANDEZ,87,49,102,14,20,136,130,6,134,2,0,4,36,40,16,19,14,7,0,3,71,56,130
20211021,21OCT2021:00:00:00,UFU FERRER,83,59,69,66,7,142,136,6,136,6,0,8,26,47,39,13,5,4,0,3,95,38,136
20211021,21OCT2021:00:00:00,UFU GRIERSON,119,127,146,61,39,246,228,18,238,8,0,32,64,37,47,41,20,5,0,2,174,52,228
20211021,21OCT2021:00:00:00,UFU GUTIERREZ,158,137,154,127,14,295,271,24,285,10,209,55,13,6,7,1,2,2,0,0,186,85,271
20211021,21OCT2021:00:00:00,UFU MUÑIZ,112,66,73,96,9,178,130,48,136,42,1,14,34,33,52,31,9,4,0,0,83,47,130
20211021,21OCT2021:00:00:00,UFU PENNA,64,61,70,53,2,125,115,10,123,2,49,24,11,14,10,6,10,1,0,5,82,28,115
20211021,21OCT2021:00:00:00,UFU PIROVANO,174,131,229,38,38,305,283,22,297,8,0,14,58,117,41,31,23,21,0,11,160,112,283
20211021,21OCT2021:00:00:00,UFU PIÑERO,151,84,187,42,6,235,225,10,225,10,66,40,30,35,12,16,25,11,0,4,172,49,225
20211021,21OCT2021:00:00:00,UFU RAMOS MEJIA,80,67,105,17,25,147,109,38,113,34,4,8,33,39,11,28,14,10,0,4,62,43,109
20211021,21OCT2021:00:00:00,UFU RIVADAVIA,102,86,113,41,34,188,150,38,150,38,4,4,69,45,21,17,21,7,0,2,90,58,150
20211021,21OCT2021:00:00:00,UFU SANTOJANNI,97,73,92,58,20,170,160,10,164,6,2,38,22,37,31,19,13,8,0,1,93,66,160
20211021,21OCT2021:00:00:00,UFU TORNU,136,118,209,30,15,254,206,48,210,44,20,41,36,64,39,28,7,19,0,7,142,54,206
20211021,21OCT2021:00:00:00,UFU VELEZ SARSFIELD,147,103,175,58,17,250,238,12,242,8,0,18,57,56,47,38,20,14,0,2,169,67,238
20211021,21OCT2021:00:00:00,UFU ZUBIZARRETA,93,91,128,48,8,184,184,0,184,0,0,20,38,55,16,27,5,23,0,8,130,46,184
20211022,22OCT2021:00:00:00,UFU ALVAREZ,176,101,213,48,16,277,227,50,235,42,62,23,54,45,52,16,13,12,0,0,161,66,227
20211022,22OCT2021:00:00:00,UFU ARGERICH,58,40,62,31,5,98,78,20,78,20,21,13,13,21,13,9,1,7,0,0,45,33,78
20211022,22OCT2021:00:00:00,UFU BORDA-MOYANO,19,31,35,13,2,50,44,6,44,6,2,2,5,15,14,5,5,2,0,0,27,17,44
20211022,22OCT2021:00:00:00,UFU DURAND,111,63,158,6,10,174,168,6,168,6,0,13,41,55,25,24,7,9,0,1,102,65,168
20211022,22OCT2021:00:00:00,UFU ELIZALDE,170,137,114,188,5,307,259,48,275,32,222,72,2,8,0,0,3,0,0,5,160,94,259
20211022,22OCT2021:00:00:00,UFU FERNANDEZ,88,30,105,6,7,118,110,8,114,4,0,2,27,35,18,14,18,4,0,0,67,43,110
20211022,22OCT2021:00:00:00,UFU FERRER,95,62,86,69,2,157,157,0,157,0,0,3,25,54,29,24,22,0,0,2,115,40,157
20211125,25NOV2021:00:00:00,UFU TORNU,140,107,203,30,14,247,221,26,223,24,12,25,31,74,47,20,21,17,0,18,136,67,221
20211125,25NOV2021:00:00:00,UFU VELEZ SARSFIELD,121,114,182,39,14,235,227,8,231,4,0,14,39,72,48,33,17,12,0,7,151,69,227
20211125,25NOV2021:00:00:00,UFU ZUBIZARRETA,119,112,169,56,6,231,229,2,229,2,0,12,52,66,50,23,16,12,0,6,163,60,229
20211126,26NOV2021:00:00:00,UFU ALVAREZ,194,120,254,48,12,314,282,32,294,20,15,25,58,76,62,45,17,16,0,9,178,95,282
20211126,26NOV2021:00:00:00,UFU ARGERICH,30,26,33,17,6,56,52,4,52,4,2,5,8,14,10,12,3,2,0,3,26,23,52
20211126,26NOV2021:00:00:00,UFU BORDA-MOYANO,19,26,34,9,2,45,41,4,41,4,4,2,3,17,3,0,13,3,0,1,27,13,41
20211126,26NOV2021:00:00:00,UFU DURAND,153,109,234,20,8,262,254,8,254,8,0,10,39,76,56,28,31,22,0,17,131,106,254
20211126,26NOV2021:00:00:00,UFU ELIZALDE,54,66,23,95,2,120,104,16,110,10,102,16,2,0,0,0,0,0,0,3,49,52,104
20211126,26NOV2021:00:00:00,UFU FERNANDEZ,137,90,197,21,9,227,197,30,219,8,0,5,58,82,27,13,18,24,0,15,113,69,197
20211126,26NOV2021:00:00:00,UFU FERRER,66,47,83,28,2,113,111,2,111,2,0,3,22,38,25,3,12,10,0,1,82,28,111
20211126,26NOV2021:00:00:00,UFU GRIERSON,92,63,97,44,14,155,149,6,149,6,0,4,38,33,40,21,12,7,0,1,110,37,149
20211126,26NOV2021:00:00:00,UFU GUTIERREZ,72,77,88,61,0,149,133,16,145,4,98,38,3,4,2,4,0,0,0,2,69,61,133
20211126,26NOV2021:00:00:00,UFU MUÑIZ,111,91,116,73,13,202,164,38,176,26,2,8,41,55,41,31,17,7,0,3,110,51,164
20211126,26NOV2021:00:00:00,UFU PENNA,63,58,77,40,4,121,117,4,117,4,20,10,18,35,17,5,13,3,0,3,86,28,117
20211126,26NOV2021:00:00:00,UFU PIROVANO,151,129,219,33,28,280,263,17,279,1,0,9,64,77,63,34,22,11,0,19,139,105,263
20211126,26NOV2021:00:00:00,UFU PIÑERO,106,68,128,37,9,174,160,14,164,10,37,11,31,40,24,25,6,0,0,2,117,41,160
20211126,26NOV2021:00:00:00,UFU RAMOS MEJIA,102,74,131,25,20,176,160,16,162,14,10,6,28,45,37,21,24,5,0,8,88,64,160
20211126,26NOV2021:00:00:00,UFU RIVADAVIA,87,31,86,16,16,118,84,34,88,30,0,1,39,31,13,14,16,4,0,4,46,34,84
20211126,26NOV2021:00:00:00,UFU SANTOJANNI,118,79,123,68,6,197,185,12,193,4,5,27,38,49,20,29,13,16,0,11,103,71,185
20211126,26NOV2021:00:00:00,UFU TORNU,156,92,211,36,1,248,218,30,222,26,9,31,50,48,46,32,11,21,0,10,135,72,218
20211126,26NOV2021:00:00:00,UFU VELEZ SARSFIELD,125,96,183,33,5,221,217,4,219,2,0,12,44,44,47,37,26,11,0,6,148,63,217
20211126,26NOV2021:00:00:00,UFU ZUBIZARRETA,131,93,151,56,17,224,224,0,224,0,0,22,44,50,44,27,16,21,0,6,162,56,224
20211127,27NOV2021:00:00:00,UFU ALVAREZ,139,122,210,38,13,261,251,10,251,10,11,8,48,74,33,34,26,27,0,9,168,74,251
20211127,27NOV2021:00:00:00,UFU ARGERICH,7,8,11,4,0,15,15,0,15,0,0,4,0,6,3,0,2,0,0,0,8,7,15
20211127,27NOV2021:00:00:00,UFU BORDA-MOYANO,26,20,37,9,0,46,40,6,40,6,0,9,0,8,9,13,2,5,0,0,24,16,40
20211127,27NOV2021:00:00:00,UFU DURAND,55,28,75,2,6,83,71,12,71,12,2,0,13,27,15,12,4,10,0,6,32,33,71
20211127,27NOV2021:00:00:00,UFU ELIZALDE,64,38,26,68,8,102,98,4,100,2,58,40,0,0,2,2,0,0,0,1,47,50,98
20211127,27NOV2021:00:00:00,UFU FERNANDEZ,65,42,99,3,5,107,87,20,105,2,0,0,30,33,10,20,11,3,0,9,44,34,87
20211127,27NOV2021:00:00:00,UFU FERRER,90,36,75,49,2,126,122,4,122,4,0,0,22,40,17,15,30,2,0,7,81,34,122
20211127,27NOV2021:00:00:00,UFU GRIERSON,76,82,82,71,5,158,146,12,146,12,0,13,33,32,35,16,17,12,0,3,107,34,146
20211127,27NOV2021:00:00:00,UFU GUTIERREZ,56,66,55,62,5,122,106,16,108,14,85,27,2,2,4,2,0,0,0,1,53,51,106
20211127,27NOV2021:00:00:00,UFU MUÑIZ,87,84,98,67,6,171,137,34,151,20,9,6,49,37,36,10,13,11,0,7,93,37,137
20211127,27NOV2021:00:00:00,UFU PENNA,32,51,31,46,6,83,79,4,79,4,13,15,15,19,6,8,2,5,0,7,49,23,79
20211127,27NOV2021:00:00:00,UFU PIROVANO,133,98,187,22,22,231,221,10,221,10,0,24,53,43,26,29,36,20,0,16,119,86,221
20211127,27NOV2021:00:00:00,UFU PIÑERO,67,33,72,17,11,100,94,6,94,6,0,5,25,27,23,13,5,2,0,4,68,22,94
20211127,27NOV2021:00:00:00,UFU RAMOS MEJIA,93,54,115,10,22,147,136,11,136,11,2,13,28,47,19,21,13,4,0,5,75,56,136
20211127,27NOV2021:00:00:00,UFU RIVADAVIA,90,65,111,27,17,155,155,0,155,0,0,4,54,38,22,17,12,8,0,8,81,65,155
20211127,27NOV2021:00:00:00,UFU SANTOJANNI,79,62,94,45,2,141,141,0,141,0,0,14,37,27,38,6,11,8,0,14,74,53,141
20211127,27NOV2021:00:00:00,UFU TORNU,77,69,127,8,11,146,128,18,128,18,6,13,21,38,31,9,12,16,0,10,72,46,128
20211127,27NOV2021:00:00:00,UFU VELEZ SARSFIELD,117,96,147,53,13,213,209,4,209,4,0,10,67,47,39,18,18,14,0,11,126,72,209
20211127,27NOV2021:00:00:00,UFU ZUBIZARRETA,195,148,256,83,4,343,335,8,343,0,0,38,40,76,78,43,37,31,0,3,245,87,335
20211128,28NOV2021:00:00:00,UFU ALVAREZ,107,61,144,14,10,168,158,10,158,10,24,19,36,28,29,14,12,6,0,10,104,44,158
20211128,28NOV2021:00:00:00,UFU ARGERICH,22,13,19,16,0,35,35,0,35,0,0,0,15,2,6,5,5,2,0,5,18,12,35
20211128,28NOV2021:00:00:00,UFU BORDA-MOYANO,12,18,18,12,0,30,28,2,28,2,0,0,6,5,4,4,8,3,0,0,17,11,28
20211128,28NOV2021:00:00:00,UFU DURAND,50,60,95,8,7,110,108,2,108,2,0,7,16,36,27,18,4,2,0,6,56,46,108
20211128,28NOV2021:00:00:00,UFU ELIZALDE,49,43,21,71,0,92,80,12,90,2,66,13,4,7,2,0,0,0,0,0,44,36,80
20211128,28NOV2021:00:00:00,UFU FERNANDEZ,44,34,64,12,2,78,70,8,70,8,0,2,8,20,5,24,10,9,0,4,40,26,70
20211128,28NOV2021:00:00:00,UFU FERRER,11,18,16,13,0,29,29,0,29,0,0,1,5,3,7,4,9,0,0,3,17,9,29
20211128,28NOV2021:00:00:00,UFU GRIERSON,54,62,59,52,5,116,104,12,104,12,0,9,18,27,28,14,20,0,0,1,72,31,104
20211128,28NOV2021:00:00:00,UFU GUTIERREZ,35,29,33,29,2,64,62,2,62,2,41,14,4,0,3,0,2,0,0,3,31,28,62
20211128,28NOV2021:00:00:00,UFU MUÑIZ,61,55,52,51,13,116,102,14,106,10,0,18,20,35,18,16,4,5,0,2,72,28,102
20211128,28NOV2021:00:00:00,UFU PENNA,23,13,26,10,0,36,36,0,36,0,2,0,0,12,8,11,3,0,0,7,19,10,36
20211128,28NOV2021:00:00:00,UFU PIROVANO,87,94,142,21,18,181,167,14,175,6,8,15,36,48,43,15,14,2,0,10,93,64,167
20211128,28NOV2021:00:00:00,UFU PIÑERO,34,22,47,7,2,56,54,2,54,2,0,3,11,13,9,9,6,5,0,3,36,13,54
20211128,28NOV2021:00:00:00,UFU RAMOS MEJIA,50,43,61,6,26,93,85,8,85,8,2,8,11,18,25,20,7,2,0,7,44,34,85
20211128,28NOV2021:00:00:00,UFU RIVADAVIA,33,41,55,13,6,74,44,30,44,30,0,2,26,24,15,1,2,4,0,1,24,19,44
20211128,28NOV2021:00:00:00,UFU SANTOJANNI,34,39,47,24,2,73,71,2,73,0,0,6,8,14,21,8,10,6,0,8,36,27,71
20211128,28NOV2021:00:00:00,UFU TORNU,67,31,89,7,2,98,84,14,84,14,2,11,17,20,17,12,14,5,0,3,51,30,84
20211128,28NOV2021:00:00:00,UFU VELEZ SARSFIELD,92,47,104,28,7,139,135,4,135,4,0,12,17,30,25,32,9,14,0,6,90,39,135
20211128,28NOV2021:00:00:00,UFU ZUBIZARRETA,99,59,115,24,19,158,158,0,158,0,0,12,45,22,21,35,14,9,0,5,114,39,158
20211129,29NOV2021:00:00:00,UFU ALVAREZ,180,102,235,35,12,282,242,40,266,16,22,6,54,59,50,33,36,22,0,8,172,62,242
20211129,29NOV2021:00:00:00,UFU ARGERICH,54,55,64,45,0,109,95,14,95,14,12,13,30,21,9,7,15,2,0,8,55,31,95
20211129,29NOV2021:00:00:00,UFU BORDA-MOYANO,21,34,33,21,1,55,53,2,53,2,0,0,11,13,15,9,5,2,0,1,39,13,53
20211129,29NOV2021:00:00:00,UFU DURAND,129,92,195,10,16,221,217,4,217,4,20,14,42,59,34,20,19,13,0,6,117,94,217
20211129,29NOV2021:00:00:00,UFU ELIZALDE,73,81,43,111,0,154,148,6,152,2,96,40,1,2,10,3,2,0,0,1,89,58,148
20211129,29NOV2021:00:00:00,UFU FERNANDEZ,131,70,156,26,19,201,173,28,179,22,0,4,70,40,34,20,24,9,0,7,103,63,173
20210705,05JUL2021:00:00:00,UFU DURAND,134,99,189,37,7,233,219,14,219,14,12,13,60,56,46,32,14,0,0,33,106,80,219
20210705,05JUL2021:00:00:00,UFU ELIZALDE,171,182,116,229,8,353,297,56,321,32,197,91,25,22,11,6,0,1,0,8,214,75,297
20210705,05JUL2021:00:00:00,UFU FERNANDEZ,134,90,163,43,18,224,214,10,220,4,0,9,55,63,41,38,16,2,0,33,103,78,214
20210705,05JUL2021:00:00:00,UFU FERRER,157,140,133,146,18,297,291,6,291,6,0,5,79,92,73,26,9,13,0,41,171,79,291
20210705,05JUL2021:00:00:00,UFU GRIERSON,191,181,188,133,51,372,356,16,356,16,0,28,83,115,76,55,6,9,0,36,225,95,356
20210705,05JUL2021:00:00:00,UFU GUTIERREZ,170,140,158,138,14,310,290,20,306,4,152,55,32,37,21,9,4,0,0,8,199,82,290
20210705,05JUL2021:00:00:00,UFU MUÑIZ,175,176,153,184,14,351,283,68,309,42,0,2,92,61,93,53,36,14,0,26,191,66,283
20210705,05JUL2021:00:00:00,UFU PENNA,45,35,65,15,0,80,70,10,80,0,0,2,21,15,19,15,5,3,0,7,47,16,70
20210705,05JUL2021:00:00:00,UFU PIROVANO,180,112,202,45,45,292,250,42,280,12,0,3,59,94,58,40,18,20,0,23,128,99,250
20210705,05JUL2021:00:00:00,UFU PIÑERO,133,120,163,82,8,253,253,0,253,0,0,16,48,54,73,35,23,4,0,27,164,61,253
20210705,05JUL2021:00:00:00,UFU RAMOS MEJIA,191,226,294,91,32,417,363,54,373,44,23,23,46,138,102,52,18,15,0,36,207,120,363
20210705,05JUL2021:00:00:00,UFU RIVADAVIA,117,111,138,43,47,228,210,18,214,14,0,7,47,64,51,28,21,10,0,26,103,81,210
20210705,05JUL2021:00:00:00,UFU SANTOJANNI,198,200,219,167,12,398,380,18,396,2,18,38,55,115,73,60,25,14,0,28,261,91,380
20210705,05JUL2021:00:00:00,UFU TORNU,156,174,228,76,26,330,300,30,302,28,22,19,46,81,65,50,33,14,0,16,199,78,300
20210705,05JUL2021:00:00:00,UFU VELEZ SARSFIELD,140,169,202,77,30,309,297,12,307,2,2,16,56,92,81,35,22,5,0,39,180,78,297
20210705,05JUL2021:00:00:00,UFU ZUBIZARRETA,224,148,199,146,27,372,370,2,372,0,0,15,62,100,73,65,38,19,0,29,243,98,370
20210706,06JUL2021:00:00:00,UFU ALVAREZ,244,182,311,94,21,426,398,28,402,24,34,25,103,80,93,49,28,14,0,33,263,102,398
20210706,06JUL2021:00:00:00,UFU ARGERICH,84,91,108,60,7,175,151,24,151,24,10,17,39,46,28,10,15,10,0,29,59,62,151
20210706,06JUL2021:00:00:00,UFU BORDA-MOYANO,61,33,41,50,3,94,90,4,90,4,3,5,19,28,12,20,0,7,0,1,60,29,90
20210706,06JUL2021:00:00:00,UFU DURAND,119,77,162,18,16,196,192,4,192,4,8,9,55,65,22,20,12,5,0,32,88,72,192
20210706,06JUL2021:00:00:00,UFU ELIZALDE,145,129,117,151,6,274,248,26,272,2,134,87,16,18,16,0,2,1,0,8,176,64,248
20210706,06JUL2021:00:00:00,UFU FERNANDEZ,123,76,161,23,15,199,149,50,185,14,0,3,55,66,22,33,14,6,0,23,66,60,149
20210706,06JUL2021:00:00:00,UFU FERRER,103,62,83,77,5,165,161,4,161,4,0,0,43,57,35,19,11,0,0,11,103,47,161
20210706,06JUL2021:00:00:00,UFU GRIERSON,180,153,154,100,79,333,317,16,323,10,0,22,98,91,53,42,15,12,0,32,197,87,317
20210706,06JUL2021:00:00:00,UFU GUTIERREZ,177,137,190,107,17,314,296,18,306,8,149,70,23,34,22,10,3,3,0,11,196,88,296
20210706,06JUL2021:00:00:00,UFU MUÑIZ,159,163,160,148,14,322,244,78,268,54,0,7,80,81,72,42,23,17,0,20,164,60,244
20210706,06JUL2021:00:00:00,UFU PENNA,66,50,92,24,0,116,104,12,110,6,0,2,29,37,16,14,9,9,0,8,66,30,104
20210706,06JUL2021:00:00:00,UFU PIROVANO,164,114,200,54,24,278,258,20,278,0,0,11,59,86,54,39,20,9,0,43,111,103,258
20210706,06JUL2021:00:00:00,UFU PIÑERO,123,65,120,47,21,188,166,22,180,8,6,7,43,55,48,11,7,11,0,17,105,42,166
20210706,06JUL2021:00:00:00,UFU RAMOS MEJIA,173,143,223,65,28,316,292,24,308,8,16,18,83,52,48,62,24,13,0,23,158,110,292
20210706,06JUL2021:00:00:00,UFU RIVADAVIA,134,125,156,72,31,259,245,14,253,6,0,9,85,79,30,26,17,13,0,36,107,100,245
20210706,06JUL2021:00:00:00,UFU SANTOJANNI,121,139,147,101,12,260,248,12,252,8,4,8,63,61,39,43,23,19,0,29,161,58,248
20210706,06JUL2021:00:00:00,UFU TORNU,186,117,228,56,19,303,241,62,265,38,18,19,65,93,63,29,11,5,0,12,164,60,241
20210706,06JUL2021:00:00:00,UFU VELEZ SARSFIELD,189,152,235,87,19,341,335,6,339,2,0,12,89,101,78,41,10,10,0,26,209,100,335
20210706,06JUL2021:00:00:00,UFU ZUBIZARRETA,170,121,175,98,18,291,289,2,291,0,0,37,55,73,78,30,15,3,0,24,191,74,289
20210707,07JUL2021:00:00:00,UFU ALVAREZ,247,240,356,114,17,487,463,24,465,22,45,51,100,125,96,28,25,17,0,30,304,129,463
20210707,07JUL2021:00:00:00,UFU ARGERICH,76,63,95,44,0,139,123,16,129,10,2,9,38,37,24,8,16,5,0,23,42,55,123
20210707,07JUL2021:00:00:00,UFU BORDA-MOYANO,48,31,48,27,4,79,71,8,71,8,0,5,6,31,14,18,5,0,0,5,42,24,71
20210707,07JUL2021:00:00:00,UFU DURAND,125,100,207,12,6,225,219,6,219,6,4,9,53,49,56,26,15,13,0,26,106,87,219
20210707,07JUL2021:00:00:00,UFU ELIZALDE,118,111,106,123,0,229,211,18,223,6,129,62,14,12,11,1,0,0,0,16,134,61,211
20210707,07JUL2021:00:00:00,UFU FERNANDEZ,137,109,183,35,28,246,194,52,226,20,0,7,58,63,62,41,13,2,0,29,93,72,194
20210707,07JUL2021:00:00:00,UFU FERRER,95,104,104,81,14,199,189,10,189,10,0,3,57,50,55,19,8,7,0,14,125,50,189
20210707,07JUL2021:00:00:00,UFU GRIERSON,145,120,108,134,23,265,259,6,259,6,0,10,81,78,45,29,22,0,0,30,156,71,259
20210707,07JUL2021:00:00:00,UFU GUTIERREZ,136,132,165,88,15,268,264,4,268,0,130,39,16,31,36,7,9,0,0,11,175,78,264
20210707,07JUL2021:00:00:00,UFU MUÑIZ,194,168,137,196,29,362,274,88,308,54,2,17,68,124,64,55,24,8,0,17,182,75,274
20210707,07JUL2021:00:00:00,UFU PENNA,89,67,123,29,4,156,110,46,150,6,0,6,50,43,23,15,6,13,0,17,62,31,110
20210707,07JUL2021:00:00:00,UFU PIROVANO,186,129,226,60,29,315,291,24,313,2,0,7,71,108,56,50,18,5,0,35,144,112,291
20210707,07JUL2021:00:00:00,UFU PIÑERO,144,119,202,54,7,263,239,24,253,10,0,14,59,59,62,44,12,13,0,25,146,64,239
20210707,07JUL2021:00:00:00,UFU RAMOS MEJIA,215,145,260,87,13,360,314,46,334,26,8,27,76,104,49,59,24,13,0,22,181,111,314
20210707,07JUL2021:00:00:00,UFU RIVADAVIA,132,112,157,50,37,244,218,26,222,22,0,4,89,69,47,21,8,6,0,24,112,82,218
20210707,07JUL2021:00:00:00,UFU SANTOJANNI,201,187,188,178,22,388,374,14,384,4,10,31,73,89,90,54,31,10,0,28,245,101,374
20210707,07JUL2021:00:00:00,UFU TORNU,121,121,183,38,21,242,216,26,218,24,9,28,31,66,54,23,11,20,0,23,130,62,216
20210707,07JUL2021:00:00:00,UFU VELEZ SARSFIELD,151,175,222,95,9,326,308,18,324,2,0,10,80,82,66,52,24,12,0,33,176,99,308
20210707,07JUL2021:00:00:00,UFU ZUBIZARRETA,144,130,191,74,9,274,270,4,274,0,0,12,53,75,58,36,20,20,0,16,176,78,270
20210708,08JUL2021:00:00:00,UFU ALVAREZ,213,183,322,57,17,396,366,30,372,24,45,33,85,104,46,47,29,7,0,28,241,97,366
20210708,08JUL2021:00:00:00,UFU ARGERICH,92,58,88,54,8,150,126,24,132,18,1,13,34,49,21,22,4,6,0,20,53,53,126
20210708,08JUL2021:00:00:00,UFU BORDA-MOYANO,33,21,44,10,0,54,48,6,48,6,1,2,4,19,5,12,3,8,0,4,31,13,48
20210708,08JUL2021:00:00:00,UFU DURAND,163,118,239,34,8,281,273,8,273,8,10,15,81,73,49,23,11,19,0,32,130,111,273
20210708,08JUL2021:00:00:00,UFU ELIZALDE,104,94,68,128,2,198,182,16,194,4,127,44,5,11,6,5,0,0,0,11,127,44,182
20210708,08JUL2021:00:00:00,UFU FERNANDEZ,118,108,185,23,18,226,182,44,220,6,0,8,54,71,46,29,13,5,0,30,92,60,182
20210708,08JUL2021:00:00:00,UFU FERRER,122,110,123,94,15,232,228,4,228,4,0,8,57,78,35,25,21,8,0,19,146,63,228
20210708,08JUL2021:00:00:00,UFU GRIERSON,128,112,133,68,39,240,236,4,236,4,0,12,55,58,75,30,8,2,0,15,151,67,236
20210708,08JUL2021:00:00:00,UFU GUTIERREZ,163,136,236,56,7,299,277,22,295,4,144,48,18,34,36,8,11,0,0,17,175,83,277
20210708,08JUL2021:00:00:00,UFU MUÑIZ,188,153,148,183,10,341,265,76,275,66,0,13,66,99,85,55,20,3,0,17,181,67,265
20210828,28AUG2021:00:00:00,UFU GUTIERREZ,125,188,198,108,9,315,289,26,297,18,210,71,4,8,15,7,0,0,0,3,207,77,289
20210828,28AUG2021:00:00:00,UFU MUÑIZ,131,115,98,141,9,248,172,76,174,74,2,17,50,61,68,36,10,4,0,4,131,37,172
20210828,28AUG2021:00:00:00,UFU PENNA,55,25,49,31,0,80,72,8,76,4,3,5,37,15,10,2,1,7,0,3,50,19,72
20210828,28AUG2021:00:00:00,UFU PIROVANO,164,137,252,21,30,303,283,20,291,12,2,15,57,94,75,41,9,10,0,7,153,123,283
20210828,28AUG2021:00:00:00,UFU PIÑERO,86,65,97,43,13,153,145,8,147,6,2,11,38,45,37,17,3,0,0,1,107,37,145
20210828,28AUG2021:00:00:00,UFU RAMOS MEJIA,109,102,143,34,36,213,203,10,205,8,10,21,24,75,40,25,9,9,0,6,114,83,203
20210828,28AUG2021:00:00:00,UFU RIVADAVIA,131,80,166,25,20,211,147,64,147,64,0,5,74,50,28,26,12,16,0,6,83,58,147
20210828,28AUG2021:00:00:00,UFU SANTOJANNI,303,234,318,187,34,539,507,32,525,14,2,33,121,117,122,73,33,38,0,10,366,131,507
20210828,28AUG2021:00:00:00,UFU TORNU,128,105,198,24,11,233,223,10,223,10,15,39,26,45,43,38,18,9,0,7,152,64,223
20210828,28AUG2021:00:00:00,UFU VELEZ SARSFIELD,218,112,249,55,28,332,306,26,310,22,2,20,46,77,95,63,20,9,0,7,213,86,306
20210828,28AUG2021:00:00:00,UFU ZUBIZARRETA,222,130,252,93,9,354,348,6,354,0,2,28,51,100,89,40,25,19,0,10,246,92,348
20210829,29AUG2021:00:00:00,UFU ALVAREZ,157,100,226,26,5,257,243,14,243,14,38,22,30,54,46,38,22,7,0,11,170,62,243
20210829,29AUG2021:00:00:00,UFU ARGERICH,51,18,37,32,0,69,65,4,69,0,7,2,17,18,10,8,5,2,0,1,37,26,65
20210829,29AUG2021:00:00:00,UFU BORDA-MOYANO,20,30,25,23,2,50,42,8,42,8,1,0,9,11,16,9,4,0,0,0,30,12,42
20210829,29AUG2021:00:00:00,UFU DURAND,130,83,185,16,12,213,199,14,199,14,6,23,26,45,45,36,19,13,0,8,108,83,199
20210829,29AUG2021:00:00:00,UFU ELIZALDE,118,115,88,143,2,233,181,52,209,24,147,46,19,8,8,2,3,0,0,2,109,70,181
20210829,29AUG2021:00:00:00,UFU FERNANDEZ,83,70,138,9,6,153,139,14,143,10,0,6,35,37,28,22,10,15,0,3,78,58,139
20210829,29AUG2021:00:00:00,UFU FERRER,53,35,47,37,4,88,84,4,84,4,0,0,18,33,22,10,5,0,0,1,63,20,84
20210829,29AUG2021:00:00:00,UFU GRIERSON,99,56,67,54,34,155,147,8,147,8,0,15,30,47,25,15,20,3,0,11,97,39,147
20210829,29AUG2021:00:00:00,UFU GUTIERREZ,184,117,206,93,2,301,293,8,293,8,188,79,3,12,14,5,0,0,0,0,215,78,293
20210829,29AUG2021:00:00:00,UFU MUÑIZ,81,62,67,67,11,145,131,14,133,12,4,21,30,17,37,21,4,11,0,3,98,30,131
20210829,29AUG2021:00:00:00,UFU PENNA,50,36,43,43,0,86,84,2,84,2,0,3,11,27,18,10,13,4,0,1,60,23,84
20210829,29AUG2021:00:00:00,UFU PIROVANO,173,134,259,38,10,307,269,38,299,8,45,20,36,71,57,37,23,18,0,16,142,110,269
20210829,29AUG2021:00:00:00,UFU PIÑERO,85,67,122,24,6,152,152,0,152,0,0,5,28,26,42,27,18,6,0,7,104,41,152
20210829,29AUG2021:00:00:00,UFU RAMOS MEJIA,136,80,159,41,16,216,210,6,210,6,8,23,35,54,56,23,11,6,0,6,143,58,210
20210829,29AUG2021:00:00:00,UFU RIVADAVIA,107,84,149,27,15,191,181,10,181,10,0,6,38,65,29,25,17,11,0,1,102,78,181
20210829,29AUG2021:00:00:00,UFU SANTOJANNI,249,161,261,141,8,410,394,16,402,8,4,21,91,79,103,53,34,25,0,3,300,91,394
20210829,29AUG2021:00:00:00,UFU TORNU,100,88,144,36,8,188,182,6,182,6,25,20,19,27,49,30,10,8,0,7,125,50,182
20210829,29AUG2021:00:00:00,UFU VELEZ SARSFIELD,172,124,236,53,7,296,290,6,292,4,0,20,38,61,56,50,54,17,0,7,187,96,290
20210829,29AUG2021:00:00:00,UFU ZUBIZARRETA,135,95,167,56,7,230,228,2,230,0,0,38,27,59,45,29,21,11,0,6,152,70,228
20210830,30AUG2021:00:00:00,UFU ALVAREZ,224,195,345,56,18,419,389,30,401,18,59,21,86,93,73,46,28,13,0,14,246,129,389
20210830,30AUG2021:00:00:00,UFU ARGERICH,88,73,91,66,4,161,149,12,155,6,40,16,16,30,21,23,8,7,0,4,85,59,149
20210830,30AUG2021:00:00:00,UFU BORDA-MOYANO,37,40,42,31,4,77,71,6,71,6,2,10,11,22,13,13,4,2,0,0,45,26,71
20210830,30AUG2021:00:00:00,UFU DURAND,171,106,236,20,21,277,267,10,267,10,50,32,30,67,45,24,19,10,0,13,147,107,267
20210830,30AUG2021:00:00:00,UFU ELIZALDE,174,195,144,220,5,369,315,54,325,44,200,128,12,17,10,2,0,0,0,1,198,116,315
20210830,30AUG2021:00:00:00,UFU FERNANDEZ,155,102,200,41,16,257,235,22,239,18,0,12,62,53,41,42,17,30,0,4,152,79,235
20210830,30AUG2021:00:00:00,UFU FERRER,114,83,111,75,11,197,193,4,193,4,0,7,38,59,61,19,7,6,0,6,140,47,193
20210830,30AUG2021:00:00:00,UFU GRIERSON,132,149,170,103,8,281,273,8,275,6,0,31,61,67,61,24,20,17,0,5,196,71,273
20210830,30AUG2021:00:00:00,UFU GUTIERREZ,202,193,274,118,3,395,381,14,389,6,265,96,9,13,9,3,0,0,0,0,257,124,381
20210830,30AUG2021:00:00:00,UFU MUÑIZ,129,156,166,100,19,285,245,40,249,36,7,34,51,84,45,46,18,0,0,0,184,61,245
20210830,30AUG2021:00:00:00,UFU PENNA,114,88,130,67,5,202,188,14,188,14,41,15,45,26,23,23,16,13,0,0,131,57,188
20210830,30AUG2021:00:00:00,UFU PIROVANO,239,131,285,50,35,370,356,14,364,6,0,17,77,99,78,54,25,20,0,9,210,137,356
20210830,30AUG2021:00:00:00,UFU PIÑERO,153,86,173,52,14,239,235,4,235,4,0,22,62,55,40,39,7,14,0,2,174,59,235
20210830,30AUG2021:00:00:00,UFU RAMOS MEJIA,275,190,322,86,57,465,439,26,451,14,47,46,82,93,70,68,40,19,0,9,286,144,439
20210830,30AUG2021:00:00:00,UFU RIVADAVIA,186,104,218,39,33,290,288,2,288,2,0,20,83,69,57,22,28,11,0,17,150,120,288
20210830,30AUG2021:00:00:00,UFU SANTOJANNI,301,270,332,223,16,571,545,26,561,10,87,45,81,121,83,77,49,28,0,5,384,156,545
20210830,30AUG2021:00:00:00,UFU TORNU,257,179,371,43,22,436,360,76,366,70,53,34,79,92,74,62,24,18,0,5,244,108,360
20210830,30AUG2021:00:00:00,UFU VELEZ SARSFIELD,214,171,300,63,22,385,373,12,381,4,0,42,89,69,88,42,33,22,0,5,262,106,373
20210830,30AUG2021:00:00:00,UFU ZUBIZARRETA,233,210,271,150,22,443,433,10,443,0,0,40,96,79,86,67,37,38,0,11,312,110,433
20210831,31AUG2021:00:00:00,UFU ALVAREZ,297,220,378,95,44,517,477,40,489,28,88,34,98,97,89,47,48,16,0,13,336,128,477
20210831,31AUG2021:00:00:00,UFU ARGERICH,99,70,107,60,2,169,146,23,148,21,48,13,19,38,20,10,15,6,0,4,75,67,146
20210831,31AUG2021:00:00:00,UFU BORDA-MOYANO,35,37,43,26,3,72,70,2,70,2,2,13,9,15,14,7,10,2,0,2,47,21,70
20210831,31AUG2021:00:00:00,UFU DURAND,153,130,247,25,11,283,271,12,273,10,38,31,35,90,47,16,12,14,0,17,145,109,271
20210831,31AUG2021:00:00:00,UFU ELIZALDE,214,165,118,257,4,379,285,94,361,18,241,87,10,16,16,7,2,0,0,0,174,111,285
20210831,31AUG2021:00:00:00,UFU FERNANDEZ,116,117,188,32,13,233,227,6,229,4,0,8,55,64,40,37,18,11,0,3,143,80,227
20210831,31AUG2021:00:00:00,UFU FERRER,121,84,127,73,5,205,190,15,194,11,0,6,46,65,36,26,19,7,0,1,142,47,190
20210831,31AUG2021:00:00:00,UFU GRIERSON,133,138,149,105,17,271,263,8,263,8,0,32,63,73,48,41,10,4,0,8,188,66,263
20210831,31AUG2021:00:00:00,UFU GUTIERREZ,225,241,296,151,19,466,434,32,462,4,298,111,16,18,14,6,3,0,0,0,305,128,434
20210831,31AUG2021:00:00:00,UFU MUÑIZ,163,176,178,130,31,339,285,54,293,46,17,31,68,78,67,35,32,11,0,8,190,86,285
20210831,31AUG2021:00:00:00,UFU PENNA,119,67,104,80,2,186,170,16,172,14,39,18,32,37,17,28,8,7,0,3,111,56,170
20210831,31AUG2021:00:00:00,UFU PIROVANO,206,174,293,59,28,380,360,20,372,8,0,37,58,114,80,48,26,17,0,14,167,179,360
20210831,31AUG2021:00:00:00,UFU PIÑERO,118,78,171,20,5,196,194,2,194,2,0,28,53,38,28,28,18,3,0,2,143,47,194
20210831,31AUG2021:00:00:00,UFU RAMOS MEJIA,159,161,245,57,18,320,302,18,308,12,35,38,42,90,56,38,14,7,0,9,204,88,302
20210831,31AUG2021:00:00:00,UFU RIVADAVIA,173,108,228,25,28,281,277,4,277,4,1,17,79,70,51,26,20,17,0,9,158,109,277
20211022,22OCT2021:00:00:00,UFU GRIERSON,64,57,82,33,6,121,93,28,121,0,0,16,41,15,18,21,3,7,0,0,71,22,93
20211022,22OCT2021:00:00:00,UFU GUTIERREZ,108,101,111,94,4,209,195,14,209,0,141,53,2,7,5,0,1,0,0,0,131,64,195
20211022,22OCT2021:00:00:00,UFU MUÑIZ,127,102,134,80,15,229,199,30,199,30,9,22,27,59,47,31,25,9,0,4,140,54,199
20211022,22OCT2021:00:00:00,UFU PENNA,47,57,54,46,4,104,98,6,98,6,29,22,12,16,11,7,6,1,0,2,68,28,98
20211022,22OCT2021:00:00:00,UFU PIROVANO,164,118,222,25,35,282,186,96,276,6,0,19,79,70,50,35,14,15,0,1,113,72,186
20211022,22OCT2021:00:00:00,UFU PIÑERO,119,126,203,26,16,245,237,8,239,6,91,56,16,27,15,20,16,4,0,4,167,66,237
20211022,22OCT2021:00:00:00,UFU RAMOS MEJIA,94,78,124,21,27,172,150,22,158,14,11,18,36,41,27,17,18,4,0,2,87,61,150
20211022,22OCT2021:00:00:00,UFU RIVADAVIA,115,69,108,43,33,184,164,20,176,8,0,4,60,48,23,28,18,3,0,1,101,62,164
20211022,22OCT2021:00:00:00,UFU SANTOJANNI,122,85,124,75,8,207,167,40,203,4,10,38,48,34,36,13,16,12,0,8,96,63,167
20211022,22OCT2021:00:00:00,UFU TORNU,191,133,269,42,13,324,266,58,270,54,48,35,56,59,44,44,18,20,0,6,183,69,266
20211022,22OCT2021:00:00:00,UFU VELEZ SARSFIELD,104,110,160,44,10,214,212,2,212,2,0,10,51,57,44,24,18,10,0,1,149,62,212
20211022,22OCT2021:00:00:00,UFU ZUBIZARRETA,141,101,156,64,22,242,242,0,242,0,0,43,54,41,47,24,22,11,0,6,174,62,242
20211023,23OCT2021:00:00:00,UFU ALVAREZ,148,89,154,52,31,237,219,18,219,18,26,17,50,54,37,23,12,18,0,2,151,66,219
20211023,23OCT2021:00:00:00,UFU ARGERICH,0,6,6,0,0,6,6,0,6,0,4,2,0,0,0,0,0,0,0,0,3,3,6
20211023,23OCT2021:00:00:00,UFU BORDA-MOYANO,6,8,7,5,2,14,14,0,14,0,0,0,7,4,1,2,0,0,0,0,9,5,14
20211023,23OCT2021:00:00:00,UFU DURAND,71,69,128,5,7,140,130,10,130,10,2,11,11,37,31,15,22,11,0,1,72,57,130
20211023,23OCT2021:00:00:00,UFU ELIZALDE,87,96,61,122,0,183,167,16,173,10,131,42,4,2,4,0,0,0,0,0,104,63,167
20211023,23OCT2021:00:00:00,UFU FERNANDEZ,63,37,75,7,18,100,96,4,96,4,0,4,11,28,20,11,7,19,0,0,66,30,96
20211023,23OCT2021:00:00:00,UFU FERRER,73,50,65,49,9,123,119,4,119,4,0,5,20,39,26,22,11,0,0,5,91,23,119
20211023,23OCT2021:00:00:00,UFU GRIERSON,76,77,88,36,29,153,143,10,143,10,0,15,39,33,19,29,14,4,0,2,103,37,143
20211023,23OCT2021:00:00:00,UFU GUTIERREZ,44,74,61,54,3,118,92,26,104,14,84,19,3,4,4,0,0,4,0,0,56,34,92
20211023,23OCT2021:00:00:00,UFU MUÑIZ,92,101,94,86,13,193,167,26,169,24,0,21,36,46,47,22,13,8,0,6,117,44,167
20211023,23OCT2021:00:00:00,UFU PENNA,36,30,23,39,4,66,61,5,63,3,24,6,5,12,12,4,3,0,0,0,43,18,61
20211023,23OCT2021:00:00:00,UFU PIROVANO,127,112,188,23,28,239,231,8,231,8,0,11,44,90,41,25,18,10,0,3,137,91,231
20211023,23OCT2021:00:00:00,UFU PIÑERO,63,43,79,24,3,106,106,0,106,0,0,5,21,23,26,20,6,5,0,0,76,29,106
20211023,23OCT2021:00:00:00,UFU RAMOS MEJIA,61,67,97,12,19,128,118,10,120,8,0,10,29,29,26,18,8,8,0,2,64,52,118
20211023,23OCT2021:00:00:00,UFU RIVADAVIA,80,42,84,22,16,122,90,32,90,32,0,3,31,39,15,11,13,10,0,3,46,41,90
20211023,23OCT2021:00:00:00,UFU SANTOJANNI,94,84,100,62,16,178,172,6,172,6,0,24,31,39,27,29,13,15,0,10,96,66,172
20211023,23OCT2021:00:00:00,UFU TORNU,113,95,173,7,28,208,198,10,198,10,8,33,29,48,42,12,26,10,0,3,142,53,198
20211023,23OCT2021:00:00:00,UFU VELEZ SARSFIELD,125,72,140,38,19,197,185,12,191,6,0,21,36,37,37,27,28,11,0,4,125,56,185
20211023,23OCT2021:00:00:00,UFU ZUBIZARRETA,137,123,194,54,12,260,256,4,260,0,0,19,56,37,68,33,24,23,0,2,185,69,256
20211024,24OCT2021:00:00:00,UFU ALVAREZ,92,100,159,16,17,192,180,12,184,8,27,17,29,29,37,23,18,12,0,1,130,49,180
20211024,24OCT2021:00:00:00,UFU ARGERICH,0,2,2,0,0,2,2,0,2,0,0,0,0,0,0,2,0,0,0,0,1,1,2
20211024,24OCT2021:00:00:00,UFU BORDA-MOYANO,16,12,16,10,2,28,28,0,28,0,0,2,9,8,4,2,3,0,0,0,16,12,28
20211024,24OCT2021:00:00:00,UFU DURAND,97,91,149,16,23,188,178,10,178,10,16,13,32,43,39,16,25,4,0,7,96,75,178
20211024,24OCT2021:00:00:00,UFU ELIZALDE,106,83,40,145,4,189,125,64,167,22,145,32,4,3,5,0,0,0,0,0,82,43,125
20211024,24OCT2021:00:00:00,UFU FERNANDEZ,36,24,44,9,7,60,56,4,56,4,0,3,17,9,8,8,6,9,0,3,35,18,56
20211024,24OCT2021:00:00:00,UFU FERRER,27,42,38,19,12,69,59,10,59,10,0,0,9,16,22,19,3,0,0,1,45,13,59
20211024,24OCT2021:00:00:00,UFU GRIERSON,52,33,54,19,12,85,77,8,77,8,0,13,20,8,24,18,2,0,0,2,53,22,77
20211024,24OCT2021:00:00:00,UFU GUTIERREZ,111,94,134,58,13,205,193,12,197,8,138,46,0,8,7,6,0,0,0,2,133,58,193
20211024,24OCT2021:00:00:00,UFU MUÑIZ,56,64,68,39,13,120,112,8,112,8,0,17,17,29,12,25,13,7,0,4,76,32,112
20211024,24OCT2021:00:00:00,UFU PENNA,23,26,36,13,0,49,47,2,49,0,14,1,7,11,4,3,5,4,0,0,35,12,47
20211024,24OCT2021:00:00:00,UFU PIROVANO,133,102,164,26,45,235,223,12,229,6,20,9,39,37,47,50,25,8,0,6,127,90,223
20211024,24OCT2021:00:00:00,UFU PIÑERO,49,52,82,13,6,101,99,2,99,2,0,5,14,23,17,15,22,5,0,0,75,24,99
20211024,24OCT2021:00:00:00,UFU RAMOS MEJIA,70,68,111,13,14,138,136,2,136,2,0,10,30,30,29,18,13,8,0,4,72,60,136
20211024,24OCT2021:00:00:00,UFU RIVADAVIA,72,44,95,6,15,116,108,8,110,6,0,2,24,36,18,15,10,11,0,1,61,46,108
20211024,24OCT2021:00:00:00,UFU SANTOJANNI,117,63,97,68,15,180,161,19,167,13,0,20,22,36,26,41,17,18,0,11,75,75,161
20211024,24OCT2021:00:00:00,UFU TORNU,100,71,130,13,28,171,165,6,165,6,19,11,24,33,32,17,25,10,0,5,110,50,165
20211024,24OCT2021:00:00:00,UFU VELEZ SARSFIELD,102,73,128,37,10,175,167,8,171,4,0,10,23,28,41,29,27,17,0,0,122,45,167
20211024,24OCT2021:00:00:00,UFU ZUBIZARRETA,66,56,84,38,0,122,122,0,122,0,0,4,14,24,24,19,22,15,0,4,88,30,122
20211025,25OCT2021:00:00:00,UFU ALVAREZ,181,131,245,51,16,312,296,16,298,14,62,41,41,57,41,24,32,14,0,7,183,106,296
20211025,25OCT2021:00:00:00,UFU ARGERICH,96,76,102,62,8,172,149,23,149,23,33,20,34,26,10,17,15,17,0,6,80,63,149
20211025,25OCT2021:00:00:00,UFU BORDA-MOYANO,25,25,34,10,6,50,50,0,50,0,0,2,0,13,12,14,6,3,0,0,28,22,50
20211025,25OCT2021:00:00:00,UFU DURAND,133,126,238,4,17,259,251,8,251,8,18,22,59,60,39,22,18,21,0,6,144,101,251
20211025,25OCT2021:00:00:00,UFU ELIZALDE,162,153,95,211,9,315,271,44,297,18,240,67,0,7,0,1,0,0,0,5,170,96,271
20211025,25OCT2021:00:00:00,UFU FERNANDEZ,90,79,130,26,13,169,147,22,157,12,4,3,32,45,34,22,15,14,0,4,82,61,147
20211025,25OCT2021:00:00:00,UFU FERRER,130,67,90,90,17,197,191,6,191,6,0,3,62,50,34,31,9,8,0,0,152,39,191
20211025,25OCT2021:00:00:00,UFU GRIERSON,115,84,108,73,18,199,191,8,191,8,0,15,57,45,35,34,8,5,0,1,145,45,191
20211025,25OCT2021:00:00:00,UFU GUTIERREZ,159,138,148,138,11,297,269,28,293,4,211,56,10,12,6,0,2,0,0,1,178,90,269
20211025,25OCT2021:00:00:00,UFU MUÑIZ,96,81,84,87,6,177,151,26,157,20,2,17,26,47,44,26,3,12,0,0,91,60,151
20211025,25OCT2021:00:00:00,UFU PENNA,73,45,64,50,4,118,104,14,110,8,37,4,15,26,13,14,7,2,0,3,61,40,104
20211025,25OCT2021:00:00:00,UFU PIROVANO,231,175,331,51,24,406,386,20,394,12,0,9,97,92,102,54,32,20,0,5,222,159,386
20211025,25OCT2021:00:00:00,UFU PIÑERO,181,128,243,54,12,309,301,8,301,8,122,44,32,31,33,20,19,8,0,0,235,66,301
20211025,25OCT2021:00:00:00,UFU RAMOS MEJIA,166,141,210,61,36,307,249,58,257,50,34,19,48,65,47,40,34,20,0,7,143,99,249
20211025,25OCT2021:00:00:00,UFU RIVADAVIA,145,79,152,49,23,224,216,8,216,8,0,11,54,62,23,37,23,14,0,3,131,82,216
20211025,25OCT2021:00:00:00,UFU SANTOJANNI,138,118,155,87,14,256,248,8,254,2,17,14,49,56,50,26,23,21,0,5,138,105,248
20211129,29NOV2021:00:00:00,UFU FERRER,51,34,51,34,0,85,81,4,85,0,0,3,15,24,22,15,6,0,0,6,53,22,81
20211129,29NOV2021:00:00:00,UFU GRIERSON,91,86,116,45,16,177,155,22,175,2,2,6,47,42,28,27,13,12,0,3,115,36,155
20211129,29NOV2021:00:00:00,UFU GUTIERREZ,77,98,91,75,9,175,163,12,169,6,113,40,6,8,2,2,1,3,0,5,81,77,163
20211129,29NOV2021:00:00:00,UFU MUÑIZ,91,111,82,96,24,202,174,28,182,20,0,3,35,58,37,20,25,24,0,3,110,60,174
20211129,29NOV2021:00:00:00,UFU PENNA,67,59,76,43,7,126,118,8,120,6,36,20,7,24,14,17,4,4,0,1,84,33,118
20211129,29NOV2021:00:00:00,UFU PIROVANO,172,138,249,34,27,310,298,12,304,6,0,14,73,83,58,39,33,10,0,13,162,123,298
20211129,29NOV2021:00:00:00,UFU PIÑERO,119,95,156,50,8,214,204,10,206,8,40,27,43,48,24,12,13,7,0,4,152,47,204
20211129,29NOV2021:00:00:00,UFU RAMOS MEJIA,162,122,216,29,39,284,252,32,268,16,28,23,53,83,42,31,17,7,0,12,121,119,252
20211129,29NOV2021:00:00:00,UFU RIVADAVIA,152,63,146,45,24,215,203,12,205,10,0,2,63,48,41,22,27,12,0,11,113,79,203
20211129,29NOV2021:00:00:00,UFU SANTOJANNI,105,69,90,81,3,174,162,12,174,0,2,16,29,46,27,24,13,17,0,12,87,63,162
20211129,29NOV2021:00:00:00,UFU TORNU,114,77,155,27,9,191,171,20,171,20,13,8,24,62,33,20,11,20,0,10,103,58,171
20211129,29NOV2021:00:00:00,UFU VELEZ SARSFIELD,110,141,183,56,12,251,237,14,247,4,0,3,41,65,59,32,25,26,0,4,163,70,237
20211129,29NOV2021:00:00:00,UFU ZUBIZARRETA,210,158,225,120,23,368,366,2,368,0,0,26,81,73,70,58,40,20,0,17,252,97,366
20211130,30NOV2021:00:00:00,UFU ALVAREZ,146,135,234,35,12,281,255,26,257,24,21,23,34,64,40,65,19,15,0,8,171,76,255
20211130,30NOV2021:00:00:00,UFU ARGERICH,70,44,54,55,5,114,94,20,104,10,0,7,26,17,18,14,14,18,0,11,42,38,94
20211130,30NOV2021:00:00:00,UFU BORDA-MOYANO,25,21,35,11,0,46,36,10,36,10,0,6,2,12,11,10,3,2,0,0,22,14,36
20211130,30NOV2021:00:00:00,UFU DURAND,134,87,200,12,9,221,213,8,213,8,17,9,41,57,44,14,25,14,0,6,121,86,213
20211130,30NOV2021:00:00:00,UFU ELIZALDE,64,63,31,91,5,127,95,32,109,18,84,39,2,2,0,0,0,0,0,0,56,39,95
20211130,30NOV2021:00:00:00,UFU FERNANDEZ,84,73,125,20,12,157,133,24,149,8,0,2,45,38,34,20,15,3,0,4,79,50,133
20211130,30NOV2021:00:00:00,UFU FERRER,52,49,75,26,0,101,97,4,99,2,0,4,36,30,8,17,3,3,0,7,69,21,97
20211130,30NOV2021:00:00:00,UFU GRIERSON,94,113,147,49,11,207,187,20,189,18,0,15,55,40,24,45,25,3,0,8,133,45,187
20211130,30NOV2021:00:00:00,UFU GUTIERREZ,96,87,111,66,6,183,173,10,179,4,117,31,11,5,8,11,0,0,0,3,96,73,173
20211130,30NOV2021:00:00:00,UFU MUÑIZ,95,131,97,114,15,226,196,30,204,22,4,17,48,44,46,48,11,8,0,6,138,52,196
20211130,30NOV2021:00:00:00,UFU PENNA,47,69,86,25,5,116,112,4,114,2,22,9,25,18,10,13,11,8,0,5,74,33,112
20211130,30NOV2021:00:00:00,UFU PIROVANO,248,147,320,32,43,395,377,18,385,10,0,31,85,98,70,64,27,20,0,36,193,147,377
20211130,30NOV2021:00:00:00,UFU PIÑERO,86,61,110,26,11,147,139,8,143,4,39,33,18,20,15,8,11,3,0,5,98,34,139
20211130,30NOV2021:00:00:00,UFU RAMOS MEJIA,139,91,154,46,30,230,194,36,194,36,4,12,68,66,29,21,17,13,0,9,106,79,194
20211130,30NOV2021:00:00:00,UFU RIVADAVIA,161,121,213,44,25,282,274,8,274,8,0,8,67,76,38,38,33,22,0,13,149,112,274
20211130,30NOV2021:00:00:00,UFU SANTOJANNI,127,82,122,81,6,209,199,10,209,0,0,13,41,51,44,26,29,5,0,28,96,75,199
20211130,30NOV2021:00:00:00,UFU TORNU,157,117,234,30,10,274,228,46,240,34,22,20,38,69,55,39,22,9,0,13,137,78,228
20211130,30NOV2021:00:00:00,UFU VELEZ SARSFIELD,129,136,190,70,5,265,255,10,259,6,0,18,60,66,52,35,21,13,0,11,172,72,255
20211130,30NOV2021:00:00:00,UFU ZUBIZARRETA,186,129,195,76,44,315,311,4,315,0,0,37,45,48,78,47,30,30,0,16,217,78,311
20211201,01DEC2021:00:00:00,UFU ALVAREZ,192,191,311,45,27,383,343,40,345,38,26,24,117,79,46,42,26,23,0,14,228,101,343
20211201,01DEC2021:00:00:00,UFU ARGERICH,50,36,53,29,4,86,78,8,78,8,3,4,15,15,16,14,16,3,0,6,39,33,78
20211201,01DEC2021:00:00:00,UFU BORDA-MOYANO,36,31,47,14,6,67,65,2,65,2,0,7,18,13,4,16,9,0,0,3,38,24,65
20211201,01DEC2021:00:00:00,UFU DURAND,84,61,125,7,13,145,139,6,139,6,0,8,32,42,37,14,9,3,0,11,71,57,139
20211201,01DEC2021:00:00:00,UFU ELIZALDE,47,61,46,57,5,108,94,14,104,4,72,30,2,3,1,0,0,0,0,1,41,52,94
20211201,01DEC2021:00:00:00,UFU FERNANDEZ,98,87,141,38,6,185,157,28,163,22,0,12,59,40,28,18,13,15,0,11,81,65,157
20211201,01DEC2021:00:00:00,UFU FERRER,84,39,66,52,5,123,115,8,119,4,0,7,31,44,11,17,9,4,0,5,74,36,115
20211201,01DEC2021:00:00:00,UFU GRIERSON,71,61,65,54,13,132,126,6,126,6,0,11,34,26,16,8,33,4,0,4,84,36,126
20211201,01DEC2021:00:00:00,UFU GUTIERREZ,62,83,87,50,8,145,127,18,143,2,102,30,3,4,6,0,0,0,0,5,68,54,127
20211201,01DEC2021:00:00:00,UFU MUÑIZ,111,126,118,92,27,237,201,36,201,36,4,18,47,62,48,32,19,7,0,7,135,59,201
20211201,01DEC2021:00:00:00,UFU PENNA,37,58,52,43,0,95,82,13,82,13,16,0,18,36,4,13,8,0,0,4,55,23,82
20211201,01DEC2021:00:00:00,UFU PIROVANO,192,142,269,24,41,334,322,12,328,6,0,17,64,95,86,31,20,21,0,21,170,131,322
20211201,01DEC2021:00:00:00,UFU PIÑERO,113,79,133,45,14,192,184,8,184,8,44,23,23,30,21,20,16,15,0,4,133,47,184
20211201,01DEC2021:00:00:00,UFU RAMOS MEJIA,94,84,117,26,35,178,162,16,162,16,7,2,38,50,35,15,24,7,0,10,71,81,162
20211201,01DEC2021:00:00:00,UFU RIVADAVIA,185,111,208,45,43,296,280,16,282,14,0,15,88,95,37,36,15,10,0,16,153,111,280
20211201,01DEC2021:00:00:00,UFU SANTOJANNI,116,69,124,55,6,185,179,6,183,2,0,7,40,40,30,36,16,16,0,11,95,73,179
20211201,01DEC2021:00:00:00,UFU TORNU,165,132,241,37,19,297,237,60,239,58,20,38,41,73,57,45,13,10,0,14,129,90,237
20211201,01DEC2021:00:00:00,UFU VELEZ SARSFIELD,162,128,245,39,6,290,260,30,288,2,4,9,54,72,44,51,35,21,0,14,172,74,260
20211201,01DEC2021:00:00:00,UFU ZUBIZARRETA,116,69,121,32,32,185,171,14,185,0,0,6,22,41,50,32,19,15,0,8,119,44,171
20211202,02DEC2021:00:00:00,UFU ALVAREZ,157,121,211,41,26,278,254,24,258,20,14,32,56,81,45,26,16,8,0,9,163,82,254
20211202,02DEC2021:00:00:00,UFU ARGERICH,41,31,47,25,0,72,58,14,58,14,4,2,9,11,26,5,11,4,0,5,29,23,58
20211202,02DEC2021:00:00:00,UFU BORDA-MOYANO,60,19,54,23,2,79,43,36,43,36,5,4,19,14,10,14,9,4,0,2,23,18,43
20211202,02DEC2021:00:00:00,UFU DURAND,88,77,146,9,10,165,155,10,155,10,0,12,46,42,26,16,17,6,0,17,74,64,155
20211202,02DEC2021:00:00:00,UFU ELIZALDE,79,78,45,112,0,157,115,42,155,2,116,33,3,2,3,0,0,0,0,2,63,50,115
20211202,02DEC2021:00:00:00,UFU FERNANDEZ,98,71,135,16,18,169,149,20,155,14,0,8,53,34,22,26,18,8,0,3,87,59,149
20211202,02DEC2021:00:00:00,UFU FERRER,46,39,45,40,0,85,83,2,85,0,0,0,11,30,22,8,5,9,0,5,59,19,83
20211202,02DEC2021:00:00:00,UFU GRIERSON,90,37,77,42,8,127,111,16,123,4,0,7,34,22,17,17,17,13,0,2,75,34,111
20211202,02DEC2021:00:00:00,UFU GUTIERREZ,82,73,90,56,9,155,139,16,153,2,106,35,4,5,3,2,0,0,0,2,74,63,139
20211202,02DEC2021:00:00:00,UFU MUÑIZ,133,152,138,111,36,285,261,24,265,20,4,28,62,59,40,55,25,12,0,9,173,79,261
20211202,02DEC2021:00:00:00,UFU PENNA,95,73,134,34,0,168,140,28,166,2,21,16,32,28,31,20,10,10,0,8,92,39,140
20211202,02DEC2021:00:00:00,UFU PIROVANO,196,133,259,35,35,329,317,12,323,6,0,15,83,114,58,19,27,13,0,26,167,124,317
20211202,02DEC2021:00:00:00,UFU PIÑERO,84,73,103,43,11,157,153,4,157,0,24,23,38,24,26,7,9,6,0,5,110,37,153
20211202,02DEC2021:00:00:00,UFU RAMOS MEJIA,107,109,164,27,25,216,156,60,168,48,3,11,52,54,44,20,23,9,0,9,88,59,156
20210708,08JUL2021:00:00:00,UFU PENNA,93,60,127,22,4,153,130,23,146,7,0,4,37,47,21,29,10,5,0,13,87,30,130
20210708,08JUL2021:00:00:00,UFU PIROVANO,178,180,273,52,33,358,319,39,347,11,2,19,96,97,63,44,25,12,0,36,149,134,319
20210708,08JUL2021:00:00:00,UFU PIÑERO,130,94,152,59,13,224,206,18,220,4,0,12,38,69,38,34,20,13,0,17,136,50,206
20210708,08JUL2021:00:00:00,UFU RAMOS MEJIA,148,140,198,62,28,288,270,18,282,6,9,14,68,63,40,59,32,3,0,19,159,92,270
20210708,08JUL2021:00:00:00,UFU RIVADAVIA,168,116,171,75,38,284,234,50,242,42,0,4,86,88,38,56,10,2,0,23,116,93,234
20210708,08JUL2021:00:00:00,UFU SANTOJANNI,231,148,183,172,24,379,355,24,371,8,15,33,118,68,59,35,29,22,0,37,222,96,355
20210708,08JUL2021:00:00:00,UFU TORNU,176,130,258,29,19,306,286,20,288,18,18,12,71,78,52,41,25,9,0,25,184,71,286
20210708,08JUL2021:00:00:00,UFU VELEZ SARSFIELD,182,176,256,82,20,358,312,46,348,10,0,26,103,84,62,33,34,16,0,36,183,93,312
20210708,08JUL2021:00:00:00,UFU ZUBIZARRETA,98,63,100,52,9,161,161,0,161,0,0,6,30,45,25,22,22,11,0,11,113,37,161
20210709,09JUL2021:00:00:00,UFU ALVAREZ,196,150,281,55,10,346,322,24,322,24,7,26,66,85,65,56,24,17,0,33,189,100,322
20210709,09JUL2021:00:00:00,UFU ARGERICH,42,17,36,20,3,59,59,0,59,0,0,2,12,17,13,3,9,3,0,8,28,23,59
20210709,09JUL2021:00:00:00,UFU BORDA-MOYANO,30,38,39,27,2,68,58,10,58,10,0,0,23,23,13,9,0,0,0,2,41,15,58
20210709,09JUL2021:00:00:00,UFU DURAND,89,60,137,8,4,149,147,2,147,2,2,17,34,43,25,14,10,4,0,18,76,53,147
20210709,09JUL2021:00:00:00,UFU ELIZALDE,89,87,78,93,5,176,151,25,167,9,109,45,2,13,4,3,0,0,0,8,94,49,151
20210709,09JUL2021:00:00:00,UFU FERNANDEZ,103,123,193,27,6,226,158,68,216,10,2,13,53,73,31,35,17,2,0,18,73,67,158
20210709,09JUL2021:00:00:00,UFU FERRER,100,81,82,97,2,181,177,4,177,4,0,3,46,36,47,39,10,0,0,18,112,47,177
20210709,09JUL2021:00:00:00,UFU GRIERSON,113,131,128,103,13,244,232,12,242,2,7,22,42,72,52,38,2,9,0,15,153,64,232
20210709,09JUL2021:00:00:00,UFU GUTIERREZ,115,91,156,44,6,206,190,16,196,10,80,32,27,25,24,18,0,0,0,13,134,42,190
20210709,09JUL2021:00:00:00,UFU MUÑIZ,144,124,125,127,16,268,226,42,236,32,0,12,77,54,61,46,18,0,0,26,136,64,226
20210709,09JUL2021:00:00:00,UFU PENNA,50,40,66,24,0,90,84,6,88,2,9,2,30,21,11,7,9,1,0,4,55,25,84
20210709,09JUL2021:00:00:00,UFU PIROVANO,155,145,253,37,10,300,288,12,294,6,0,10,76,74,59,44,25,12,0,37,137,114,288
20210709,09JUL2021:00:00:00,UFU PIÑERO,85,62,98,40,9,147,145,2,145,2,0,6,21,37,22,39,18,4,0,8,98,38,145
20210709,09JUL2021:00:00:00,UFU RAMOS MEJIA,138,110,191,47,10,248,220,28,226,22,6,19,57,71,36,23,17,19,0,16,105,99,220
20210709,09JUL2021:00:00:00,UFU RIVADAVIA,119,86,157,21,27,205,197,8,197,8,0,1,72,73,24,13,10,12,0,29,86,81,197
20210709,09JUL2021:00:00:00,UFU SANTOJANNI,251,190,209,202,30,441,431,10,435,6,5,34,109,93,99,59,18,24,0,35,284,112,431
20210709,09JUL2021:00:00:00,UFU TORNU,108,117,194,22,9,225,217,8,217,8,14,14,46,49,50,24,18,10,0,19,146,52,217
20210709,09JUL2021:00:00:00,UFU VELEZ SARSFIELD,163,174,260,63,14,337,327,10,331,6,0,16,74,84,69,60,24,10,0,44,198,85,327
20210709,09JUL2021:00:00:00,UFU ZUBIZARRETA,114,97,135,73,3,211,211,0,211,0,0,18,53,36,43,28,19,14,0,13,127,71,211
20210710,10JUL2021:00:00:00,UFU ALVAREZ,195,156,285,61,5,351,337,14,339,12,24,21,59,82,81,54,28,2,0,36,207,94,337
20210710,10JUL2021:00:00:00,UFU BORDA-MOYANO,88,20,74,29,5,108,94,14,94,14,0,2,20,21,17,16,20,12,0,6,52,36,94
20210710,10JUL2021:00:00:00,UFU DURAND,84,79,149,10,4,163,151,12,151,12,6,6,36,48,26,22,12,7,0,21,67,63,151
20210710,10JUL2021:00:00:00,UFU ELIZALDE,121,88,95,112,2,209,189,20,203,6,137,40,12,10,5,3,2,0,0,13,125,51,189
20210710,10JUL2021:00:00:00,UFU FERNANDEZ,86,52,117,19,2,138,112,26,136,2,0,7,27,51,13,20,15,5,0,24,46,42,112
20210710,10JUL2021:00:00:00,UFU FERRER,79,71,84,63,3,150,146,4,146,4,0,0,33,32,32,33,16,4,0,19,89,38,146
20210710,10JUL2021:00:00:00,UFU GRIERSON,155,128,130,124,29,283,269,14,271,12,0,12,58,83,60,45,25,0,0,31,166,71,269
20210710,10JUL2021:00:00:00,UFU GUTIERREZ,142,140,161,93,28,282,274,8,278,4,106,34,32,62,21,22,3,2,0,20,179,73,274
20210710,10JUL2021:00:00:00,UFU MUÑIZ,117,126,90,137,16,243,209,34,217,26,2,12,61,62,55,34,11,6,0,21,132,56,209
20210710,10JUL2021:00:00:00,UFU PENNA,23,27,38,12,0,50,46,4,48,2,0,0,16,12,3,8,9,2,0,7,23,16,46
20210710,10JUL2021:00:00:00,UFU PIROVANO,145,107,203,35,14,252,240,12,248,4,0,8,38,82,56,43,13,12,0,33,98,109,240
20210710,10JUL2021:00:00:00,UFU PIÑERO,84,52,94,39,3,136,134,2,134,2,0,6,34,38,21,25,7,5,0,9,90,33,134
20210710,10JUL2021:00:00:00,UFU RAMOS MEJIA,140,84,157,53,14,224,195,29,199,25,12,15,41,51,58,20,15,12,0,12,114,69,195
20210710,10JUL2021:00:00:00,UFU RIVADAVIA,130,101,152,52,27,231,215,16,215,16,0,9,83,52,21,28,25,13,0,23,103,89,215
20210710,10JUL2021:00:00:00,UFU SANTOJANNI,266,210,223,244,9,476,462,14,466,10,0,30,106,96,100,60,38,46,0,37,300,125,462
20210710,10JUL2021:00:00:00,UFU TORNU,111,96,160,34,13,207,197,10,197,10,12,7,34,52,32,38,16,16,0,15,123,59,197
20210710,10JUL2021:00:00:00,UFU VELEZ SARSFIELD,146,161,230,55,22,307,297,10,301,6,0,2,75,92,53,40,22,23,0,38,176,83,297
20210710,10JUL2021:00:00:00,UFU ZUBIZARRETA,90,69,105,53,1,159,155,4,159,0,0,12,40,33,29,8,26,11,0,9,101,45,155
20210711,11JUL2021:00:00:00,UFU ALVAREZ,174,107,240,33,8,281,263,18,267,14,23,15,70,51,72,28,16,6,0,30,159,74,263
20210711,11JUL2021:00:00:00,UFU ARGERICH,25,35,41,17,2,60,58,2,60,0,4,1,10,16,12,13,2,2,0,11,25,21,58
20210711,11JUL2021:00:00:00,UFU BORDA-MOYANO,12,23,19,14,2,35,33,2,33,2,0,2,9,8,6,8,2,0,0,5,19,9,33
20210711,11JUL2021:00:00:00,UFU DURAND,80,68,136,11,1,148,142,6,144,4,3,11,28,51,35,13,3,4,0,22,66,54,142
20210711,11JUL2021:00:00:00,UFU ELIZALDE,120,83,73,127,3,203,167,36,195,8,118,44,8,15,10,7,1,0,0,7,118,42,167
20210711,11JUL2021:00:00:00,UFU FERNANDEZ,58,63,104,6,11,121,103,18,117,4,0,7,26,22,27,24,10,5,0,11,56,36,103
20210711,11JUL2021:00:00:00,UFU FERRER,86,55,55,78,8,141,135,6,135,6,0,0,30,35,31,15,25,5,0,19,78,38,135
20210711,11JUL2021:00:00:00,UFU GRIERSON,119,110,116,108,5,229,219,10,219,10,2,18,68,58,42,38,0,3,0,25,139,55,219
20210711,11JUL2021:00:00:00,UFU GUTIERREZ,148,113,205,52,4,261,257,4,257,4,105,64,19,38,26,5,4,0,0,10,168,79,257
20210711,11JUL2021:00:00:00,UFU MUÑIZ,86,108,92,82,20,194,134,60,178,16,0,4,28,52,53,33,22,2,0,14,89,31,134
20210711,11JUL2021:00:00:00,UFU PENNA,47,33,37,43,0,80,68,12,78,2,6,7,12,11,19,8,12,5,0,8,40,20,68
20210711,11JUL2021:00:00:00,UFU PIROVANO,148,143,233,37,21,291,267,24,279,12,7,17,56,81,70,20,24,16,0,37,121,109,267
20210711,11JUL2021:00:00:00,UFU PIÑERO,83,58,85,46,10,141,135,6,135,6,0,9,28,30,43,27,3,1,0,10,90,33,135
20210711,11JUL2021:00:00:00,UFU RAMOS MEJIA,130,83,161,36,16,213,207,6,209,4,11,3,48,66,41,21,13,10,0,11,134,61,207
20210711,11JUL2021:00:00:00,UFU RIVADAVIA,95,82,137,20,20,177,159,18,159,18,0,7,43,56,31,22,11,7,0,30,63,66,159
20210711,11JUL2021:00:00:00,UFU SANTOJANNI,202,127,187,134,8,329,309,20,319,10,6,30,53,65,56,67,27,25,0,27,196,86,309
20210711,11JUL2021:00:00:00,UFU TORNU,109,75,139,37,8,184,178,6,178,6,14,10,26,40,49,21,9,15,0,15,118,45,178
20210711,11JUL2021:00:00:00,UFU VELEZ SARSFIELD,152,145,222,59,16,297,287,10,295,2,0,12,27,72,69,56,37,24,0,27,179,81,287
20210711,11JUL2021:00:00:00,UFU ZUBIZARRETA,87,46,98,35,0,133,133,0,133,0,0,13,18,29,28,26,11,8,0,12,82,39,133
20210831,31AUG2021:00:00:00,UFU SANTOJANNI,327,259,354,208,24,586,566,20,580,6,6,80,127,114,127,49,58,25,0,9,406,151,566
20210831,31AUG2021:00:00:00,UFU TORNU,271,203,377,82,15,474,360,114,362,112,61,38,79,96,112,46,22,20,0,11,247,101,360
20210831,31AUG2021:00:00:00,UFU VELEZ SARSFIELD,198,166,312,50,2,364,348,16,362,2,0,40,73,74,60,64,30,23,0,11,225,112,348
20210831,31AUG2021:00:00:00,UFU ZUBIZARRETA,255,172,316,89,22,427,425,2,427,0,0,49,80,103,83,62,29,21,0,8,311,106,425
20210901,01SEP2021:00:00:00,UFU ALVAREZ,210,191,281,90,30,401,359,42,367,34,77,34,84,93,54,25,23,11,0,5,262,92,359
20210901,01SEP2021:00:00:00,UFU ARGERICH,74,45,77,38,4,119,105,14,105,14,22,7,20,32,15,18,5,0,0,3,57,43,105
20210901,01SEP2021:00:00:00,UFU BORDA-MOYANO,21,69,57,27,6,90,82,8,82,8,0,12,21,22,23,7,5,0,0,0,56,26,82
20210901,01SEP2021:00:00:00,UFU DURAND,128,93,201,17,3,221,211,10,211,10,30,23,33,51,46,28,3,7,0,11,117,83,211
20210901,01SEP2021:00:00:00,UFU ELIZALDE,163,160,127,192,4,323,282,41,304,19,174,110,3,20,8,5,3,0,0,1,153,128,282
20210901,01SEP2021:00:00:00,UFU FERNANDEZ,88,48,103,20,13,136,118,18,128,8,0,6,21,49,25,10,23,2,0,8,65,45,118
20210901,01SEP2021:00:00:00,UFU FERRER,105,63,95,62,11,168,160,8,164,4,0,3,27,68,29,23,16,2,0,1,115,44,160
20210901,01SEP2021:00:00:00,UFU GRIERSON,152,86,149,75,14,238,232,6,232,6,0,39,44,50,58,39,6,2,0,0,178,54,232
20210901,01SEP2021:00:00:00,UFU GUTIERREZ,153,206,232,125,2,359,347,12,359,0,246,79,5,16,10,3,0,0,0,0,242,104,347
20210901,01SEP2021:00:00:00,UFU MUÑIZ,132,124,119,119,18,256,208,48,216,40,10,45,54,45,40,38,11,13,0,4,155,49,208
20210901,01SEP2021:00:00:00,UFU PENNA,62,37,57,42,0,99,91,8,91,8,24,16,12,7,20,15,3,2,0,2,62,27,91
20210901,01SEP2021:00:00:00,UFU PIROVANO,163,134,244,29,24,297,259,38,295,2,0,20,56,67,75,31,30,18,0,8,151,100,259
20210901,01SEP2021:00:00:00,UFU PIÑERO,185,157,277,48,17,342,306,36,308,34,122,46,41,54,41,11,24,3,0,0,231,73,306
20210901,01SEP2021:00:00:00,UFU RAMOS MEJIA,189,143,270,42,20,332,306,26,312,20,27,27,66,72,71,25,28,16,0,4,219,83,306
20210901,01SEP2021:00:00:00,UFU RIVADAVIA,125,70,134,38,23,195,185,10,187,8,0,8,57,61,28,14,15,12,0,3,102,80,185
20210901,01SEP2021:00:00:00,UFU SANTOJANNI,277,183,300,146,14,460,436,24,452,8,64,38,61,96,102,53,41,5,0,4,320,112,436
20210901,01SEP2021:00:00:00,UFU TORNU,196,162,287,61,10,358,210,148,212,146,59,33,19,89,93,36,20,9,0,13,139,56,210
20210901,01SEP2021:00:00:00,UFU VELEZ SARSFIELD,163,122,239,34,12,285,263,22,281,4,0,26,53,63,55,49,30,9,0,7,191,65,263
20210901,01SEP2021:00:00:00,UFU ZUBIZARRETA,103,131,166,54,14,234,234,0,234,0,0,14,31,48,77,33,19,12,0,6,170,58,234
20210902,02SEP2021:00:00:00,UFU ALVAREZ,176,139,248,32,35,315,299,16,299,16,67,23,68,54,45,20,17,21,0,8,195,96,299
20210902,02SEP2021:00:00:00,UFU ARGERICH,64,57,76,44,1,121,91,30,93,28,26,11,22,28,6,10,12,6,0,4,51,35,91
20210902,02SEP2021:00:00:00,UFU BORDA-MOYANO,51,14,37,24,4,65,65,0,65,0,1,17,5,10,13,13,6,0,0,2,41,22,65
20210902,02SEP2021:00:00:00,UFU DURAND,112,118,204,14,12,230,220,10,222,8,20,29,50,61,35,20,12,3,0,7,122,91,220
20210902,02SEP2021:00:00:00,UFU ELIZALDE,157,133,101,189,0,290,236,54,274,16,193,65,3,15,6,8,0,0,0,0,145,91,236
20210902,02SEP2021:00:00:00,UFU FERNANDEZ,92,80,131,27,14,172,137,35,149,23,0,12,35,50,33,29,6,7,0,3,84,50,137
20210902,02SEP2021:00:00:00,UFU FERRER,81,37,55,60,3,118,114,4,116,2,0,0,35,27,37,13,3,3,0,3,78,33,114
20210902,02SEP2021:00:00:00,UFU GRIERSON,142,82,149,59,16,224,216,8,216,8,0,26,57,50,43,26,11,11,0,3,142,70,216
20210902,02SEP2021:00:00:00,UFU GUTIERREZ,156,177,209,115,9,333,313,20,333,0,210,68,8,17,16,1,13,0,0,0,216,97,313
20210902,02SEP2021:00:00:00,UFU MUÑIZ,146,118,140,102,22,264,202,62,216,48,10,30,35,36,64,56,22,11,0,7,140,55,202
20210902,02SEP2021:00:00:00,UFU PENNA,115,67,116,61,5,182,178,4,178,4,38,19,34,35,19,19,4,14,0,5,116,57,178
20210902,02SEP2021:00:00:00,UFU PIROVANO,198,164,276,40,46,362,338,24,358,4,0,19,87,108,66,41,30,11,0,20,184,134,338
20210902,02SEP2021:00:00:00,UFU PIÑERO,159,156,248,38,29,315,287,28,289,26,105,42,41,51,45,22,5,4,0,0,214,71,287
20210902,02SEP2021:00:00:00,UFU RAMOS MEJIA,194,120,238,47,29,314,292,22,298,16,22,29,72,79,46,27,25,14,0,3,201,88,292
20210902,02SEP2021:00:00:00,UFU RIVADAVIA,151,88,169,40,30,239,231,8,231,8,0,17,59,61,36,28,27,11,0,5,134,92,231
20210902,02SEP2021:00:00:00,UFU SANTOJANNI,222,158,229,135,16,380,374,6,380,0,4,42,79,92,58,47,25,33,0,2,275,97,374
20210902,02SEP2021:00:00:00,UFU TORNU,205,141,295,33,18,346,284,62,286,60,48,27,56,73,84,33,13,12,0,7,187,89,284
20210902,02SEP2021:00:00:00,UFU VELEZ SARSFIELD,182,115,243,40,14,297,291,6,297,0,0,47,38,86,68,28,26,4,0,6,196,89,291
20210902,02SEP2021:00:00:00,UFU ZUBIZARRETA,97,80,141,34,2,177,175,2,177,0,0,16,36,43,41,19,11,11,0,4,128,43,175
20210903,03SEP2021:00:00:00,UFU ALVAREZ,190,167,264,48,45,357,329,28,331,26,48,13,79,70,67,45,21,14,0,7,231,91,329
20210903,03SEP2021:00:00:00,UFU ARGERICH,50,39,56,29,4,89,81,8,81,8,16,19,9,23,5,11,1,5,0,1,45,35,81
20210903,03SEP2021:00:00:00,UFU BORDA-MOYANO,30,19,36,10,3,49,43,6,43,6,0,6,12,8,7,6,10,0,0,0,32,11,43
20210903,03SEP2021:00:00:00,UFU DURAND,122,67,163,15,11,189,181,8,181,8,0,13,45,45,45,23,8,10,0,5,105,71,181
20210903,03SEP2021:00:00:00,UFU ELIZALDE,118,120,73,165,2,240,178,62,198,42,175,37,5,16,6,1,0,0,0,3,102,73,178
20210903,03SEP2021:00:00:00,UFU FERNANDEZ,101,73,139,24,11,174,153,21,161,13,0,3,33,46,29,34,20,9,0,1,100,52,153
20210903,03SEP2021:00:00:00,UFU FERRER,74,62,69,59,8,136,130,6,130,6,0,3,26,48,22,12,14,11,0,2,95,33,130
20210903,03SEP2021:00:00:00,UFU GRIERSON,119,81,121,71,8,200,194,6,196,4,0,35,47,30,38,30,11,9,0,4,141,47,194
20210903,03SEP2021:00:00:00,UFU GUTIERREZ,198,153,260,88,5,353,323,30,335,18,241,63,10,19,8,4,5,3,0,0,224,99,323
20210903,03SEP2021:00:00:00,UFU MUÑIZ,148,114,130,111,23,264,206,58,208,56,20,31,49,51,37,57,15,4,0,1,147,58,206
20210903,03SEP2021:00:00:00,UFU PENNA,102,45,78,61,10,149,133,16,141,8,16,15,29,43,20,10,15,1,0,2,95,35,133
20210903,03SEP2021:00:00:00,UFU PIROVANO,186,139,259,36,30,325,305,20,315,10,0,16,66,91,73,31,30,18,0,7,173,125,305
20210903,03SEP2021:00:00:00,UFU PIÑERO,194,152,314,29,3,346,338,8,338,8,133,59,43,41,34,21,13,2,0,0,246,89,338
20210903,03SEP2021:00:00:00,UFU RAMOS MEJIA,180,124,230,52,24,306,282,24,292,14,30,25,60,80,45,37,19,10,0,8,192,82,282
20210903,03SEP2021:00:00:00,UFU RIVADAVIA,172,120,188,56,50,294,278,16,282,12,2,30,67,59,68,33,25,10,0,6,160,112,278
20210903,03SEP2021:00:00:00,UFU SANTOJANNI,234,143,228,132,19,379,355,24,371,8,43,52,76,45,58,52,38,15,0,5,269,81,355
20210903,03SEP2021:00:00:00,UFU TORNU,187,137,278,42,4,324,282,42,282,42,37,27,39,81,93,28,14,5,0,6,187,89,282
20210903,03SEP2021:00:00:00,UFU VELEZ SARSFIELD,150,120,218,42,12,272,262,10,266,6,2,23,55,81,34,52,13,12,0,6,176,80,262
20210903,03SEP2021:00:00:00,UFU ZUBIZARRETA,56,63,74,36,11,121,117,4,121,0,2,12,20,24,32,18,10,3,0,2,88,27,117
20210904,04SEP2021:00:00:00,UFU ALVAREZ,147,131,224,30,24,278,252,26,252,26,32,10,46,50,48,43,21,28,0,6,180,66,252
20210904,04SEP2021:00:00:00,UFU BORDA-MOYANO,25,22,25,18,4,47,45,2,45,2,2,0,10,10,8,5,8,4,0,0,27,17,45
20210904,04SEP2021:00:00:00,UFU DURAND,122,75,170,17,10,197,189,8,189,8,0,12,31,55,54,19,15,11,0,6,109,74,189
20211025,25OCT2021:00:00:00,UFU TORNU,208,197,323,55,27,405,329,76,347,58,62,45,47,83,100,36,14,18,0,9,207,112,329
20211025,25OCT2021:00:00:00,UFU VELEZ SARSFIELD,166,139,210,88,7,305,301,4,303,2,2,13,66,63,65,42,35,19,0,1,216,84,301
20211025,25OCT2021:00:00:00,UFU ZUBIZARRETA,227,139,242,91,33,366,366,0,366,0,0,57,79,76,50,41,45,18,0,11,259,96,366
20211026,26OCT2021:00:00:00,UFU ALVAREZ,204,155,272,57,30,359,333,26,337,22,53,39,70,69,53,37,14,24,0,8,226,99,333
20211026,26OCT2021:00:00:00,UFU ARGERICH,80,64,74,62,8,144,128,16,132,12,46,14,20,26,14,8,7,9,0,1,68,59,128
20211026,26OCT2021:00:00:00,UFU BORDA-MOYANO,33,26,37,19,3,59,57,2,57,2,2,4,11,23,9,2,8,0,0,0,37,20,57
20211026,26OCT2021:00:00:00,UFU DURAND,124,98,192,15,15,222,212,10,212,10,24,30,41,41,44,14,14,14,0,2,117,93,212
20211026,26OCT2021:00:00:00,UFU ELIZALDE,157,170,83,237,7,327,273,54,313,14,245,68,4,4,2,4,0,0,0,0,184,89,273
20211026,26OCT2021:00:00:00,UFU FERNANDEZ,94,74,143,16,9,168,142,26,152,16,0,5,34,36,43,36,9,5,0,5,80,57,142
20211026,26OCT2021:00:00:00,UFU FERRER,90,59,98,39,12,149,145,4,147,2,0,0,23,61,24,21,8,12,0,5,98,42,145
20211026,26OCT2021:00:00:00,UFU GRIERSON,115,95,125,58,27,210,206,4,206,4,0,33,45,37,46,35,10,4,0,3,151,52,206
20211026,26OCT2021:00:00:00,UFU GUTIERREZ,189,125,142,165,7,314,296,18,312,2,212,67,12,12,6,5,0,0,0,1,180,114,296
20211026,26OCT2021:00:00:00,UFU MUÑIZ,114,150,138,93,33,264,208,56,214,50,0,38,27,61,68,34,19,17,0,2,140,66,208
20211026,26OCT2021:00:00:00,UFU PENNA,88,75,87,70,6,163,153,10,153,10,59,21,22,19,31,6,5,0,0,7,95,51,153
20211026,26OCT2021:00:00:00,UFU PIROVANO,182,134,251,38,27,316,294,22,304,12,0,27,64,84,44,45,31,21,0,20,159,115,294
20211026,26OCT2021:00:00:00,UFU PIÑERO,136,130,206,40,20,266,262,4,262,4,103,53,32,36,24,12,3,3,0,0,193,66,262
20211026,26OCT2021:00:00:00,UFU RAMOS MEJIA,113,107,168,26,26,220,190,30,208,12,19,17,52,42,30,27,20,13,0,5,111,73,190
20211026,26OCT2021:00:00:00,UFU RIVADAVIA,128,95,162,28,33,223,219,4,221,2,0,1,70,46,24,29,35,18,0,4,124,91,219
20211026,26OCT2021:00:00:00,UFU SANTOJANNI,142,119,146,105,10,261,247,14,257,4,5,30,43,50,50,38,36,9,0,0,142,105,247
20211026,26OCT2021:00:00:00,UFU TORNU,254,140,316,45,33,394,328,66,330,64,57,53,67,87,53,32,33,12,0,2,225,96,328
20211026,26OCT2021:00:00:00,UFU VELEZ SARSFIELD,132,123,205,35,15,255,247,8,249,6,0,24,55,53,33,41,37,12,0,6,174,67,247
20211026,26OCT2021:00:00:00,UFU ZUBIZARRETA,131,114,155,67,23,245,245,0,245,0,0,29,49,61,42,19,30,15,0,2,185,58,245
20211027,27OCT2021:00:00:00,UFU ALVAREZ,240,157,305,58,34,397,369,28,373,24,93,35,60,74,35,51,31,18,0,1,273,95,369
20211027,27OCT2021:00:00:00,UFU ARGERICH,68,54,81,28,13,122,92,30,94,28,15,8,29,28,20,8,10,4,0,3,54,35,92
20211027,27OCT2021:00:00:00,UFU BORDA-MOYANO,20,40,39,17,4,60,56,4,56,4,2,9,12,9,19,4,1,4,0,0,34,22,56
20211027,27OCT2021:00:00:00,UFU DURAND,109,104,176,21,16,213,209,4,211,2,23,15,31,51,38,35,8,12,0,0,126,83,209
20211027,27OCT2021:00:00:00,UFU ELIZALDE,106,130,65,160,11,236,200,36,220,16,166,59,2,3,4,2,0,0,0,3,118,79,200
20211027,27OCT2021:00:00:00,UFU FERNANDEZ,79,52,114,6,11,131,123,8,127,4,0,5,27,28,18,12,25,16,0,2,69,52,123
20211027,27OCT2021:00:00:00,UFU FERRER,66,86,89,57,6,152,144,8,150,2,0,3,27,27,38,30,15,12,0,4,94,46,144
20211027,27OCT2021:00:00:00,UFU GRIERSON,124,68,102,83,7,192,162,30,184,8,0,20,45,39,37,29,6,16,0,1,124,37,162
20211027,27OCT2021:00:00:00,UFU GUTIERREZ,136,149,132,131,22,285,259,26,279,6,181,59,18,16,11,0,0,0,0,2,160,97,259
20211027,27OCT2021:00:00:00,UFU MUÑIZ,84,118,98,91,13,202,158,44,164,38,12,12,29,33,45,37,22,12,0,0,122,36,158
20211027,27OCT2021:00:00:00,UFU PENNA,85,52,65,63,9,137,129,8,129,8,57,16,12,22,13,14,2,1,0,3,89,37,129
20211027,27OCT2021:00:00:00,UFU PIROVANO,198,145,258,40,45,343,329,14,337,6,0,17,73,97,73,33,28,22,0,15,189,125,329
20211027,27OCT2021:00:00:00,UFU PIÑERO,107,125,174,38,20,232,226,6,226,6,87,42,15,30,38,14,3,3,0,1,166,59,226
20211027,27OCT2021:00:00:00,UFU RAMOS MEJIA,109,103,155,43,14,212,190,22,192,20,23,24,38,44,39,18,15,11,0,10,98,82,190
20211027,27OCT2021:00:00:00,UFU RIVADAVIA,133,71,151,24,29,204,198,6,198,6,0,5,59,43,26,38,21,12,0,5,116,77,198
20211027,27OCT2021:00:00:00,UFU SANTOJANNI,123,136,139,102,18,259,241,18,251,8,16,37,43,66,45,21,15,16,0,7,128,106,241
20211027,27OCT2021:00:00:00,UFU TORNU,169,143,246,38,28,312,268,44,270,42,23,28,55,49,65,30,39,23,0,2,190,75,268
20211027,27OCT2021:00:00:00,UFU VELEZ SARSFIELD,138,119,179,46,32,257,235,22,251,6,4,13,41,59,51,38,28,23,0,7,165,63,235
20211027,27OCT2021:00:00:00,UFU ZUBIZARRETA,43,35,43,33,2,78,70,8,78,0,0,9,10,6,15,12,17,9,0,2,52,16,70
20211028,28OCT2021:00:00:00,UFU ALVAREZ,171,131,238,45,19,302,275,27,277,25,39,27,58,64,52,25,24,13,0,4,192,79,275
20211028,28OCT2021:00:00:00,UFU ARGERICH,66,45,66,41,4,111,87,24,87,24,14,13,24,12,12,14,7,15,0,0,50,37,87
20211028,28OCT2021:00:00:00,UFU BORDA-MOYANO,22,25,30,11,6,47,41,6,41,6,2,2,3,3,20,4,11,2,0,0,25,16,41
20211028,28OCT2021:00:00:00,UFU DURAND,186,85,242,13,16,271,263,8,263,8,26,21,75,71,28,23,22,5,0,10,150,103,263
20211028,28OCT2021:00:00:00,UFU ELIZALDE,103,124,62,156,9,227,183,44,199,28,166,44,1,12,2,2,0,0,0,0,119,64,183
20211028,28OCT2021:00:00:00,UFU FERNANDEZ,61,60,92,19,10,121,115,6,121,0,0,4,38,34,11,19,10,5,0,2,67,46,115
20211028,28OCT2021:00:00:00,UFU FERRER,79,37,77,36,3,116,110,6,110,6,0,0,20,46,23,10,13,4,0,2,77,31,110
20211028,28OCT2021:00:00:00,UFU GRIERSON,67,74,101,37,3,141,125,16,139,2,0,17,24,33,22,26,8,11,0,1,87,37,125
20211028,28OCT2021:00:00:00,UFU GUTIERREZ,121,102,123,98,2,223,213,10,219,4,133,42,12,16,11,6,3,0,0,2,136,75,213
20211028,28OCT2021:00:00:00,UFU MUÑIZ,113,127,129,92,19,240,204,36,212,28,18,16,35,70,40,28,22,11,0,3,143,58,204
20211028,28OCT2021:00:00:00,UFU PENNA,45,35,54,26,0,80,76,4,78,2,11,12,13,17,16,4,6,1,0,9,41,26,76
20211028,28OCT2021:00:00:00,UFU PIROVANO,139,149,224,29,35,288,274,14,280,8,0,16,81,84,57,19,12,19,0,9,157,108,274
20211028,28OCT2021:00:00:00,UFU PIÑERO,117,86,168,22,13,203,189,14,191,12,84,17,26,34,16,9,15,2,0,0,136,53,189
20211028,28OCT2021:00:00:00,UFU RAMOS MEJIA,72,81,111,27,15,153,133,20,133,20,2,8,31,42,35,14,12,9,0,1,82,50,133
20211028,28OCT2021:00:00:00,UFU RIVADAVIA,111,91,116,49,37,202,194,8,194,8,0,1,48,77,36,16,18,6,0,3,112,79,194
20211028,28OCT2021:00:00:00,UFU SANTOJANNI,130,97,154,56,17,227,213,14,221,6,4,20,42,57,33,23,25,23,0,2,121,90,213
20211028,28OCT2021:00:00:00,UFU TORNU,125,129,209,31,14,254,214,40,216,38,22,36,23,57,50,30,10,26,0,5,139,69,214
20211028,28OCT2021:00:00:00,UFU VELEZ SARSFIELD,123,95,172,28,18,218,212,6,214,4,0,17,32,70,51,25,13,10,0,1,153,58,212
20211028,28OCT2021:00:00:00,UFU ZUBIZARRETA,141,104,159,71,15,245,245,0,245,0,0,35,39,62,57,35,14,3,0,13,173,59,245
20211029,29OCT2021:00:00:00,UFU ALVAREZ,149,141,221,43,26,290,278,12,282,8,56,18,41,70,47,26,15,17,0,2,194,82,278
20211029,29OCT2021:00:00:00,UFU ARGERICH,73,41,70,39,5,114,82,32,82,32,17,1,18,18,25,18,12,5,0,1,46,35,82
20211029,29OCT2021:00:00:00,UFU BORDA-MOYANO,29,13,31,7,4,42,38,4,38,4,0,2,2,8,16,7,3,4,0,0,25,13,38
20211029,29OCT2021:00:00:00,UFU DURAND,115,87,178,10,14,202,194,8,194,8,0,15,39,62,36,15,23,12,0,2,116,76,194
20211029,29OCT2021:00:00:00,UFU ELIZALDE,77,56,43,89,1,133,111,22,127,6,103,23,4,1,2,0,0,0,0,0,67,44,111
20211202,02DEC2021:00:00:00,UFU RIVADAVIA,184,137,232,40,49,321,261,60,261,60,0,59,93,83,24,26,18,18,0,21,117,123,261
20211202,02DEC2021:00:00:00,UFU SANTOJANNI,111,108,131,66,22,219,205,14,213,6,0,21,51,46,35,38,14,14,0,24,105,76,205
20211202,02DEC2021:00:00:00,UFU TORNU,94,92,157,22,7,186,146,40,146,40,9,20,26,53,27,35,11,5,0,6,98,42,146
20211202,02DEC2021:00:00:00,UFU VELEZ SARSFIELD,130,101,168,44,19,231,221,10,225,6,0,16,65,51,38,32,18,11,0,10,150,61,221
20211202,02DEC2021:00:00:00,UFU ZUBIZARRETA,191,159,234,69,47,350,350,0,350,0,0,19,71,90,69,29,46,26,0,13,245,92,350
20211203,03DEC2021:00:00:00,UFU ALVAREZ,176,131,273,22,12,307,281,26,281,26,20,13,57,75,59,38,31,14,0,13,193,75,281
20211203,03DEC2021:00:00:00,UFU ARGERICH,43,27,54,14,2,70,70,0,70,0,0,7,18,21,12,7,5,0,0,6,34,30,70
20211203,03DEC2021:00:00:00,UFU BORDA-MOYANO,21,35,30,25,1,56,50,6,50,6,0,4,15,13,12,7,3,2,0,5,29,16,50
20211203,03DEC2021:00:00:00,UFU DURAND,99,94,179,5,9,193,181,12,181,12,0,10,26,78,28,24,15,12,0,14,88,79,181
20211203,03DEC2021:00:00:00,UFU ELIZALDE,47,65,53,55,4,112,90,22,96,16,75,33,0,4,0,0,0,0,0,2,51,37,90
20211203,03DEC2021:00:00:00,UFU FERNANDEZ,71,79,116,22,12,150,134,16,144,6,0,4,38,54,25,15,5,9,0,14,63,57,134
20211203,03DEC2021:00:00:00,UFU FERRER,85,61,105,41,0,146,128,18,132,14,0,3,26,39,36,29,9,4,0,7,91,30,128
20211203,03DEC2021:00:00:00,UFU GRIERSON,94,83,110,45,22,177,173,4,173,4,0,20,36,36,22,33,17,13,0,9,119,43,173
20211203,03DEC2021:00:00:00,UFU GUTIERREZ,52,52,68,33,3,104,100,4,100,4,54,40,4,3,0,3,0,0,0,0,58,42,100
20211203,03DEC2021:00:00:00,UFU MUÑIZ,139,141,154,96,30,280,238,42,240,40,6,30,38,72,58,36,21,19,0,6,156,76,238
20211203,03DEC2021:00:00:00,UFU PENNA,50,24,60,12,2,74,70,4,70,4,0,12,16,14,25,4,3,0,0,1,51,18,70
20211203,03DEC2021:00:00:00,UFU PIROVANO,226,179,353,24,28,405,373,32,393,12,0,35,107,103,93,24,34,9,0,29,189,155,373
20211203,03DEC2021:00:00:00,UFU PIÑERO,98,74,150,17,5,172,168,4,168,4,0,10,42,46,40,18,8,8,0,5,117,45,168
20211203,03DEC2021:00:00:00,UFU RAMOS MEJIA,117,81,163,14,21,198,180,18,180,18,5,15,27,50,34,23,18,26,0,7,95,78,180
20211203,03DEC2021:00:00:00,UFU RIVADAVIA,213,148,262,49,50,361,359,2,359,2,2,20,118,81,70,33,16,21,0,13,205,141,359
20211203,03DEC2021:00:00:00,UFU SANTOJANNI,109,104,148,58,7,213,205,8,207,6,0,26,38,53,20,26,32,18,0,13,104,88,205
20211203,03DEC2021:00:00:00,UFU TORNU,130,101,204,14,13,231,199,32,201,30,14,19,43,47,50,34,9,15,0,16,105,78,199
20211203,03DEC2021:00:00:00,UFU VELEZ SARSFIELD,119,126,190,49,6,245,241,4,243,2,0,14,42,49,55,33,39,13,0,14,161,66,241
20211203,03DEC2021:00:00:00,UFU ZUBIZARRETA,77,45,95,22,5,122,122,0,122,0,0,16,12,24,33,20,10,7,0,6,86,30,122
20211204,04DEC2021:00:00:00,UFU ALVAREZ,111,88,167,23,9,199,187,12,187,12,4,13,32,59,52,11,10,18,0,11,122,54,187
20211204,04DEC2021:00:00:00,UFU BORDA-MOYANO,25,13,30,8,0,38,38,0,38,0,0,5,4,8,2,13,4,2,0,3,16,19,38
20211204,04DEC2021:00:00:00,UFU DURAND,123,57,163,9,8,180,166,14,166,14,5,4,40,51,33,26,14,7,0,9,93,64,166
20211204,04DEC2021:00:00:00,UFU ELIZALDE,32,30,31,29,2,62,52,10,60,2,37,20,0,0,5,0,0,0,0,0,32,20,52
20211204,04DEC2021:00:00:00,UFU FERNANDEZ,63,33,80,12,4,96,88,8,90,6,0,5,19,28,21,11,9,3,0,5,51,32,88
20211204,04DEC2021:00:00:00,UFU FERRER,54,44,55,38,5,98,94,4,94,4,0,4,16,35,17,12,6,8,0,3,68,23,94
20211204,04DEC2021:00:00:00,UFU GRIERSON,107,85,129,38,25,192,190,2,190,2,0,21,32,31,38,52,14,4,0,14,127,48,190
20211204,04DEC2021:00:00:00,UFU GUTIERREZ,53,66,75,35,9,119,107,12,109,10,73,33,4,7,2,0,0,0,0,0,63,44,107
20211204,04DEC2021:00:00:00,UFU MUÑIZ,127,136,140,98,25,263,217,46,221,42,8,28,53,57,44,38,19,16,0,11,143,63,217
20211204,04DEC2021:00:00:00,UFU PENNA,32,30,49,13,0,62,58,4,60,2,5,4,15,22,3,7,1,5,0,3,43,12,58
20211204,04DEC2021:00:00:00,UFU PIROVANO,142,99,190,26,25,241,233,8,235,6,0,15,65,49,44,38,23,7,0,13,134,86,233
20211204,04DEC2021:00:00:00,UFU PIÑERO,65,62,102,15,10,127,127,0,127,0,0,3,34,24,30,24,7,5,0,15,72,40,127
20211204,04DEC2021:00:00:00,UFU RAMOS MEJIA,47,43,70,11,9,90,76,14,76,14,2,4,14,22,24,15,4,5,0,7,39,30,76
20211204,04DEC2021:00:00:00,UFU RIVADAVIA,98,76,127,28,19,174,174,0,174,0,0,10,46,35,26,21,24,12,0,8,89,77,174
20211204,04DEC2021:00:00:00,UFU SANTOJANNI,99,77,103,52,21,176,166,10,174,2,0,7,37,42,23,22,25,20,0,21,80,65,166
20211204,04DEC2021:00:00:00,UFU TORNU,89,98,157,18,12,187,177,10,177,10,8,13,37,36,53,20,12,8,0,15,101,60,177
20211204,04DEC2021:00:00:00,UFU VELEZ SARSFIELD,117,88,152,43,10,205,201,4,201,4,0,12,38,35,41,30,35,14,0,6,142,53,201
20211204,04DEC2021:00:00:00,UFU ZUBIZARRETA,181,175,258,87,11,356,348,8,356,0,0,20,61,88,80,52,42,13,0,13,241,94,348
20211205,05DEC2021:00:00:00,UFU ALVAREZ,130,107,203,18,16,237,223,14,223,14,17,20,34,63,43,33,15,12,0,11,149,63,223
20211205,05DEC2021:00:00:00,UFU ARGERICH,16,17,22,9,2,33,33,0,33,0,2,0,12,7,7,5,0,0,0,0,20,13,33
20211205,05DEC2021:00:00:00,UFU BORDA-MOYANO,14,20,21,13,0,34,34,0,34,0,0,0,11,9,5,5,2,2,0,1,19,14,34
20211205,05DEC2021:00:00:00,UFU DURAND,105,59,146,1,17,164,152,12,152,12,6,3,39,46,28,16,19,7,0,15,76,61,152
20211205,05DEC2021:00:00:00,UFU ELIZALDE,55,36,19,70,2,91,71,20,85,6,57,27,0,3,4,0,0,0,0,6,37,28,71
20211205,05DEC2021:00:00:00,UFU FERNANDEZ,71,38,95,7,7,109,99,10,99,10,0,3,26,19,20,23,8,10,0,4,59,36,99
20211205,05DEC2021:00:00:00,UFU FERRER,44,32,39,23,14,76,70,6,70,6,0,0,7,33,14,16,6,0,0,6,43,21,70
20211205,05DEC2021:00:00:00,UFU GRIERSON,51,51,62,34,6,102,78,24,80,22,0,12,26,15,15,24,5,5,0,4,52,22,78
20211205,05DEC2021:00:00:00,UFU GUTIERREZ,42,56,62,30,6,98,84,14,86,12,52,30,3,7,4,2,0,0,0,0,45,39,84
20211205,05DEC2021:00:00:00,UFU MUÑIZ,100,108,121,75,12,208,164,44,174,34,4,10,26,48,50,52,10,8,0,14,108,42,164
20211205,05DEC2021:00:00:00,UFU PENNA,38,24,41,19,2,62,58,4,62,0,2,0,14,8,14,6,14,4,0,0,43,15,58
20211205,05DEC2021:00:00:00,UFU PIROVANO,141,134,221,18,36,275,255,20,265,10,15,15,49,73,39,34,27,23,0,26,134,95,255
20211205,05DEC2021:00:00:00,UFU PIÑERO,40,32,64,6,2,72,72,0,72,0,0,5,12,21,8,20,3,3,0,14,40,18,72
20211205,05DEC2021:00:00:00,UFU RAMOS MEJIA,59,60,82,21,16,119,115,4,115,4,0,7,22,32,27,11,11,9,0,7,58,50,115
20211205,05DEC2021:00:00:00,UFU RIVADAVIA,91,69,120,18,22,160,150,10,150,10,0,10,60,37,19,16,12,6,0,10,75,65,150
20211205,05DEC2021:00:00:00,UFU SANTOJANNI,43,41,60,19,5,84,76,8,80,4,0,3,19,22,19,6,10,5,0,11,35,30,76
20211205,05DEC2021:00:00:00,UFU TORNU,120,62,156,21,5,182,162,20,162,20,2,56,18,32,25,23,7,19,0,8,83,71,162
20211205,05DEC2021:00:00:00,UFU VELEZ SARSFIELD,96,98,137,49,8,194,188,6,190,4,0,11,51,48,51,18,13,2,0,12,115,61,188
20211205,05DEC2021:00:00:00,UFU ZUBIZARRETA,176,84,197,55,8,260,260,0,260,0,0,24,46,48,50,46,30,16,0,9,176,75,260
20211206,06DEC2021:00:00:00,UFU ALVAREZ,133,107,191,42,7,240,228,12,230,10,20,16,61,60,29,23,12,19,0,13,111,104,228
20211206,06DEC2021:00:00:00,UFU ARGERICH,98,80,117,59,2,178,124,54,140,38,5,11,38,42,20,30,21,11,0,7,60,57,124
20211206,06DEC2021:00:00:00,UFU BORDA-MOYANO,42,62,74,25,5,104,100,4,100,4,5,12,8,23,21,26,6,3,0,4,61,35,100
20211206,06DEC2021:00:00:00,UFU DURAND,111,83,165,13,16,194,178,16,178,16,0,12,37,65,22,20,29,9,0,16,94,68,178
20211206,06DEC2021:00:00:00,UFU ELIZALDE,98,84,58,122,2,182,152,30,170,12,124,46,4,6,1,1,0,0,0,1,90,61,152
20210712,12JUL2021:00:00:00,UFU ALVAREZ,250,189,331,91,17,439,409,30,417,22,27,26,128,100,73,52,23,10,0,34,276,99,409
20210712,12JUL2021:00:00:00,UFU ARGERICH,88,84,108,54,10,172,143,29,147,25,15,11,27,47,39,18,13,2,0,19,55,68,143
20210712,12JUL2021:00:00:00,UFU BORDA-MOYANO,37,28,33,32,0,65,62,3,62,3,0,0,12,28,4,15,6,0,0,6,37,19,62
20210712,12JUL2021:00:00:00,UFU DURAND,140,111,207,36,8,251,243,8,247,4,0,7,47,86,42,38,22,9,0,28,119,96,243
20210712,12JUL2021:00:00:00,UFU ELIZALDE,165,146,138,169,4,311,285,26,309,2,192,66,21,9,13,7,2,1,0,6,201,78,285
20210712,12JUL2021:00:00:00,UFU FERNANDEZ,144,109,197,41,15,253,237,16,243,10,0,3,68,74,54,34,10,10,0,20,118,99,237
20210712,12JUL2021:00:00:00,UFU FERRER,137,154,137,149,5,291,283,8,283,8,0,2,80,108,50,33,13,5,0,24,178,81,283
20210712,12JUL2021:00:00:00,UFU GRIERSON,177,159,150,154,32,336,318,18,324,12,0,24,99,87,54,45,27,0,0,28,202,88,318
20210712,12JUL2021:00:00:00,UFU GUTIERREZ,134,164,194,104,0,298,285,13,293,5,140,75,34,17,23,5,2,2,0,11,188,85,285
20210712,12JUL2021:00:00:00,UFU MUÑIZ,192,232,168,237,19,424,368,56,384,40,3,18,87,124,114,47,22,9,0,21,247,100,368
20210712,12JUL2021:00:00:00,UFU PENNA,89,61,126,22,2,150,132,18,144,6,2,3,33,25,49,19,9,10,0,13,80,39,132
20210712,12JUL2021:00:00:00,UFU PIROVANO,170,131,238,35,28,301,281,20,297,4,0,11,64,81,73,51,13,8,0,24,145,112,281
20210712,12JUL2021:00:00:00,UFU PIÑERO,119,100,146,73,0,219,213,6,213,6,0,6,41,72,60,21,9,10,0,8,148,56,213
20210712,12JUL2021:00:00:00,UFU RAMOS MEJIA,210,175,284,65,36,385,355,30,365,20,18,33,81,111,77,43,18,4,0,30,196,129,355
20210712,12JUL2021:00:00:00,UFU RIVADAVIA,150,103,171,55,27,253,237,16,245,8,0,12,63,66,52,29,22,9,0,24,111,101,237
20210712,12JUL2021:00:00:00,UFU SANTOJANNI,253,206,213,232,14,459,439,20,449,10,18,24,106,114,89,51,39,18,0,37,287,115,439
20210712,12JUL2021:00:00:00,UFU TORNU,226,189,329,71,15,415,385,30,385,30,36,31,64,109,69,56,32,18,0,25,243,112,385
20210712,12JUL2021:00:00:00,UFU VELEZ SARSFIELD,171,159,256,59,15,330,320,10,322,8,0,12,62,89,84,40,27,16,0,29,183,108,320
20210712,12JUL2021:00:00:00,UFU ZUBIZARRETA,201,162,195,127,41,363,353,10,363,0,0,18,68,99,96,36,30,16,0,20,234,99,353
20210713,13JUL2021:00:00:00,UFU ALVAREZ,233,180,334,64,15,413,369,44,385,28,28,39,110,103,57,45,28,3,0,21,251,97,369
20210713,13JUL2021:00:00:00,UFU ARGERICH,10,9,9,10,0,19,17,2,17,2,0,0,3,2,2,4,1,7,0,1,8,8,17
20210713,13JUL2021:00:00:00,UFU BORDA-MOYANO,54,24,38,39,1,78,72,6,72,6,0,1,19,14,9,17,16,2,0,3,41,28,72
20210713,13JUL2021:00:00:00,UFU DURAND,107,95,146,36,20,202,198,4,198,4,0,5,77,56,29,17,12,6,0,25,91,82,198
20210713,13JUL2021:00:00:00,UFU ELIZALDE,107,85,63,127,2,192,168,24,188,4,106,45,13,15,6,4,3,0,0,3,130,35,168
20210713,13JUL2021:00:00:00,UFU FERNANDEZ,4,0,4,0,0,4,0,4,4,0,0,0,0,2,2,0,0,0,0,0,0,0,0
20210713,13JUL2021:00:00:00,UFU FERRER,156,99,112,121,22,255,241,14,243,12,0,0,64,64,61,45,16,5,0,16,164,61,241
20210713,13JUL2021:00:00:00,UFU GRIERSON,111,108,100,92,27,219,213,6,217,2,0,15,62,57,38,32,13,2,0,23,119,71,213
20210713,13JUL2021:00:00:00,UFU GUTIERREZ,135,127,174,82,6,262,250,12,260,2,132,76,10,25,11,8,0,0,0,7,174,69,250
20210713,13JUL2021:00:00:00,UFU MUÑIZ,171,186,151,186,20,357,255,102,287,70,0,9,71,119,73,53,28,4,0,13,170,72,255
20210713,13JUL2021:00:00:00,UFU PENNA,7,8,8,5,2,15,9,6,13,2,0,0,6,2,3,4,0,0,0,0,6,3,9
20210713,13JUL2021:00:00:00,UFU PIROVANO,161,110,216,30,25,271,259,12,269,2,0,12,77,72,49,30,17,14,0,16,141,102,259
20210713,13JUL2021:00:00:00,UFU PIÑERO,94,60,93,52,9,154,150,4,150,4,0,7,49,37,19,29,8,5,0,7,95,48,150
20210713,13JUL2021:00:00:00,UFU RAMOS MEJIA,144,118,182,40,40,262,256,6,262,0,0,3,83,86,33,29,16,12,0,22,164,70,256
20210713,13JUL2021:00:00:00,UFU RIVADAVIA,238,131,244,72,53,369,361,8,361,8,0,16,116,92,60,41,32,12,0,29,182,148,361
20210713,13JUL2021:00:00:00,UFU SANTOJANNI,167,173,189,126,25,340,316,24,328,12,2,26,105,77,55,39,23,13,0,21,211,84,316
20210713,13JUL2021:00:00:00,UFU TORNU,16,34,30,20,0,50,50,0,50,0,5,5,12,5,10,11,2,0,0,3,29,18,50
20210713,13JUL2021:00:00:00,UFU VELEZ SARSFIELD,185,176,264,74,23,361,347,14,357,4,0,14,118,59,96,40,28,6,0,26,218,103,347
20210713,13JUL2021:00:00:00,UFU ZUBIZARRETA,106,87,106,78,9,193,193,0,193,0,0,13,45,39,44,32,8,12,0,11,130,52,193
20210714,14JUL2021:00:00:00,UFU ALVAREZ,152,148,237,37,26,300,226,74,226,74,29,17,76,62,44,42,26,4,0,27,137,62,226
20210714,14JUL2021:00:00:00,UFU ARGERICH,87,70,106,41,10,157,139,18,141,16,7,4,37,42,31,13,13,10,0,15,69,54,139
20210714,14JUL2021:00:00:00,UFU BORDA-MOYANO,95,49,101,39,4,144,130,14,130,14,0,8,22,32,37,16,22,7,0,11,70,49,130
20210714,14JUL2021:00:00:00,UFU DURAND,138,102,191,28,21,240,234,6,234,6,3,25,84,57,31,25,13,2,0,27,111,96,234
20210714,14JUL2021:00:00:00,UFU ELIZALDE,196,123,80,233,6,319,289,30,301,18,210,55,11,14,15,8,6,0,0,5,206,78,289
20210714,14JUL2021:00:00:00,UFU FERNANDEZ,127,109,179,37,20,236,222,14,222,14,0,3,76,65,32,36,15,9,0,28,106,87,222
20210714,14JUL2021:00:00:00,UFU FERRER,106,114,123,88,9,220,218,2,218,2,0,0,73,62,55,14,14,2,0,15,134,69,218
20210714,14JUL2021:00:00:00,UFU GRIERSON,159,127,161,111,14,286,276,10,278,8,2,23,86,54,62,30,20,9,0,22,183,69,276
20210714,14JUL2021:00:00:00,UFU GUTIERREZ,164,129,206,76,11,293,271,22,293,0,143,68,16,23,36,2,5,0,0,10,186,75,271
20210714,14JUL2021:00:00:00,UFU MUÑIZ,189,177,162,189,15,366,308,58,324,42,0,15,73,102,100,51,19,6,0,12,220,76,308
20210714,14JUL2021:00:00:00,UFU PENNA,74,51,90,30,5,125,115,10,121,4,2,7,28,46,19,15,8,0,0,4,80,31,115
20210714,14JUL2021:00:00:00,UFU PIROVANO,173,131,220,42,42,304,268,36,292,12,0,12,78,82,63,38,18,13,0,26,134,108,268
20210714,14JUL2021:00:00:00,UFU PIÑERO,97,107,136,54,14,204,198,6,198,6,0,6,48,56,35,23,24,12,0,20,125,52,198
20210714,14JUL2021:00:00:00,UFU RAMOS MEJIA,208,149,237,100,20,357,323,34,343,14,24,22,66,103,81,32,18,11,0,20,183,120,323
20210714,14JUL2021:00:00:00,UFU RIVADAVIA,139,115,178,33,43,254,220,34,228,26,0,4,94,74,34,20,18,10,0,32,105,83,220
20210714,14JUL2021:00:00:00,UFU SANTOJANNI,251,188,223,184,32,439,419,20,431,8,13,31,113,116,67,61,19,19,0,31,275,113,419
20210714,14JUL2021:00:00:00,UFU TORNU,206,154,265,67,28,360,318,42,318,42,7,23,87,100,81,37,14,11,0,19,203,93,318
20210714,14JUL2021:00:00:00,UFU VELEZ SARSFIELD,179,127,213,73,20,306,298,8,300,6,2,15,79,75,64,32,35,4,0,25,185,88,298
20210714,14JUL2021:00:00:00,UFU ZUBIZARRETA,162,122,135,118,31,284,284,0,284,0,0,21,59,59,81,28,24,12,0,15,197,72,284
20210715,15JUL2021:00:00:00,UFU ALVAREZ,183,129,223,63,26,312,234,78,234,78,25,22,89,76,51,28,17,4,0,25,126,83,234
20210715,15JUL2021:00:00:00,UFU ARGERICH,81,70,99,37,15,151,119,32,127,24,9,7,39,38,26,16,7,9,0,13,56,49,119
20210715,15JUL2021:00:00:00,UFU BORDA-MOYANO,51,43,56,29,9,94,84,10,84,10,4,9,15,25,19,9,10,3,0,2,53,29,84
20210715,15JUL2021:00:00:00,UFU DURAND,119,93,162,38,12,212,206,6,206,6,11,6,50,60,46,21,16,2,0,20,106,80,206
20210715,15JUL2021:00:00:00,UFU ELIZALDE,154,131,76,205,4,285,267,18,269,16,162,65,13,30,6,9,0,0,0,9,179,79,267
20210715,15JUL2021:00:00:00,UFU FERNANDEZ,105,75,127,34,19,180,160,20,168,12,0,3,51,54,28,25,16,3,0,16,85,59,160
20210715,15JUL2021:00:00:00,UFU FERRER,99,90,121,60,8,189,175,14,175,14,0,4,39,56,49,26,8,7,0,13,120,42,175
20210904,04SEP2021:00:00:00,UFU ELIZALDE,115,103,55,158,5,218,196,22,206,12,126,59,10,9,10,2,0,2,0,1,115,80,196
20210904,04SEP2021:00:00:00,UFU FERNANDEZ,58,49,91,16,0,107,97,10,97,10,1,6,17,29,19,14,13,8,0,3,54,40,97
20210904,04SEP2021:00:00:00,UFU FERRER,73,73,68,75,3,146,140,6,146,0,0,5,13,49,37,26,10,6,0,0,107,33,140
20210904,04SEP2021:00:00:00,UFU GRIERSON,113,67,94,67,19,180,176,4,176,4,0,17,40,21,38,41,13,10,0,10,117,49,176
20210904,04SEP2021:00:00:00,UFU GUTIERREZ,120,145,163,92,10,265,259,6,259,6,194,49,3,8,5,0,6,0,0,1,184,73,259
20210904,04SEP2021:00:00:00,UFU MUÑIZ,70,125,112,66,17,195,149,46,155,40,4,15,17,55,56,32,14,2,0,1,112,36,149
20210904,04SEP2021:00:00:00,UFU PENNA,58,33,57,28,6,91,83,8,83,8,15,16,7,21,18,9,5,0,0,2,57,23,83
20210904,04SEP2021:00:00:00,UFU PIROVANO,127,109,210,16,10,236,228,8,228,8,0,10,47,64,65,32,11,7,0,1,132,95,228
20210904,04SEP2021:00:00:00,UFU PIÑERO,64,57,88,30,3,121,117,4,117,4,0,7,21,32,38,16,3,4,0,3,85,26,117
20210904,04SEP2021:00:00:00,UFU RAMOS MEJIA,116,113,176,34,19,229,218,11,218,11,19,13,44,69,36,20,13,15,0,5,149,64,218
20210904,04SEP2021:00:00:00,UFU RIVADAVIA,74,58,97,21,14,132,132,0,132,0,0,6,35,34,27,19,5,6,0,2,75,55,132
20210904,04SEP2021:00:00:00,UFU SANTOJANNI,179,182,196,142,23,361,353,8,355,6,0,28,49,90,82,65,35,12,0,2,259,92,353
20210904,04SEP2021:00:00:00,UFU TORNU,126,81,156,32,19,207,179,28,179,28,19,16,26,46,53,17,23,7,0,3,133,42,179
20210904,04SEP2021:00:00:00,UFU VELEZ SARSFIELD,184,112,210,70,16,296,288,8,292,4,1,21,53,63,54,40,55,9,0,3,206,79,288
20210904,04SEP2021:00:00:00,UFU ZUBIZARRETA,211,127,240,94,4,338,322,16,338,0,0,48,56,51,70,40,27,46,0,5,238,79,322
20210905,05SEP2021:00:00:00,UFU ALVAREZ,181,127,271,24,13,308,294,14,294,14,45,9,47,73,67,29,24,14,0,10,201,83,294
20210905,05SEP2021:00:00:00,UFU ARGERICH,20,16,24,12,0,36,36,0,36,0,0,0,7,13,9,1,4,2,0,0,21,15,36
20210905,05SEP2021:00:00:00,UFU BORDA-MOYANO,16,13,18,9,2,29,25,4,25,4,0,4,3,3,9,2,6,2,0,0,18,7,25
20210905,05SEP2021:00:00:00,UFU DURAND,82,62,119,19,6,144,140,4,140,4,3,10,24,28,29,22,16,12,0,7,79,54,140
20210905,05SEP2021:00:00:00,UFU ELIZALDE,122,77,62,135,2,199,174,25,194,5,118,33,12,22,10,4,0,0,0,0,94,80,174
20210905,05SEP2021:00:00:00,UFU FERNANDEZ,51,37,74,9,5,88,81,7,87,1,0,2,11,23,17,20,10,5,0,0,49,32,81
20210905,05SEP2021:00:00:00,UFU FERRER,27,45,45,27,0,72,67,5,67,5,0,1,9,16,4,19,12,11,0,0,49,18,67
20210905,05SEP2021:00:00:00,UFU GRIERSON,102,59,108,43,10,161,159,2,159,2,4,15,29,41,39,20,9,4,0,2,112,45,159
20210905,05SEP2021:00:00:00,UFU GUTIERREZ,143,116,180,75,4,259,247,12,255,4,170,50,5,20,10,4,0,0,0,1,184,61,247
20210905,05SEP2021:00:00:00,UFU MUÑIZ,55,72,57,53,17,127,93,34,93,34,4,13,13,25,29,29,12,2,0,0,72,21,93
20210905,05SEP2021:00:00:00,UFU PENNA,58,25,40,38,5,83,77,6,77,6,10,12,18,5,18,13,7,0,0,1,52,24,77
20210905,05SEP2021:00:00:00,UFU PIROVANO,163,132,266,23,6,295,277,18,293,2,26,23,39,66,58,46,23,14,0,9,157,111,277
20210905,05SEP2021:00:00:00,UFU PIÑERO,67,54,90,31,0,121,114,7,114,7,2,14,29,24,24,17,8,3,0,1,83,26,114
20210905,05SEP2021:00:00:00,UFU RAMOS MEJIA,109,89,143,26,29,198,188,10,188,10,11,9,25,55,52,22,20,4,0,4,115,69,188
20210905,05SEP2021:00:00:00,UFU RIVADAVIA,106,76,149,22,11,182,96,86,98,84,0,3,53,43,39,20,13,11,0,2,52,42,96
20210905,05SEP2021:00:00:00,UFU SANTOJANNI,230,152,247,124,11,382,372,10,380,2,21,33,45,66,82,70,33,32,0,8,269,95,372
20210905,05SEP2021:00:00:00,UFU TORNU,95,78,139,28,6,173,159,14,159,14,21,18,18,35,46,12,17,6,0,5,106,48,159
20210905,05SEP2021:00:00:00,UFU VELEZ SARSFIELD,143,105,190,48,10,248,244,4,246,2,0,20,26,44,60,57,27,14,0,10,156,78,244
20210905,05SEP2021:00:00:00,UFU ZUBIZARRETA,64,57,93,28,0,121,119,2,121,0,0,9,25,18,24,20,11,14,0,3,86,30,119
20210906,06SEP2021:00:00:00,UFU ALVAREZ,172,165,259,63,15,337,305,32,309,28,60,15,80,74,55,26,19,8,0,6,211,88,305
20210906,06SEP2021:00:00:00,UFU ARGERICH,76,79,88,62,5,155,137,18,149,6,26,16,24,16,27,20,17,9,0,1,76,57,137
20210906,06SEP2021:00:00:00,UFU BORDA-MOYANO,55,19,56,15,3,74,68,6,68,6,0,8,11,17,11,18,9,0,0,1,44,23,68
20210906,06SEP2021:00:00:00,UFU DURAND,145,95,205,28,7,240,228,12,234,6,21,12,34,73,50,24,11,15,0,10,126,92,228
20210906,06SEP2021:00:00:00,UFU ELIZALDE,178,162,124,212,6,342,306,36,322,20,210,83,15,13,13,6,2,0,0,3,181,122,306
20210906,06SEP2021:00:00:00,UFU FERNANDEZ,109,71,136,34,10,180,166,14,168,12,0,4,39,49,48,18,13,9,0,1,104,61,166
20210906,06SEP2021:00:00:00,UFU FERRER,91,54,82,58,9,149,145,4,147,2,4,0,19,33,45,26,19,3,0,2,107,36,145
20210906,06SEP2021:00:00:00,UFU GRIERSON,111,79,122,56,12,190,184,6,184,6,0,17,47,39,43,33,11,0,0,5,132,46,184
20210906,06SEP2021:00:00:00,UFU GUTIERREZ,234,196,264,159,11,434,416,18,428,6,282,85,16,22,11,8,10,0,0,2,283,131,416
20210906,06SEP2021:00:00:00,UFU MUÑIZ,132,162,117,152,25,294,276,18,276,18,0,20,58,57,92,42,19,6,0,0,212,64,276
20210906,06SEP2021:00:00:00,UFU PENNA,124,102,127,90,9,226,216,10,216,10,41,26,41,41,33,25,11,8,0,3,141,72,216
20210906,06SEP2021:00:00:00,UFU PIROVANO,189,128,261,28,30,319,301,18,305,14,2,18,66,111,48,34,22,18,0,4,171,126,301
20210906,06SEP2021:00:00:00,UFU PIÑERO,203,171,308,50,16,374,368,6,368,6,137,56,33,50,58,22,9,9,0,2,267,94,368
20210906,06SEP2021:00:00:00,UFU RAMOS MEJIA,191,163,254,82,18,354,332,22,336,18,39,30,46,71,63,61,28,16,0,12,220,99,332
20210906,06SEP2021:00:00:00,UFU RIVADAVIA,113,86,148,37,14,199,185,14,187,12,0,11,43,44,34,31,20,16,0,3,109,73,185
20210906,06SEP2021:00:00:00,UFU SANTOJANNI,225,195,283,127,12,422,416,6,418,4,39,46,97,72,70,43,31,24,0,12,285,119,416
20210906,06SEP2021:00:00:00,UFU TORNU,176,153,277,45,7,329,273,56,275,54,42,33,50,71,82,37,9,5,0,3,189,81,273
20210906,06SEP2021:00:00:00,UFU VELEZ SARSFIELD,161,133,228,47,19,294,292,2,294,0,0,18,47,77,70,36,29,17,0,5,206,81,292
20210906,06SEP2021:00:00:00,UFU ZUBIZARRETA,193,163,222,104,30,356,348,8,356,0,0,33,69,75,76,59,31,13,0,7,254,87,348
20210907,07SEP2021:00:00:00,UFU ALVAREZ,168,147,261,36,18,315,305,10,305,10,49,20,45,68,60,27,35,11,0,4,223,78,305
20210907,07SEP2021:00:00:00,UFU ARGERICH,56,34,50,38,2,90,80,10,84,6,8,7,26,7,13,12,12,5,0,0,45,34,80
20210907,07SEP2021:00:00:00,UFU BORDA-MOYANO,25,32,41,16,0,57,57,0,57,0,3,2,8,12,9,6,13,4,0,0,38,18,57
20210907,07SEP2021:00:00:00,UFU DURAND,110,75,159,8,18,185,181,4,181,4,0,13,40,57,28,20,11,16,0,8,99,74,181
20210907,07SEP2021:00:00:00,UFU ELIZALDE,90,91,66,113,2,181,161,20,169,12,86,51,13,17,10,4,0,0,0,0,103,58,161
20210907,07SEP2021:00:00:00,UFU FERNANDEZ,78,50,98,20,10,128,112,16,112,16,0,11,29,28,21,12,12,15,0,0,66,46,112
20210907,07SEP2021:00:00:00,UFU FERRER,83,50,67,64,2,133,125,8,129,4,0,2,41,30,32,11,17,0,0,4,92,29,125
20210907,07SEP2021:00:00:00,UFU GRIERSON,121,100,123,93,5,221,211,10,213,8,0,37,57,44,38,16,19,10,0,0,157,54,211
20210907,07SEP2021:00:00:00,UFU GUTIERREZ,222,130,226,119,7,352,338,14,348,4,217,87,15,9,16,5,3,0,0,0,225,112,338
20210907,07SEP2021:00:00:00,UFU MUÑIZ,141,111,119,126,7,252,208,44,214,38,8,29,44,49,58,38,19,7,0,3,140,65,208
20210907,07SEP2021:00:00:00,UFU PENNA,78,86,95,67,2,164,154,10,156,8,22,27,23,43,28,11,6,4,0,2,113,39,154
20210907,07SEP2021:00:00:00,UFU PIROVANO,142,98,163,32,45,240,226,14,232,8,2,16,51,61,59,19,14,18,0,5,125,96,226
20211029,29OCT2021:00:00:00,UFU FERNANDEZ,101,46,119,14,14,147,121,26,141,6,0,6,35,42,20,25,14,5,0,0,83,38,121
20211029,29OCT2021:00:00:00,UFU FERRER,93,42,73,47,15,135,127,8,129,6,0,0,28,33,25,29,8,12,0,2,97,28,127
20211029,29OCT2021:00:00:00,UFU GRIERSON,103,78,121,53,7,181,143,38,181,0,0,4,50,29,42,25,12,19,0,0,103,39,143
20211029,29OCT2021:00:00:00,UFU GUTIERREZ,109,109,136,70,12,218,196,22,214,4,142,40,16,10,3,4,3,0,0,16,115,64,196
20211029,29OCT2021:00:00:00,UFU MUÑIZ,95,99,103,74,17,194,154,40,158,36,4,7,39,59,27,21,21,16,0,1,112,41,154
20211029,29OCT2021:00:00:00,UFU PENNA,85,53,82,52,4,138,116,22,134,4,30,3,23,31,20,12,13,6,0,8,76,32,116
20211029,29OCT2021:00:00:00,UFU PIROVANO,128,112,188,25,27,240,168,72,236,4,0,10,62,62,57,25,11,13,0,5,92,71,168
20211029,29OCT2021:00:00:00,UFU PIÑERO,113,85,167,20,11,198,196,2,196,2,50,28,36,32,21,12,15,4,0,0,150,45,196
20211029,29OCT2021:00:00:00,UFU RAMOS MEJIA,78,83,123,21,17,161,135,26,149,12,14,6,28,38,21,38,10,6,0,3,83,49,135
20211029,29OCT2021:00:00:00,UFU RIVADAVIA,120,76,142,34,20,196,176,20,192,4,0,10,51,57,21,25,19,13,0,2,107,67,176
20211029,29OCT2021:00:00:00,UFU SANTOJANNI,100,72,116,41,15,172,164,8,172,0,14,20,37,28,24,27,11,11,0,5,92,67,164
20211029,29OCT2021:00:00:00,UFU TORNU,161,101,219,24,19,262,220,42,222,40,37,28,42,38,60,29,20,8,0,4,146,70,220
20211029,29OCT2021:00:00:00,UFU VELEZ SARSFIELD,127,104,186,35,10,231,227,4,227,4,0,18,47,36,57,23,22,28,0,4,153,70,227
20211029,29OCT2021:00:00:00,UFU ZUBIZARRETA,71,68,100,30,9,139,139,0,139,0,0,14,23,24,44,3,19,12,0,3,100,36,139
20211030,30OCT2021:00:00:00,UFU ALVAREZ,107,93,161,34,5,200,188,12,188,12,20,4,40,32,49,28,11,16,0,1,137,50,188
20211030,30OCT2021:00:00:00,UFU ARGERICH,2,2,2,2,0,4,4,0,4,0,0,2,0,2,0,0,0,0,0,0,2,2,4
20211030,30OCT2021:00:00:00,UFU BORDA-MOYANO,13,11,15,7,2,24,22,2,22,2,2,0,11,2,3,4,2,0,0,0,16,6,22
20211030,30OCT2021:00:00:00,UFU DURAND,90,70,133,17,10,160,152,8,152,8,3,7,26,51,24,16,26,7,0,2,89,61,152
20211030,30OCT2021:00:00:00,UFU ELIZALDE,88,87,41,134,0,175,155,20,161,14,137,28,8,1,1,0,0,0,0,0,103,52,155
20211030,30OCT2021:00:00:00,UFU FERNANDEZ,27,38,58,5,2,65,59,6,59,6,0,4,8,20,7,11,10,5,0,1,36,21,59
20211030,30OCT2021:00:00:00,UFU FERRER,65,33,46,49,3,98,90,8,92,6,0,3,23,21,24,8,13,6,0,0,71,19,90
20211030,30OCT2021:00:00:00,UFU GRIERSON,52,58,75,23,12,110,104,6,106,4,0,17,12,40,16,13,12,0,0,0,79,23,104
20211030,30OCT2021:00:00:00,UFU GUTIERREZ,86,99,99,84,2,185,177,8,177,8,125,37,6,5,6,4,2,0,0,0,116,60,177
20211030,30OCT2021:00:00:00,UFU MUÑIZ,50,63,58,44,11,113,95,18,95,18,3,7,18,28,22,24,4,7,0,0,71,24,95
20211030,30OCT2021:00:00:00,UFU PENNA,63,57,80,36,4,120,110,10,112,8,24,4,16,29,23,18,2,4,0,0,80,29,110
20211030,30OCT2021:00:00:00,UFU PIROVANO,103,111,183,19,12,214,204,10,206,8,0,13,39,50,38,35,21,18,0,7,115,82,204
20211030,30OCT2021:00:00:00,UFU PIÑERO,53,43,71,23,2,96,96,0,96,0,0,6,19,24,29,13,4,1,0,3,68,22,96
20211030,30OCT2021:00:00:00,UFU RAMOS MEJIA,78,63,117,10,14,141,131,10,137,4,0,15,33,32,19,16,18,8,0,4,50,77,131
20211030,30OCT2021:00:00:00,UFU RIVADAVIA,74,52,90,15,21,126,126,0,126,0,0,6,39,30,12,17,8,14,0,0,72,52,126
20211030,30OCT2021:00:00:00,UFU SANTOJANNI,98,63,69,83,9,161,159,2,161,0,0,12,30,31,33,17,21,17,0,10,83,66,159
20211030,30OCT2021:00:00:00,UFU TORNU,90,53,122,9,12,143,117,26,117,26,20,10,10,30,38,15,15,5,0,6,66,45,117
20211030,30OCT2021:00:00:00,UFU VELEZ SARSFIELD,93,86,143,31,5,179,175,4,177,2,0,20,20,39,42,21,18,19,0,3,115,57,175
20211030,30OCT2021:00:00:00,UFU ZUBIZARRETA,136,144,218,54,8,280,276,4,280,0,0,38,42,46,53,41,32,28,0,4,203,69,276
20211031,31OCT2021:00:00:00,UFU ALVAREZ,125,88,187,23,3,213,193,20,195,18,24,33,21,31,38,30,25,11,0,6,138,49,193
20211031,31OCT2021:00:00:00,UFU ARGERICH,0,15,7,6,2,15,13,2,15,0,2,2,2,2,3,2,0,2,0,2,6,5,13
20211031,31OCT2021:00:00:00,UFU BORDA-MOYANO,22,36,37,19,2,58,52,6,52,6,0,5,14,13,9,4,6,7,0,0,34,18,52
20211031,31OCT2021:00:00:00,UFU DURAND,61,37,82,10,6,98,90,8,90,8,10,6,6,19,27,19,5,6,0,1,57,32,90
20211031,31OCT2021:00:00:00,UFU ELIZALDE,92,107,68,129,2,199,131,68,197,2,157,31,5,2,4,0,0,0,0,0,76,54,131
20211031,31OCT2021:00:00:00,UFU FERNANDEZ,53,27,69,10,1,80,74,6,76,4,0,3,10,28,8,8,11,12,0,1,35,38,74
20211031,31OCT2021:00:00:00,UFU FERRER,63,37,47,48,5,100,100,0,100,0,0,0,8,14,28,19,20,11,0,3,69,28,100
20211031,31OCT2021:00:00:00,UFU GRIERSON,51,41,64,21,7,92,90,2,90,2,0,11,26,17,12,16,7,3,0,1,64,25,90
20211031,31OCT2021:00:00:00,UFU GUTIERREZ,108,90,100,94,4,198,190,8,190,8,136,45,0,8,7,2,0,0,0,7,124,59,190
20211031,31OCT2021:00:00:00,UFU MUÑIZ,34,56,40,47,3,90,74,16,74,16,0,11,12,19,26,15,3,4,0,3,53,18,74
20211031,31OCT2021:00:00:00,UFU PENNA,38,32,43,25,2,70,68,2,68,2,26,2,10,11,9,6,3,3,0,0,51,17,68
20211031,31OCT2021:00:00:00,UFU PIROVANO,118,99,188,18,11,217,201,16,213,4,11,14,37,56,49,25,13,12,0,8,111,82,201
20211031,31OCT2021:00:00:00,UFU PIÑERO,49,34,52,22,9,83,77,6,77,6,0,17,10,9,22,14,5,6,0,1,57,18,77
20211031,31OCT2021:00:00:00,UFU RAMOS MEJIA,58,38,76,9,11,96,96,0,96,0,3,0,30,12,17,19,13,2,0,3,53,39,96
20211031,31OCT2021:00:00:00,UFU RIVADAVIA,45,30,56,13,6,75,73,2,73,2,0,0,19,17,15,14,7,3,0,0,43,29,73
20211031,31OCT2021:00:00:00,UFU SANTOJANNI,92,72,100,55,9,164,152,12,160,4,0,14,25,21,36,23,26,19,0,8,74,70,152
20211031,31OCT2021:00:00:00,UFU TORNU,72,50,97,23,2,122,102,20,102,20,16,16,14,35,20,12,5,4,0,3,66,33,102
20211031,31OCT2021:00:00:00,UFU VELEZ SARSFIELD,92,63,97,54,4,155,149,6,155,0,0,7,27,40,37,17,24,3,0,6,102,41,149
20211031,31OCT2021:00:00:00,UFU ZUBIZARRETA,92,64,103,51,2,156,156,0,156,0,0,8,31,35,32,14,23,13,0,3,116,37,156
20211101,01NOV2021:00:00:00,UFU ALVAREZ,164,179,259,60,24,343,321,22,327,16,43,34,52,81,37,39,39,18,0,1,236,84,321
20211101,01NOV2021:00:00:00,UFU ARGERICH,77,57,91,35,8,134,112,22,114,20,29,6,22,21,18,20,12,6,0,0,62,50,112
20211101,01NOV2021:00:00:00,UFU BORDA-MOYANO,44,20,28,26,10,64,44,20,44,20,0,13,2,24,16,5,2,2,0,1,27,16,44
20211101,01NOV2021:00:00:00,UFU DURAND,137,108,221,14,10,245,235,10,235,10,9,24,42,50,48,30,24,18,0,10,129,96,235
20211101,01NOV2021:00:00:00,UFU ELIZALDE,112,114,64,144,18,226,156,70,202,24,164,53,4,0,5,0,0,0,0,1,91,64,156
20211101,01NOV2021:00:00:00,UFU FERNANDEZ,76,73,125,17,7,149,129,20,135,14,0,10,27,35,29,27,12,9,0,1,72,55,129
20211101,01NOV2021:00:00:00,UFU FERRER,85,73,91,62,5,158,154,4,154,4,0,2,27,36,31,34,26,2,0,2,110,42,154
20211101,01NOV2021:00:00:00,UFU GRIERSON,121,112,139,85,9,233,225,8,227,6,0,42,44,61,33,34,11,8,0,0,169,56,225
20211101,01NOV2021:00:00:00,UFU GUTIERREZ,122,148,135,123,12,270,256,14,260,10,181,61,13,11,2,0,2,0,0,3,164,89,256
20211101,01NOV2021:00:00:00,UFU MUÑIZ,167,112,136,124,19,279,243,36,249,30,13,27,29,53,69,53,23,12,0,2,168,73,243
20211101,01NOV2021:00:00:00,UFU PENNA,112,70,104,72,6,182,152,30,170,12,44,24,22,31,12,20,22,7,0,3,104,45,152
20211101,01NOV2021:00:00:00,UFU PIROVANO,169,134,248,34,21,303,291,12,291,12,0,14,51,88,50,50,27,23,0,10,173,108,291
20211101,01NOV2021:00:00:00,UFU PIÑERO,131,69,183,12,5,200,190,10,192,8,85,37,13,19,27,13,6,0,0,0,143,46,190
20211101,01NOV2021:00:00:00,UFU RAMOS MEJIA,163,107,169,66,35,270,220,50,238,32,15,17,48,61,45,31,28,25,0,4,126,90,220
20211206,06DEC2021:00:00:00,UFU FERNANDEZ,108,94,172,19,11,202,186,16,190,12,0,9,63,47,26,37,11,9,0,24,88,73,186
20211206,06DEC2021:00:00:00,UFU FERRER,60,50,69,38,3,110,108,2,110,0,0,4,17,29,33,19,2,6,0,9,74,25,108
20211206,06DEC2021:00:00:00,UFU GRIERSON,67,117,104,59,21,184,180,4,180,4,0,20,44,45,28,26,16,5,0,14,123,41,180
20211206,06DEC2021:00:00:00,UFU GUTIERREZ,96,94,111,79,0,190,183,7,190,0,118,43,0,10,13,2,4,0,0,4,75,104,183
20211206,06DEC2021:00:00:00,UFU MUÑIZ,138,144,153,85,44,282,258,24,262,20,8,26,59,59,63,42,17,8,0,11,167,80,258
20211206,06DEC2021:00:00:00,UFU PENNA,34,36,58,12,0,70,64,6,66,4,2,3,17,17,3,20,6,2,0,3,43,18,64
20211206,06DEC2021:00:00:00,UFU PIROVANO,211,201,303,53,56,412,388,24,404,8,0,12,100,122,73,56,19,30,0,26,231,131,388
20211206,06DEC2021:00:00:00,UFU PIÑERO,146,131,225,36,16,277,257,20,257,20,53,38,39,46,50,19,22,10,0,8,176,72,257
20211206,06DEC2021:00:00:00,UFU RAMOS MEJIA,132,125,195,38,24,257,229,28,237,20,6,11,52,79,43,19,30,17,0,17,124,88,229
20211206,06DEC2021:00:00:00,UFU RIVADAVIA,169,131,226,52,22,300,284,16,286,14,0,17,90,93,25,32,20,23,0,12,157,115,284
20211206,06DEC2021:00:00:00,UFU SANTOJANNI,157,155,195,117,0,312,301,11,312,0,7,43,40,56,51,56,44,15,0,14,184,103,301
20211206,06DEC2021:00:00:00,UFU TORNU,173,100,225,32,16,273,243,30,243,30,5,21,44,59,55,37,35,17,0,16,139,88,243
20211206,06DEC2021:00:00:00,UFU VELEZ SARSFIELD,121,121,175,64,3,242,230,12,230,12,0,12,64,54,35,46,21,10,0,28,121,81,230
20211206,06DEC2021:00:00:00,UFU ZUBIZARRETA,205,191,223,130,43,396,390,6,396,0,0,12,84,93,91,49,38,29,0,14,264,112,390
20211207,07DEC2021:00:00:00,UFU ALVAREZ,172,111,210,60,13,283,269,14,271,12,13,11,63,60,64,28,26,18,0,10,175,84,269
20211207,07DEC2021:00:00:00,UFU ARGERICH,38,55,61,25,7,93,81,12,83,10,9,7,33,12,10,14,3,5,0,7,43,31,81
20211207,07DEC2021:00:00:00,UFU BORDA-MOYANO,33,28,40,16,5,61,57,4,57,4,0,2,3,19,24,2,5,6,0,1,37,19,57
20211207,07DEC2021:00:00:00,UFU DURAND,95,54,134,13,2,149,145,4,145,4,0,12,34,46,22,12,14,9,0,18,62,65,145
20211207,07DEC2021:00:00:00,UFU ELIZALDE,59,66,36,86,3,125,107,18,125,0,94,23,2,2,0,2,2,0,0,1,66,40,107
20211207,07DEC2021:00:00:00,UFU FERNANDEZ,128,91,187,19,13,219,187,32,217,2,0,12,61,69,37,25,9,6,0,15,82,90,187
20211207,07DEC2021:00:00:00,UFU FERRER,68,29,56,41,0,97,97,0,97,0,0,0,12,27,35,11,9,3,0,2,75,20,97
20211207,07DEC2021:00:00:00,UFU GRIERSON,74,90,98,49,17,164,158,6,158,6,0,9,41,41,45,17,9,2,0,5,116,36,158
20211207,07DEC2021:00:00:00,UFU GUTIERREZ,99,57,84,60,12,156,126,30,150,6,106,31,6,9,2,2,0,0,0,2,54,61,126
20211207,07DEC2021:00:00:00,UFU MUÑIZ,156,124,128,120,32,280,236,44,248,32,6,28,55,64,62,44,11,10,0,14,146,76,236
20211207,07DEC2021:00:00:00,UFU PENNA,76,43,72,41,6,119,109,10,117,2,23,8,22,31,16,9,6,4,0,11,68,30,109
20211207,07DEC2021:00:00:00,UFU PIROVANO,214,157,311,32,28,371,355,16,361,10,0,18,93,109,58,44,20,29,0,35,173,145,355
20211207,07DEC2021:00:00:00,UFU PIÑERO,81,45,93,18,15,126,122,4,122,4,33,17,23,12,15,6,13,7,0,6,82,32,122
20211207,07DEC2021:00:00:00,UFU RAMOS MEJIA,133,110,176,40,27,243,208,35,224,19,6,20,69,54,37,31,13,13,0,18,100,90,208
20211207,07DEC2021:00:00:00,UFU RIVADAVIA,157,96,167,57,29,253,247,6,251,2,0,5,60,84,41,40,15,8,0,15,134,98,247
20211207,07DEC2021:00:00:00,UFU SANTOJANNI,91,79,97,67,6,170,160,10,164,6,0,16,48,31,15,23,15,22,0,14,77,69,160
20211207,07DEC2021:00:00:00,UFU TORNU,163,118,222,38,21,281,241,40,243,38,10,25,49,79,62,25,10,21,0,15,146,79,241
20211207,07DEC2021:00:00:00,UFU VELEZ SARSFIELD,126,105,175,53,3,231,229,2,231,0,0,14,49,58,45,13,23,29,0,13,145,71,229
20211207,07DEC2021:00:00:00,UFU ZUBIZARRETA,181,155,220,85,31,336,332,4,336,0,0,44,70,72,61,46,24,19,0,16,229,87,332
20211208,08DEC2021:00:00:00,UFU ALVAREZ,180,122,259,30,13,302,280,22,280,22,28,23,74,51,50,24,40,12,0,12,191,77,280
20211208,08DEC2021:00:00:00,UFU ARGERICH,40,36,46,26,4,76,76,0,76,0,2,7,13,10,9,18,13,4,0,10,32,34,76
20211208,08DEC2021:00:00:00,UFU BORDA-MOYANO,28,12,24,16,0,40,36,4,36,4,0,6,4,16,9,5,0,0,0,3,22,11,36
20211208,08DEC2021:00:00:00,UFU DURAND,83,66,138,5,6,149,143,6,143,6,0,11,30,42,33,20,11,2,0,19,66,58,143
20211208,08DEC2021:00:00:00,UFU ELIZALDE,50,49,32,62,5,99,95,4,99,0,76,13,2,5,3,0,0,0,0,0,54,41,95
20211208,08DEC2021:00:00:00,UFU FERNANDEZ,101,49,132,6,12,150,128,22,144,6,0,11,43,37,23,13,12,11,0,11,61,56,128
20211208,08DEC2021:00:00:00,UFU FERRER,64,37,57,44,0,101,93,8,97,4,0,4,25,31,19,17,5,0,0,10,61,22,93
20211208,08DEC2021:00:00:00,UFU GRIERSON,64,59,75,45,3,123,119,4,119,4,0,9,23,31,28,14,12,6,0,6,77,36,119
20211208,08DEC2021:00:00:00,UFU GUTIERREZ,56,44,72,22,6,100,88,12,90,10,59,15,2,11,4,7,2,0,0,0,54,34,88
20211208,08DEC2021:00:00:00,UFU MUÑIZ,102,110,78,111,23,212,192,20,200,12,10,17,31,68,40,22,17,7,0,3,127,62,192
20211208,08DEC2021:00:00:00,UFU PENNA,42,17,39,15,5,59,57,2,57,2,7,3,11,9,17,10,0,2,0,9,32,16,57
20211208,08DEC2021:00:00:00,UFU PIROVANO,226,203,355,48,26,429,405,24,419,10,0,20,111,132,68,49,29,20,0,30,210,165,405
20211208,08DEC2021:00:00:00,UFU PIÑERO,54,41,84,4,7,95,95,0,95,0,0,4,28,31,11,10,8,3,0,5,60,28,95
20211208,08DEC2021:00:00:00,UFU RAMOS MEJIA,74,77,123,9,19,151,139,12,139,12,2,9,43,39,25,21,8,4,0,16,62,61,139
20211208,08DEC2021:00:00:00,UFU RIVADAVIA,221,130,279,31,41,351,267,84,269,82,2,9,113,99,43,35,29,21,0,26,130,110,267
20211208,08DEC2021:00:00:00,UFU SANTOJANNI,87,97,113,67,4,184,178,6,180,4,0,9,39,33,33,34,17,19,0,9,90,79,178
20211208,08DEC2021:00:00:00,UFU TORNU,101,71,152,15,5,172,162,10,162,10,3,7,34,39,50,19,11,9,0,14,63,84,162
20211208,08DEC2021:00:00:00,UFU VELEZ SARSFIELD,157,85,203,30,9,242,238,4,238,4,0,5,46,52,54,31,38,16,0,11,157,70,238
20211208,08DEC2021:00:00:00,UFU ZUBIZARRETA,152,96,168,65,15,248,234,14,248,0,0,25,66,37,42,23,30,25,0,7,158,69,234
20211209,09DEC2021:00:00:00,UFU ALVAREZ,227,151,298,52,28,378,362,16,362,16,12,21,97,107,56,48,10,27,0,24,209,129,362
20211209,09DEC2021:00:00:00,UFU ARGERICH,54,65,62,54,3,119,107,12,109,10,6,8,21,26,24,12,13,9,0,11,44,51,107
20211209,09DEC2021:00:00:00,UFU BORDA-MOYANO,77,38,64,42,9,115,85,30,85,30,5,3,21,26,28,14,8,10,0,2,46,37,85
20211209,09DEC2021:00:00:00,UFU DURAND,102,69,150,13,8,171,167,4,167,4,0,8,37,45,33,18,17,13,0,28,74,65,167
20211209,09DEC2021:00:00:00,UFU ELIZALDE,76,57,38,90,5,133,113,20,127,6,87,43,0,0,3,0,0,0,0,0,72,41,113
20211209,09DEC2021:00:00:00,UFU FERNANDEZ,137,131,230,16,22,268,238,30,240,28,0,10,81,75,47,30,11,14,0,22,99,117,238
20211209,09DEC2021:00:00:00,UFU FERRER,50,44,43,51,0,94,90,4,92,2,0,4,32,16,27,7,4,4,0,11,63,16,90
20211209,09DEC2021:00:00:00,UFU GRIERSON,122,98,134,62,24,220,216,4,216,4,0,24,32,63,50,23,17,11,0,8,158,50,216
20211209,09DEC2021:00:00:00,UFU GUTIERREZ,91,86,112,63,2,177,164,13,173,4,115,41,5,5,3,8,0,0,0,0,85,79,164
20211209,09DEC2021:00:00:00,UFU MUÑIZ,196,218,201,167,46,414,356,58,368,46,20,23,75,113,71,62,39,11,0,22,232,102,356
20211209,09DEC2021:00:00:00,UFU PENNA,84,41,81,40,4,125,115,10,123,2,25,4,9,36,20,23,8,0,0,3,84,28,115
20211209,09DEC2021:00:00:00,UFU PIROVANO,253,241,425,38,31,494,471,23,484,10,0,12,139,149,84,45,32,33,0,48,266,157,471
20211209,09DEC2021:00:00:00,UFU PIÑERO,139,128,183,54,30,267,255,12,255,12,42,48,27,53,33,24,23,17,0,14,173,68,255
20210715,15JUL2021:00:00:00,UFU GRIERSON,142,131,143,103,27,273,265,8,267,6,0,9,83,61,58,35,19,8,0,15,185,63,265
20210715,15JUL2021:00:00:00,UFU GUTIERREZ,160,108,183,60,25,268,254,14,264,4,116,45,48,29,15,8,7,0,0,11,171,71,254
20210715,15JUL2021:00:00:00,UFU MUÑIZ,177,176,146,201,6,353,301,52,311,42,3,10,103,66,70,57,36,8,0,20,196,85,301
20210715,15JUL2021:00:00:00,UFU PENNA,89,57,127,10,9,146,132,14,142,4,0,9,23,27,47,19,15,6,0,11,80,41,132
20210715,15JUL2021:00:00:00,UFU PIROVANO,209,167,281,49,46,376,342,34,366,10,0,11,106,117,72,44,20,6,0,42,163,137,342
20210715,15JUL2021:00:00:00,UFU PIÑERO,126,113,167,52,20,239,229,10,229,10,0,16,59,69,61,17,15,2,0,11,150,63,229
20210715,15JUL2021:00:00:00,UFU RAMOS MEJIA,166,192,240,87,31,358,334,24,344,14,13,20,118,74,46,54,16,17,0,26,181,127,334
20210715,15JUL2021:00:00:00,UFU RIVADAVIA,148,95,166,44,33,243,193,50,195,48,0,6,98,66,30,32,6,5,0,18,96,78,193
20210715,15JUL2021:00:00:00,UFU SANTOJANNI,229,180,219,157,33,409,377,32,393,16,20,43,75,86,76,69,27,13,0,27,252,98,377
20210715,15JUL2021:00:00:00,UFU TORNU,159,175,239,74,21,334,304,30,306,28,21,22,76,91,59,26,23,16,0,27,189,83,304
20210715,15JUL2021:00:00:00,UFU VELEZ SARSFIELD,185,173,261,69,28,358,338,20,352,6,2,14,92,79,82,52,31,6,0,34,208,96,338
20210715,15JUL2021:00:00:00,UFU ZUBIZARRETA,140,140,168,78,34,280,280,0,280,0,0,26,70,54,65,34,24,7,0,22,180,78,280
20210716,16JUL2021:00:00:00,UFU ALVAREZ,199,154,288,44,21,353,309,44,311,42,21,35,80,78,67,20,25,27,0,17,216,76,309
20210716,16JUL2021:00:00:00,UFU ARGERICH,63,45,78,30,0,108,90,18,92,16,16,10,13,27,27,8,4,3,0,9,41,40,90
20210716,16JUL2021:00:00:00,UFU BORDA-MOYANO,56,52,63,41,4,108,90,18,90,18,0,6,31,27,21,11,8,4,0,5,50,35,90
20210716,16JUL2021:00:00:00,UFU DURAND,125,93,182,20,16,218,216,2,216,2,2,10,51,73,35,22,21,4,0,30,97,88,216
20210716,16JUL2021:00:00:00,UFU ELIZALDE,108,100,74,130,4,208,202,6,204,4,117,46,14,20,7,4,0,0,0,11,135,56,202
20210716,16JUL2021:00:00:00,UFU FERNANDEZ,177,128,242,35,28,305,269,36,291,14,0,10,107,76,43,37,20,12,0,23,174,72,269
20210716,16JUL2021:00:00:00,UFU FERRER,121,91,111,86,15,212,198,14,200,12,0,1,55,60,28,48,20,0,0,16,132,50,198
20210716,16JUL2021:00:00:00,UFU GRIERSON,123,113,127,95,14,236,228,8,228,8,0,9,59,60,67,19,17,5,0,12,148,67,228
20210716,16JUL2021:00:00:00,UFU GUTIERREZ,149,99,169,52,27,248,228,20,234,14,85,42,29,42,32,16,2,0,0,16,150,62,228
20210716,16JUL2021:00:00:00,UFU MUÑIZ,132,158,151,125,14,290,224,66,234,56,0,8,79,86,64,26,15,12,0,7,158,59,224
20210716,16JUL2021:00:00:00,UFU PENNA,82,60,99,35,8,142,134,8,140,2,0,7,36,29,32,14,20,4,0,13,90,31,134
20210716,16JUL2021:00:00:00,UFU PIROVANO,150,120,208,37,25,270,256,14,270,0,0,6,74,71,49,27,31,12,0,25,139,92,256
20210716,16JUL2021:00:00:00,UFU PIÑERO,119,79,130,58,10,198,194,4,194,4,2,8,48,49,51,17,16,7,0,6,139,45,194
20210716,16JUL2021:00:00:00,UFU RAMOS MEJIA,198,179,260,88,29,377,323,54,345,32,10,30,95,95,61,45,15,26,0,30,184,109,323
20210716,16JUL2021:00:00:00,UFU RIVADAVIA,161,124,194,33,58,285,277,8,279,6,0,12,95,83,40,30,18,7,0,39,127,110,277
20210716,16JUL2021:00:00:00,UFU SANTOJANNI,207,129,154,158,24,336,324,12,334,2,14,27,94,39,54,52,47,9,0,16,220,88,324
20210716,16JUL2021:00:00:00,UFU TORNU,158,133,232,35,24,291,273,18,277,14,13,22,51,75,52,66,6,6,0,16,180,77,273
20210716,16JUL2021:00:00:00,UFU VELEZ SARSFIELD,155,119,195,59,20,274,252,22,272,2,2,25,83,54,55,31,13,11,0,24,151,77,252
20210716,16JUL2021:00:00:00,UFU ZUBIZARRETA,119,123,141,74,27,242,240,2,242,0,0,19,52,49,47,50,11,14,0,19,155,66,240
20210717,17JUL2021:00:00:00,UFU ALVAREZ,140,104,184,47,13,244,226,18,226,18,3,14,39,82,50,24,21,11,0,26,137,63,226
20210717,17JUL2021:00:00:00,UFU ARGERICH,27,20,20,25,2,47,47,0,47,0,0,4,4,15,12,4,8,0,0,7,17,23,47
20210717,17JUL2021:00:00:00,UFU BORDA-MOYANO,73,30,69,28,6,103,95,8,95,8,0,0,17,17,19,16,22,12,0,3,54,38,95
20210717,17JUL2021:00:00:00,UFU DURAND,80,81,136,12,13,161,153,8,153,8,2,4,38,49,27,23,9,9,0,14,79,60,153
20210717,17JUL2021:00:00:00,UFU ELIZALDE,117,128,87,153,5,245,227,18,239,6,165,43,13,10,6,0,4,4,0,12,152,63,227
20210717,17JUL2021:00:00:00,UFU FERNANDEZ,122,87,170,21,18,209,204,5,204,5,0,6,42,64,26,34,25,12,0,14,134,56,204
20210717,17JUL2021:00:00:00,UFU FERRER,94,67,97,62,2,161,149,12,153,8,0,0,49,41,40,16,9,6,0,10,95,44,149
20210717,17JUL2021:00:00:00,UFU GRIERSON,87,70,76,51,30,157,149,8,149,8,0,2,52,36,32,32,2,1,0,17,95,37,149
20210717,17JUL2021:00:00:00,UFU GUTIERREZ,110,109,144,61,14,219,209,10,213,6,105,33,18,34,13,12,4,0,0,12,138,56,209
20210717,17JUL2021:00:00:00,UFU MUÑIZ,130,146,127,130,19,276,240,36,246,30,0,10,60,70,66,46,20,4,0,14,158,68,240
20210717,17JUL2021:00:00:00,UFU PENNA,24,21,26,12,7,45,39,6,41,4,5,2,10,11,10,5,0,2,0,0,27,12,39
20210717,17JUL2021:00:00:00,UFU PIROVANO,148,116,188,46,30,264,252,12,264,0,0,6,88,81,38,33,6,12,0,36,113,103,252
20210717,17JUL2021:00:00:00,UFU PIÑERO,89,91,113,59,8,180,176,4,178,2,0,10,39,59,47,19,1,5,0,16,114,46,176
20210717,17JUL2021:00:00:00,UFU RAMOS MEJIA,138,85,161,44,18,223,203,20,211,12,3,11,49,58,46,32,18,6,0,13,116,74,203
20210717,17JUL2021:00:00:00,UFU RIVADAVIA,136,88,167,37,20,224,216,8,220,4,0,1,74,59,28,27,28,7,0,20,101,93,216
20210717,17JUL2021:00:00:00,UFU SANTOJANNI,167,176,162,161,20,343,329,14,329,14,0,18,83,96,74,39,21,12,0,24,215,90,329
20210717,17JUL2021:00:00:00,UFU TORNU,111,97,143,41,24,208,204,4,204,4,6,21,48,42,58,16,14,3,0,10,134,59,204
20210717,17JUL2021:00:00:00,UFU VELEZ SARSFIELD,137,128,192,61,12,265,261,4,265,0,0,12,45,68,85,30,18,7,0,20,161,80,261
20210717,17JUL2021:00:00:00,UFU ZUBIZARRETA,177,143,201,107,12,320,312,8,320,0,0,30,74,86,52,47,24,7,0,22,208,82,312
20210718,18JUL2021:00:00:00,UFU ALVAREZ,139,105,191,27,26,244,226,18,226,18,16,17,63,65,36,26,15,6,0,22,138,66,226
20210718,18JUL2021:00:00:00,UFU ARGERICH,23,20,19,20,4,43,41,2,43,0,6,2,12,13,4,3,1,2,0,3,21,17,41
20210718,18JUL2021:00:00:00,UFU BORDA-MOYANO,15,7,9,11,2,22,16,6,16,6,0,0,12,6,0,0,4,0,0,1,9,6,16
20210718,18JUL2021:00:00:00,UFU DURAND,92,72,139,7,18,164,144,20,146,18,2,2,34,37,51,24,8,6,0,21,62,61,144
20210718,18JUL2021:00:00:00,UFU ELIZALDE,85,79,45,116,3,164,146,18,160,4,84,33,6,13,18,8,2,0,0,7,102,37,146
20210718,18JUL2021:00:00:00,UFU FERNANDEZ,69,75,115,11,18,144,140,4,142,2,0,4,30,39,29,20,14,8,0,2,103,35,140
20210718,18JUL2021:00:00:00,UFU FERRER,84,45,70,50,9,129,123,6,123,6,0,3,37,25,24,27,7,6,0,12,79,32,123
20210718,18JUL2021:00:00:00,UFU GRIERSON,112,88,107,42,51,200,178,22,192,8,0,19,29,51,50,38,11,2,0,4,121,53,178
20210718,18JUL2021:00:00:00,UFU GUTIERREZ,89,76,88,69,8,165,157,8,161,4,85,30,18,15,4,9,2,2,0,8,108,41,157
20210718,18JUL2021:00:00:00,UFU MUÑIZ,111,116,102,85,40,227,191,36,201,26,0,13,55,64,37,27,23,8,0,16,121,53,191
20210718,18JUL2021:00:00:00,UFU PENNA,50,34,49,31,4,84,80,4,84,0,0,0,7,36,22,10,3,6,0,4,52,24,80
20210718,18JUL2021:00:00:00,UFU PIROVANO,138,124,214,21,27,262,244,18,258,4,6,8,66,78,54,26,18,6,0,30,112,102,244
20210718,18JUL2021:00:00:00,UFU PIÑERO,52,36,63,11,14,88,86,2,86,2,0,0,24,22,18,17,3,4,0,6,58,22,86
20210718,18JUL2021:00:00:00,UFU RAMOS MEJIA,99,97,153,23,20,196,182,14,184,12,7,11,38,55,32,33,10,10,0,20,104,58,182
20210718,18JUL2021:00:00:00,UFU RIVADAVIA,121,62,128,29,26,183,179,4,179,4,0,8,67,45,28,16,12,7,0,22,90,67,179
20210907,07SEP2021:00:00:00,UFU PIÑERO,167,132,244,39,16,299,293,6,293,6,88,64,49,33,30,17,11,7,0,2,209,77,293
20210907,07SEP2021:00:00:00,UFU RAMOS MEJIA,164,143,230,41,36,307,295,12,299,8,16,16,62,99,46,30,21,17,0,6,203,86,295
20210907,07SEP2021:00:00:00,UFU RIVADAVIA,134,91,170,34,21,225,221,4,221,4,4,7,77,60,34,22,16,5,0,2,128,91,221
20210907,07SEP2021:00:00:00,UFU SANTOJANNI,235,189,248,158,18,424,424,0,424,0,2,39,105,128,48,76,19,7,0,8,299,117,424
20210907,07SEP2021:00:00:00,UFU TORNU,178,142,268,45,7,320,268,52,270,50,46,35,32,66,60,40,14,27,0,3,188,77,268
20210907,07SEP2021:00:00:00,UFU VELEZ SARSFIELD,139,90,169,46,14,229,223,6,225,4,0,17,53,43,58,30,23,5,0,0,161,62,223
20210907,07SEP2021:00:00:00,UFU ZUBIZARRETA,154,98,168,73,11,252,250,2,252,0,0,31,47,67,38,44,19,6,0,6,182,62,250
20210908,08SEP2021:00:00:00,UFU ALVAREZ,129,118,210,27,10,247,235,12,237,10,55,23,56,49,24,23,13,4,0,4,169,62,235
20210908,08SEP2021:00:00:00,UFU ARGERICH,37,45,54,26,2,82,74,8,74,8,8,10,13,24,11,9,4,3,0,3,40,29,74
20210908,08SEP2021:00:00:00,UFU BORDA-MOYANO,23,29,44,8,0,52,44,8,44,8,0,4,11,10,10,3,9,5,0,1,23,20,44
20210908,08SEP2021:00:00:00,UFU DURAND,102,58,149,8,3,160,156,4,156,4,0,13,27,58,36,16,7,3,0,6,89,61,156
20210908,08SEP2021:00:00:00,UFU ELIZALDE,117,69,57,123,6,186,162,24,172,14,98,45,14,21,7,1,0,0,0,0,98,64,162
20210908,08SEP2021:00:00:00,UFU FERNANDEZ,70,69,113,19,7,139,127,12,131,8,0,7,33,39,28,17,11,4,0,5,65,57,127
20210908,08SEP2021:00:00:00,UFU FERRER,60,89,80,62,7,149,143,6,147,2,0,3,37,36,41,24,3,5,0,1,108,34,143
20210908,08SEP2021:00:00:00,UFU GRIERSON,95,71,82,69,15,166,160,6,162,4,0,26,52,26,20,21,9,12,0,1,114,44,160
20210908,08SEP2021:00:00:00,UFU GUTIERREZ,159,124,197,86,0,283,259,24,279,4,198,74,3,7,0,1,0,0,0,0,162,97,259
20210908,08SEP2021:00:00:00,UFU MUÑIZ,126,113,117,111,11,239,187,52,193,46,2,33,35,52,40,32,34,11,0,3,135,49,187
20210908,08SEP2021:00:00:00,UFU PENNA,41,41,53,25,4,82,82,0,82,0,13,17,20,10,7,11,4,0,0,0,58,24,82
20210908,08SEP2021:00:00:00,UFU PIROVANO,129,109,195,23,20,238,228,10,234,4,0,17,43,79,40,29,17,13,0,7,136,85,228
20210908,08SEP2021:00:00:00,UFU PIÑERO,99,89,142,20,26,188,170,18,174,14,66,25,13,42,18,10,5,9,0,2,123,43,170
20210908,08SEP2021:00:00:00,UFU RAMOS MEJIA,124,119,172,52,19,243,227,16,233,10,7,10,52,68,36,35,28,7,0,4,147,76,227
20210908,08SEP2021:00:00:00,UFU RIVADAVIA,137,78,134,55,26,215,193,22,207,8,0,2,52,58,31,32,29,11,0,6,109,78,193
20210908,08SEP2021:00:00:00,UFU SANTOJANNI,160,170,193,132,5,330,314,16,324,6,29,31,55,54,55,47,44,15,0,5,233,76,314
20210908,08SEP2021:00:00:00,UFU TORNU,147,117,237,19,8,264,202,62,202,62,26,34,57,45,63,31,5,3,0,1,138,59,202
20210908,08SEP2021:00:00:00,UFU VELEZ SARSFIELD,108,103,162,38,11,211,193,18,211,0,2,12,50,39,48,28,14,18,0,4,136,53,193
20210908,08SEP2021:00:00:00,UFU ZUBIZARRETA,76,72,103,36,9,148,146,2,148,0,0,16,34,36,21,19,19,3,0,5,87,54,146
20210909,09SEP2021:00:00:00,UFU ALVAREZ,133,134,189,55,23,267,255,12,257,10,34,15,60,54,44,23,12,25,0,7,179,69,255
20210909,09SEP2021:00:00:00,UFU ARGERICH,46,38,53,29,2,84,72,12,78,6,8,10,12,21,14,4,11,4,0,0,41,31,72
20210909,09SEP2021:00:00:00,UFU BORDA-MOYANO,36,30,47,19,0,66,56,10,56,10,5,4,13,14,14,6,6,4,0,0,43,13,56
20210909,09SEP2021:00:00:00,UFU DURAND,108,88,161,23,12,196,186,10,186,10,17,15,33,48,25,28,19,11,0,3,111,72,186
20210909,09SEP2021:00:00:00,UFU ELIZALDE,127,92,74,141,4,219,189,30,211,8,116,64,10,13,6,10,0,0,0,1,114,74,189
20210909,09SEP2021:00:00:00,UFU FERNANDEZ,86,68,132,11,11,154,136,18,140,14,0,10,24,49,31,12,19,9,0,4,83,49,136
20210909,09SEP2021:00:00:00,UFU FERRER,114,72,100,86,0,186,184,2,186,0,0,3,30,58,48,21,23,3,0,2,133,49,184
20210909,09SEP2021:00:00:00,UFU GRIERSON,94,78,101,55,16,172,162,10,166,6,0,10,41,55,24,23,9,10,0,1,118,41,162
20210909,09SEP2021:00:00:00,UFU GUTIERREZ,153,151,214,86,4,304,290,14,302,2,173,91,6,21,13,0,0,0,0,9,206,74,290
20210909,09SEP2021:00:00:00,UFU MUÑIZ,67,92,96,49,14,159,131,28,135,24,6,23,10,31,45,22,14,8,0,1,91,39,131
20210909,09SEP2021:00:00:00,UFU PENNA,97,53,80,61,9,150,144,6,144,6,40,16,33,24,21,5,9,2,0,0,95,49,144
20210909,09SEP2021:00:00:00,UFU PIROVANO,153,106,212,24,23,259,229,30,251,8,0,9,73,70,46,37,11,13,0,12,116,101,229
20210909,09SEP2021:00:00:00,UFU PIÑERO,165,104,205,51,13,269,261,8,263,6,98,46,33,32,19,30,9,2,0,2,186,65,261
20210909,09SEP2021:00:00:00,UFU RAMOS MEJIA,149,102,193,26,32,251,241,10,245,6,18,24,45,77,50,17,15,5,0,3,174,64,241
20210909,09SEP2021:00:00:00,UFU RIVADAVIA,103,69,139,22,11,172,136,36,140,32,0,5,36,46,37,25,18,5,0,2,78,56,136
20210909,09SEP2021:00:00:00,UFU SANTOJANNI,181,175,196,149,11,356,344,12,352,4,0,40,80,96,65,37,31,7,0,8,247,89,344
20210909,09SEP2021:00:00:00,UFU TORNU,164,134,267,18,13,298,204,94,206,92,41,26,40,80,39,21,26,25,0,5,134,65,204
20210909,09SEP2021:00:00:00,UFU VELEZ SARSFIELD,161,87,204,39,5,248,244,4,248,0,0,17,58,54,44,29,27,19,0,4,167,73,244
20210909,09SEP2021:00:00:00,UFU ZUBIZARRETA,59,50,57,41,11,109,109,0,109,0,0,10,26,16,26,15,9,7,0,3,55,51,109
20210910,10SEP2021:00:00:00,UFU ALVAREZ,158,95,207,35,11,253,231,22,231,22,45,30,34,43,32,30,27,12,0,4,163,64,231
20210910,10SEP2021:00:00:00,UFU ARGERICH,59,48,81,24,2,107,83,24,83,24,16,9,18,16,20,4,14,10,0,0,47,36,83
20210910,10SEP2021:00:00:00,UFU BORDA-MOYANO,46,21,44,21,2,67,65,2,65,2,0,15,2,17,11,7,7,8,0,1,44,20,65
20210910,10SEP2021:00:00:00,UFU DURAND,106,79,153,20,12,185,171,14,171,14,0,10,43,39,38,25,25,5,0,8,91,72,171
20210910,10SEP2021:00:00:00,UFU ELIZALDE,90,130,52,163,5,220,176,44,196,24,150,42,9,7,5,6,1,0,0,0,115,61,176
20210910,10SEP2021:00:00:00,UFU FERNANDEZ,120,65,156,18,11,185,157,28,171,14,0,11,32,50,47,23,13,9,0,7,97,53,157
20210910,10SEP2021:00:00:00,UFU FERRER,80,58,70,58,10,138,130,8,134,4,0,0,26,21,42,33,10,6,0,4,92,34,130
20210910,10SEP2021:00:00:00,UFU GRIERSON,113,77,130,44,16,190,184,6,184,6,0,32,56,25,34,12,25,6,0,1,132,50,184
20210910,10SEP2021:00:00:00,UFU GUTIERREZ,123,106,146,83,0,229,203,26,229,0,156,48,2,9,10,2,2,0,0,0,129,73,203
20210910,10SEP2021:00:00:00,UFU MUÑIZ,122,121,134,92,17,243,209,34,213,30,8,13,37,48,57,50,24,6,0,1,145,63,209
20210910,10SEP2021:00:00:00,UFU PENNA,44,66,54,53,3,110,86,24,100,10,18,9,23,15,8,14,13,10,0,0,62,24,86
20210910,10SEP2021:00:00:00,UFU PIROVANO,154,108,203,31,28,262,240,22,254,8,0,6,65,69,45,46,18,13,0,17,122,101,240
20210910,10SEP2021:00:00:00,UFU PIÑERO,119,85,165,39,0,204,198,6,198,6,57,45,13,25,28,22,12,2,0,3,144,49,198
20210910,10SEP2021:00:00:00,UFU RAMOS MEJIA,161,116,191,60,26,277,265,12,265,12,32,32,43,61,52,25,25,7,0,5,176,84,265
20210910,10SEP2021:00:00:00,UFU RIVADAVIA,103,61,124,21,19,164,152,12,154,10,0,16,37,46,28,16,8,13,0,9,84,59,152
20210910,10SEP2021:00:00:00,UFU SANTOJANNI,183,105,180,90,18,288,274,14,284,4,8,33,50,57,55,40,31,14,0,1,212,61,274
20210910,10SEP2021:00:00:00,UFU TORNU,117,96,165,30,18,213,171,42,171,42,15,31,33,47,44,28,9,6,0,0,115,56,171
20210910,10SEP2021:00:00:00,UFU VELEZ SARSFIELD,88,76,124,34,6,164,162,2,162,2,0,16,35,35,55,14,4,5,0,0,115,47,162
20210910,10SEP2021:00:00:00,UFU ZUBIZARRETA,47,40,54,26,7,87,87,0,87,0,0,10,13,32,12,11,7,2,0,1,63,23,87
20210911,11SEP2021:00:00:00,UFU ALVAREZ,138,83,168,39,14,221,209,12,209,12,14,8,50,46,36,35,21,11,0,2,153,54,209
20211101,01NOV2021:00:00:00,UFU RIVADAVIA,127,61,121,47,20,188,186,2,186,2,0,5,44,37,34,27,26,15,0,9,103,74,186
20211101,01NOV2021:00:00:00,UFU SANTOJANNI,166,114,166,99,15,280,250,30,270,10,25,41,39,25,39,60,26,25,0,6,140,104,250
20211101,01NOV2021:00:00:00,UFU TORNU,175,104,222,42,15,279,213,66,231,48,18,32,35,61,67,27,23,16,0,1,134,70,213
20211101,01NOV2021:00:00:00,UFU VELEZ SARSFIELD,133,100,171,49,13,233,225,8,229,4,2,11,30,71,54,34,19,12,0,3,159,63,225
20211101,01NOV2021:00:00:00,UFU ZUBIZARRETA,185,127,221,68,23,312,306,6,312,0,0,21,50,65,82,51,18,25,0,3,208,95,306
20211102,02NOV2021:00:00:00,UFU ALVAREZ,168,126,232,37,25,294,278,16,278,16,34,26,60,64,43,28,19,20,0,7,192,79,278
20211102,02NOV2021:00:00:00,UFU ARGERICH,83,58,104,34,3,141,97,44,125,16,30,10,23,8,26,16,22,6,0,2,53,42,97
20211102,02NOV2021:00:00:00,UFU BORDA-MOYANO,18,13,22,9,0,31,27,4,27,4,0,2,0,9,11,7,2,0,0,0,17,10,27
20211102,02NOV2021:00:00:00,UFU DURAND,120,101,199,17,5,221,211,10,211,10,17,27,40,49,36,29,10,13,0,4,122,85,211
20211102,02NOV2021:00:00:00,UFU ELIZALDE,96,114,64,142,4,210,138,72,196,14,152,42,4,5,5,2,0,0,0,1,82,55,138
20211102,02NOV2021:00:00:00,UFU FERNANDEZ,86,67,126,17,10,153,125,28,145,8,0,18,43,39,11,17,7,18,0,5,73,47,125
20211102,02NOV2021:00:00:00,UFU FERRER,59,49,45,57,6,108,104,4,106,2,0,0,37,20,20,22,7,2,0,3,74,27,104
20211102,02NOV2021:00:00:00,UFU GRIERSON,104,99,115,59,29,203,195,8,195,8,0,19,45,57,26,30,16,10,0,4,139,50,195
20211102,02NOV2021:00:00:00,UFU GUTIERREZ,152,137,152,136,1,289,279,10,281,8,187,82,10,7,3,0,0,0,0,0,182,97,279
20211102,02NOV2021:00:00:00,UFU MUÑIZ,96,80,79,86,11,176,152,24,158,18,2,16,35,45,45,12,11,10,0,5,104,43,152
20211102,02NOV2021:00:00:00,UFU PENNA,124,66,105,80,5,190,186,4,188,2,31,28,44,39,15,12,16,5,0,8,133,45,186
20211102,02NOV2021:00:00:00,UFU PIROVANO,194,118,254,38,20,312,300,12,304,8,0,18,56,80,54,39,32,33,0,7,171,122,300
20211102,02NOV2021:00:00:00,UFU PIÑERO,100,98,176,22,0,198,188,10,188,10,101,28,10,13,25,8,8,5,0,2,144,40,188
20211102,02NOV2021:00:00:00,UFU RAMOS MEJIA,104,70,125,32,17,174,154,20,158,16,20,10,23,43,32,27,12,7,0,5,91,58,154
20211102,02NOV2021:00:00:00,UFU RIVADAVIA,143,79,172,33,17,222,216,6,218,4,0,11,67,57,33,30,17,7,0,2,121,93,216
20211102,02NOV2021:00:00:00,UFU SANTOJANNI,104,104,124,73,11,208,204,4,208,0,0,33,35,56,32,25,17,10,0,5,121,78,204
20211102,02NOV2021:00:00:00,UFU TORNU,164,116,236,36,8,280,226,54,242,38,40,20,41,68,33,46,16,16,0,2,143,75,226
20211102,02NOV2021:00:00:00,UFU VELEZ SARSFIELD,130,114,171,44,29,244,232,12,240,4,0,18,61,63,45,23,21,13,0,10,158,64,232
20211102,02NOV2021:00:00:00,UFU ZUBIZARRETA,148,127,176,83,16,275,273,2,275,0,0,15,51,79,49,33,29,19,0,9,193,71,273
20211103,03NOV2021:00:00:00,UFU ALVAREZ,195,160,277,56,22,355,327,28,329,26,40,28,74,57,64,21,46,25,0,3,239,85,327
20211103,03NOV2021:00:00:00,UFU ARGERICH,64,65,81,43,5,129,85,44,85,44,38,10,22,20,17,14,5,3,0,2,47,36,85
20211103,03NOV2021:00:00:00,UFU BORDA-MOYANO,18,25,26,15,2,43,39,4,39,4,0,5,8,12,12,3,2,1,0,0,26,13,39
20211103,03NOV2021:00:00:00,UFU DURAND,170,108,241,30,7,278,266,12,268,10,14,30,56,52,51,37,19,19,0,18,133,114,266
20211103,03NOV2021:00:00:00,UFU ELIZALDE,108,104,61,141,10,212,172,40,186,26,158,54,0,0,0,0,0,0,0,1,102,69,172
20211103,03NOV2021:00:00:00,UFU FERNANDEZ,87,81,135,26,7,168,148,20,158,10,0,9,45,42,20,21,21,10,0,3,82,62,148
20211103,03NOV2021:00:00:00,UFU FERRER,85,78,106,50,7,163,160,3,160,3,0,3,24,64,22,30,15,5,0,1,114,45,160
20211103,03NOV2021:00:00:00,UFU GRIERSON,90,72,104,30,28,162,156,6,156,6,0,25,33,32,24,16,23,9,0,1,113,41,156
20211103,03NOV2021:00:00:00,UFU GUTIERREZ,130,153,164,110,9,283,249,34,263,20,178,75,11,10,5,1,3,0,0,1,149,99,249
20211103,03NOV2021:00:00:00,UFU MUÑIZ,108,123,110,98,23,231,197,34,205,26,12,24,41,56,38,33,22,5,0,1,141,54,197
20211103,03NOV2021:00:00:00,UFU PENNA,66,38,55,43,6,104,100,4,102,2,27,8,28,20,7,9,5,0,0,4,73,23,100
20211103,03NOV2021:00:00:00,UFU PIROVANO,161,147,239,33,36,308,294,14,302,6,0,20,79,80,66,20,33,10,0,19,162,112,294
20211103,03NOV2021:00:00:00,UFU PIÑERO,119,103,166,24,32,222,210,12,210,12,58,40,22,37,26,24,15,0,0,2,151,55,210
20211103,03NOV2021:00:00:00,UFU RAMOS MEJIA,64,42,79,21,6,106,74,32,78,28,27,8,20,18,15,4,6,8,0,5,39,28,74
20211103,03NOV2021:00:00:00,UFU RIVADAVIA,113,58,116,35,22,173,159,14,161,12,0,6,40,55,28,28,10,6,0,3,90,66,159
20211103,03NOV2021:00:00:00,UFU SANTOJANNI,116,77,119,64,10,193,189,4,189,4,8,25,47,33,32,24,12,12,0,3,110,76,189
20211103,03NOV2021:00:00:00,UFU TORNU,106,92,173,14,11,198,160,38,172,26,21,21,37,38,43,16,15,7,0,1,101,57,160
20211103,03NOV2021:00:00:00,UFU VELEZ SARSFIELD,134,108,170,62,10,242,216,26,240,2,2,12,74,52,28,34,18,22,0,2,158,56,216
20211103,03NOV2021:00:00:00,UFU ZUBIZARRETA,89,74,120,26,17,163,163,0,163,0,0,25,29,29,46,10,6,18,0,4,114,45,163
20211104,04NOV2021:00:00:00,UFU ALVAREZ,193,109,257,22,23,302,282,20,282,20,41,30,54,54,48,29,17,29,0,4,206,72,282
20211104,04NOV2021:00:00:00,UFU ARGERICH,49,24,51,20,2,73,63,10,63,10,12,4,9,16,14,10,2,6,0,0,33,29,63
20211104,04NOV2021:00:00:00,UFU BORDA-MOYANO,23,23,34,6,6,46,42,4,42,4,0,3,4,11,10,14,4,0,0,0,27,15,42
20211104,04NOV2021:00:00:00,UFU DURAND,168,95,231,16,16,263,259,4,259,4,14,33,35,78,46,27,18,12,0,20,137,102,259
20211104,04NOV2021:00:00:00,UFU ELIZALDE,125,95,54,152,14,220,182,38,196,24,170,42,2,6,0,0,0,0,0,1,110,71,182
20211104,04NOV2021:00:00:00,UFU FERNANDEZ,68,71,113,20,6,139,129,10,131,8,0,4,34,42,29,18,9,3,0,9,75,45,129
20211104,04NOV2021:00:00:00,UFU FERRER,73,73,78,59,9,146,146,0,146,0,0,0,32,35,49,14,13,3,0,1,104,41,146
20211104,04NOV2021:00:00:00,UFU GRIERSON,92,61,98,36,19,153,137,16,151,2,2,26,34,43,26,4,14,4,0,9,87,41,137
20211104,04NOV2021:00:00:00,UFU GUTIERREZ,110,112,116,103,3,222,206,16,218,4,130,65,5,12,0,7,3,0,0,0,140,63,206
20211104,04NOV2021:00:00:00,UFU MUÑIZ,106,76,109,65,8,182,146,36,152,30,4,9,41,35,37,28,22,6,0,0,108,38,146
20211104,04NOV2021:00:00:00,UFU PENNA,79,60,73,64,2,139,131,8,133,6,26,23,22,22,19,20,5,2,0,2,99,30,131
20211104,04NOV2021:00:00:00,UFU PIROVANO,137,103,208,13,19,240,232,8,240,0,0,8,44,64,55,38,19,12,0,6,136,90,232
20211104,04NOV2021:00:00:00,UFU PIÑERO,138,95,181,46,6,233,213,20,219,14,63,42,46,35,25,13,6,3,0,3,152,56,213
20211104,04NOV2021:00:00:00,UFU RAMOS MEJIA,111,98,149,33,27,209,187,22,193,16,16,11,48,28,35,31,30,10,0,8,101,78,187
20211104,04NOV2021:00:00:00,UFU RIVADAVIA,108,50,102,30,26,158,118,40,118,40,0,10,56,28,30,13,13,8,0,1,69,48,118
20211104,04NOV2021:00:00:00,UFU SANTOJANNI,117,78,134,57,4,195,185,10,191,4,0,29,35,45,32,38,6,10,0,9,103,73,185
20211104,04NOV2021:00:00:00,UFU TORNU,153,129,236,27,19,282,254,28,254,28,19,20,42,67,69,36,18,11,0,12,156,80,254
20211104,04NOV2021:00:00:00,UFU VELEZ SARSFIELD,128,71,145,34,20,199,193,6,195,4,0,18,26,50,46,35,15,9,0,0,141,52,193
20211104,04NOV2021:00:00:00,UFU ZUBIZARRETA,158,98,158,90,8,256,238,18,256,0,0,19,52,64,33,40,28,20,0,2,177,59,238
20211105,05NOV2021:00:00:00,UFU ALVAREZ,147,107,190,40,24,254,244,10,244,10,22,9,56,65,49,30,5,18,0,4,172,68,244
20211105,05NOV2021:00:00:00,UFU ARGERICH,51,56,62,43,2,107,67,40,81,26,20,8,21,17,17,9,5,10,0,1,37,29,67
20211105,05NOV2021:00:00:00,UFU BORDA-MOYANO,23,25,37,11,0,48,44,4,44,4,0,8,1,15,12,5,1,6,0,0,30,14,44
20211209,09DEC2021:00:00:00,UFU RAMOS MEJIA,174,141,235,35,45,315,292,23,295,20,7,12,95,95,59,29,11,7,0,29,123,140,292
20211209,09DEC2021:00:00:00,UFU RIVADAVIA,177,113,211,34,45,290,278,12,278,12,0,25,83,70,51,24,17,20,0,28,135,115,278
20211209,09DEC2021:00:00:00,UFU SANTOJANNI,142,82,124,90,10,224,204,20,220,4,2,8,50,41,46,31,25,21,0,19,78,107,204
20211209,09DEC2021:00:00:00,UFU TORNU,148,154,257,34,11,302,288,14,288,14,12,31,42,74,68,40,20,15,0,20,151,115,288
20211209,09DEC2021:00:00:00,UFU VELEZ SARSFIELD,159,153,261,47,4,312,304,8,304,8,0,12,78,50,55,42,57,18,0,22,175,107,304
20211209,09DEC2021:00:00:00,UFU ZUBIZARRETA,213,192,288,84,33,405,381,24,405,0,0,32,80,64,64,85,53,27,0,17,259,105,381
20211210,10DEC2021:00:00:00,UFU ALVAREZ,258,140,319,56,23,398,372,26,372,26,23,33,82,58,70,48,38,46,0,22,245,105,372
20211210,10DEC2021:00:00:00,UFU ARGERICH,52,38,68,18,4,90,80,10,80,10,15,13,21,11,10,11,6,3,0,7,37,35,80
20211210,10DEC2021:00:00:00,UFU BORDA-MOYANO,9,26,23,10,2,35,33,2,33,2,0,5,8,8,8,4,2,0,0,3,20,10,33
20211210,10DEC2021:00:00:00,UFU DURAND,126,92,178,10,30,218,216,2,216,2,0,18,29,69,53,27,5,17,0,28,101,87,216
20211210,10DEC2021:00:00:00,UFU ELIZALDE,39,38,19,58,0,77,69,8,69,8,63,11,0,1,1,1,0,0,0,0,39,30,69
20211210,10DEC2021:00:00:00,UFU FERNANDEZ,122,124,201,23,22,246,226,20,232,14,0,18,73,67,37,20,19,12,0,12,126,88,226
20211210,10DEC2021:00:00:00,UFU FERRER,72,75,81,55,11,147,143,4,147,0,0,2,29,41,27,23,10,15,0,4,100,39,143
20211210,10DEC2021:00:00:00,UFU GRIERSON,101,91,128,43,21,192,172,20,188,4,0,20,58,22,44,31,8,9,0,31,92,49,172
20211210,10DEC2021:00:00:00,UFU GUTIERREZ,77,83,87,61,12,160,152,8,156,4,85,43,4,22,4,2,0,0,0,7,74,71,152
20211210,10DEC2021:00:00:00,UFU MUÑIZ,121,148,112,119,38,269,223,46,233,36,12,35,32,78,54,36,17,5,0,13,133,77,223
20211210,10DEC2021:00:00:00,UFU PENNA,32,17,25,24,0,49,21,28,21,28,7,6,6,15,4,8,3,0,0,0,18,3,21
20211210,10DEC2021:00:00:00,UFU PIROVANO,230,210,362,32,46,440,398,42,434,6,0,25,95,163,86,34,13,24,0,32,211,155,398
20211210,10DEC2021:00:00:00,UFU PIÑERO,151,106,192,37,28,257,231,26,231,26,30,34,29,59,52,16,30,7,0,11,150,68,231
20211210,10DEC2021:00:00:00,UFU RAMOS MEJIA,135,93,173,27,28,228,218,10,218,10,16,12,49,65,36,25,17,8,0,17,116,84,218
20211210,10DEC2021:00:00:00,UFU RIVADAVIA,209,143,221,63,68,352,346,6,350,2,0,10,138,99,52,26,16,11,0,37,168,141,346
20211210,10DEC2021:00:00:00,UFU SANTOJANNI,102,60,89,67,6,162,138,24,160,2,0,15,47,31,28,11,14,16,0,17,65,56,138
20211210,10DEC2021:00:00:00,UFU TORNU,159,122,238,22,21,281,237,44,257,24,15,31,52,62,47,45,14,15,0,11,143,83,237
20211210,10DEC2021:00:00:00,UFU VELEZ SARSFIELD,155,109,188,47,29,264,254,10,260,4,0,6,65,77,56,19,34,7,0,14,169,71,254
20211210,10DEC2021:00:00:00,UFU ZUBIZARRETA,195,191,265,78,43,386,386,0,386,0,0,19,99,75,76,39,54,24,0,24,259,103,386
20211211,11DEC2021:00:00:00,UFU ALVAREZ,181,133,259,28,27,314,304,10,304,10,7,28,67,72,39,50,32,19,0,24,187,93,304
20211211,11DEC2021:00:00:00,UFU ARGERICH,0,2,0,2,0,2,2,0,2,0,0,2,0,0,0,0,0,0,0,0,1,1,2
20211211,11DEC2021:00:00:00,UFU BORDA-MOYANO,27,23,22,26,2,50,46,4,46,4,0,2,11,10,6,10,9,2,0,1,28,17,46
20211211,11DEC2021:00:00:00,UFU DURAND,98,56,129,14,11,154,146,8,146,8,1,12,49,48,22,10,7,5,0,17,67,62,146
20211211,11DEC2021:00:00:00,UFU ELIZALDE,47,44,32,56,3,91,69,22,91,0,52,29,1,2,2,0,5,0,0,0,40,29,69
20211211,11DEC2021:00:00:00,UFU FERNANDEZ,69,71,103,25,12,140,126,14,126,14,0,10,29,40,23,23,10,5,0,11,72,43,126
20211211,11DEC2021:00:00:00,UFU FERRER,72,52,70,41,13,124,114,10,118,6,0,2,41,32,18,17,9,5,0,9,79,26,114
20211211,11DEC2021:00:00:00,UFU GRIERSON,92,62,87,53,14,154,154,0,154,0,0,11,49,24,38,21,7,4,0,16,96,42,154
20211211,11DEC2021:00:00:00,UFU GUTIERREZ,56,42,70,21,7,98,88,10,92,6,58,23,4,10,2,0,1,0,0,2,55,31,88
20211211,11DEC2021:00:00:00,UFU MUÑIZ,132,126,144,88,26,258,198,60,212,46,2,47,42,42,52,29,28,16,0,14,101,83,198
20211211,11DEC2021:00:00:00,UFU PENNA,34,29,44,16,3,63,63,0,63,0,2,3,20,15,12,5,6,0,0,5,36,21,63
20211211,11DEC2021:00:00:00,UFU PIROVANO,203,180,325,24,34,383,365,18,371,12,0,29,86,113,71,46,24,14,0,48,165,152,365
20211211,11DEC2021:00:00:00,UFU PIÑERO,73,71,109,25,10,144,136,8,136,8,0,3,39,29,30,31,8,4,0,18,86,30,136
20211211,11DEC2021:00:00:00,UFU RAMOS MEJIA,114,74,129,19,40,188,160,28,162,26,9,6,52,46,37,17,7,14,0,11,89,60,160
20211211,11DEC2021:00:00:00,UFU RIVADAVIA,125,97,170,32,20,222,222,0,222,0,0,6,65,61,37,34,9,10,0,24,105,92,222
20211211,11DEC2021:00:00:00,UFU SANTOJANNI,147,80,121,101,5,227,219,8,223,4,0,31,49,41,47,30,16,13,0,24,107,88,219
20211211,11DEC2021:00:00:00,UFU TORNU,129,123,199,44,9,252,234,18,234,18,15,24,64,48,43,24,25,9,0,24,130,79,234
20211211,11DEC2021:00:00:00,UFU VELEZ SARSFIELD,145,103,195,46,7,248,244,4,246,2,0,22,51,48,58,31,17,21,0,25,146,73,244
20211211,11DEC2021:00:00:00,UFU ZUBIZARRETA,195,137,225,87,20,332,324,8,332,0,0,35,81,68,68,25,30,25,0,23,195,106,324
20211212,12DEC2021:00:00:00,UFU ALVAREZ,172,115,239,27,21,287,273,14,273,14,10,24,57,65,45,41,29,16,0,10,176,87,273
20211212,12DEC2021:00:00:00,UFU ARGERICH,42,25,35,30,2,67,67,0,67,0,7,4,20,13,7,8,6,2,0,9,8,50,67
20211212,12DEC2021:00:00:00,UFU BORDA-MOYANO,21,19,29,11,0,40,38,2,38,2,0,2,7,9,7,6,3,6,0,1,23,14,38
20211212,12DEC2021:00:00:00,UFU DURAND,77,84,149,2,10,161,157,4,157,4,3,13,31,41,30,22,11,10,0,20,69,68,157
20211212,12DEC2021:00:00:00,UFU ELIZALDE,33,25,22,33,3,58,56,2,58,0,43,12,3,0,0,0,0,0,0,0,20,36,56
20211212,12DEC2021:00:00:00,UFU FERNANDEZ,87,70,137,12,8,157,143,14,143,14,0,2,34,51,44,6,15,5,0,13,78,52,143
20211212,12DEC2021:00:00:00,UFU FERRER,28,43,45,26,0,71,69,2,69,2,0,6,24,14,12,9,6,0,0,10,36,23,69
20211212,12DEC2021:00:00:00,UFU GRIERSON,62,67,80,39,10,129,99,30,103,26,0,10,37,19,30,21,9,3,0,5,56,31,99
20211212,12DEC2021:00:00:00,UFU GUTIERREZ,39,65,78,17,9,104,96,8,100,4,59,32,8,2,2,0,1,0,0,2,53,41,96
20211212,12DEC2021:00:00:00,UFU MUÑIZ,120,152,153,85,34,272,216,56,226,46,3,36,39,62,54,39,32,7,0,13,142,61,216
20211212,12DEC2021:00:00:00,UFU PENNA,13,16,15,12,2,29,27,2,27,2,3,3,9,3,6,5,0,0,0,5,16,6,27
20211212,12DEC2021:00:00:00,UFU PIROVANO,193,167,290,31,39,360,346,14,350,10,7,13,102,105,47,34,27,25,0,26,179,141,346
20211212,12DEC2021:00:00:00,UFU PIÑERO,71,52,90,30,3,123,119,4,119,4,0,11,32,25,27,15,13,0,0,7,80,31,119
20211212,12DEC2021:00:00:00,UFU RAMOS MEJIA,103,69,140,12,20,172,164,8,164,8,4,15,45,39,27,10,23,9,0,24,67,73,164
20211212,12DEC2021:00:00:00,UFU RIVADAVIA,115,89,168,25,11,204,178,26,178,26,0,5,71,39,33,32,15,9,0,13,91,74,178
20211212,12DEC2021:00:00:00,UFU SANTOJANNI,90,104,110,76,8,194,188,6,192,2,0,16,63,40,38,16,15,6,0,38,78,72,188
20211212,12DEC2021:00:00:00,UFU TORNU,102,95,178,15,4,197,183,14,183,14,4,24,28,51,44,22,12,12,0,13,94,74,183
20211212,12DEC2021:00:00:00,UFU VELEZ SARSFIELD,124,112,184,44,8,236,232,4,234,2,0,17,46,43,55,40,26,9,0,15,150,67,232
20211212,12DEC2021:00:00:00,UFU ZUBIZARRETA,214,191,291,103,11,405,405,0,405,0,0,38,83,60,69,61,53,41,0,29,268,108,405
20211213,13DEC2021:00:00:00,UFU ALVAREZ,182,101,221,38,24,283,255,28,261,22,14,8,73,70,40,34,26,18,0,26,131,98,255
20211213,13DEC2021:00:00:00,UFU ARGERICH,64,47,69,35,7,111,101,10,101,10,6,1,17,35,17,13,11,11,0,11,41,48,101
20210718,18JUL2021:00:00:00,UFU SANTOJANNI,187,133,175,133,12,320,306,14,312,8,5,5,47,72,76,48,42,25,0,27,198,81,306
20210718,18JUL2021:00:00:00,UFU TORNU,111,62,141,16,16,173,165,8,165,8,3,8,40,45,28,21,14,14,0,9,112,44,165
20210718,18JUL2021:00:00:00,UFU VELEZ SARSFIELD,101,116,144,51,22,217,213,4,215,2,0,2,46,48,51,39,17,14,0,22,120,71,213
20210718,18JUL2021:00:00:00,UFU ZUBIZARRETA,40,61,78,23,0,101,99,2,101,0,0,6,14,29,20,24,5,3,0,7,64,28,99
20210719,19JUL2021:00:00:00,UFU ALVAREZ,200,142,242,79,21,342,326,16,328,14,18,21,85,84,51,54,23,6,0,19,220,87,326
20210719,19JUL2021:00:00:00,UFU ARGERICH,72,67,78,57,4,139,129,10,131,8,16,9,32,28,25,15,9,5,0,15,53,57,129
20210719,19JUL2021:00:00:00,UFU BORDA-MOYANO,35,33,31,29,8,68,64,4,64,4,4,2,15,19,8,11,7,2,0,4,39,21,64
20210719,19JUL2021:00:00:00,UFU DURAND,136,77,174,14,25,213,205,8,207,6,5,10,49,72,34,16,16,11,0,15,107,83,205
20210719,19JUL2021:00:00:00,UFU ELIZALDE,159,149,95,212,1,308,264,44,296,12,155,78,15,26,24,7,2,1,0,6,177,81,264
20210719,19JUL2021:00:00:00,UFU FERNANDEZ,98,93,153,29,9,191,183,8,185,6,0,1,46,56,34,16,30,8,0,12,106,64,183
20210719,19JUL2021:00:00:00,UFU FERRER,120,49,82,72,15,169,165,4,167,2,0,0,31,55,59,17,3,4,0,13,105,47,165
20210719,19JUL2021:00:00:00,UFU GRIERSON,121,101,109,101,12,222,218,4,220,2,0,8,58,52,47,30,20,7,0,14,141,63,218
20210719,19JUL2021:00:00:00,UFU GUTIERREZ,184,117,179,116,6,301,283,18,299,2,153,31,27,48,31,2,9,0,0,5,193,84,283
20210719,19JUL2021:00:00:00,UFU MUÑIZ,152,147,138,142,19,299,253,46,269,30,3,3,70,95,58,43,17,10,0,16,161,76,253
20210719,19JUL2021:00:00:00,UFU PENNA,58,76,73,54,7,134,122,12,128,6,2,0,49,33,16,17,11,6,0,5,83,34,122
20210719,19JUL2021:00:00:00,UFU PIROVANO,160,129,218,26,45,289,267,22,287,2,0,2,71,87,57,32,20,20,0,23,129,115,267
20210719,19JUL2021:00:00:00,UFU PIÑERO,102,88,125,43,22,190,174,16,184,6,7,7,62,38,35,20,10,11,0,11,121,40,174
20210719,19JUL2021:00:00:00,UFU RAMOS MEJIA,213,186,272,92,35,399,387,12,391,8,12,36,77,74,86,58,36,20,0,28,235,123,387
20210719,19JUL2021:00:00:00,UFU RIVADAVIA,152,107,172,50,37,259,251,8,251,8,0,3,78,88,40,26,17,7,0,22,131,98,251
20210719,19JUL2021:00:00:00,UFU SANTOJANNI,185,138,141,171,11,323,303,20,317,6,1,15,59,85,82,22,43,16,0,34,186,83,303
20210719,19JUL2021:00:00:00,UFU TORNU,159,130,222,32,35,289,251,38,261,28,20,25,50,75,71,14,22,12,0,15,175,60,251
20210719,19JUL2021:00:00:00,UFU VELEZ SARSFIELD,175,161,262,57,17,336,330,6,332,4,0,18,73,74,93,58,16,4,0,30,210,90,330
20210719,19JUL2021:00:00:00,UFU ZUBIZARRETA,199,148,220,100,27,347,347,0,347,0,0,21,84,106,50,35,30,21,0,31,217,99,347
20210720,20JUL2021:00:00:00,UFU ALVAREZ,161,144,195,70,40,305,287,18,287,18,26,18,76,79,48,29,18,11,0,13,202,72,287
20210720,20JUL2021:00:00:00,UFU ARGERICH,60,59,68,43,8,119,101,18,101,18,11,4,32,33,18,8,6,7,0,6,46,48,101
20210720,20JUL2021:00:00:00,UFU BORDA-MOYANO,25,34,33,17,9,59,57,2,57,2,2,5,17,8,14,9,2,2,0,0,37,20,57
20210720,20JUL2021:00:00:00,UFU DURAND,100,89,153,25,11,189,183,6,183,6,7,12,44,52,33,24,13,4,0,25,82,76,183
20210720,20JUL2021:00:00:00,UFU ELIZALDE,182,127,99,208,2,309,263,46,293,16,181,70,16,19,18,5,0,0,0,9,181,73,263
20210720,20JUL2021:00:00:00,UFU FERNANDEZ,107,75,129,33,20,182,147,35,171,11,0,5,41,47,33,28,16,12,0,14,80,53,147
20210720,20JUL2021:00:00:00,UFU FERRER,66,45,57,49,5,111,93,18,93,18,0,2,23,38,26,17,5,0,0,7,62,24,93
20210720,20JUL2021:00:00:00,UFU GRIERSON,92,96,79,78,31,188,186,2,186,2,0,0,42,53,36,39,17,1,0,5,129,52,186
20210720,20JUL2021:00:00:00,UFU GUTIERREZ,149,147,152,123,21,296,282,14,290,6,162,30,29,34,27,12,2,0,0,17,187,76,282
20210720,20JUL2021:00:00:00,UFU MUÑIZ,126,137,130,123,10,263,161,102,207,56,0,8,54,69,56,58,17,1,0,6,112,43,161
20210720,20JUL2021:00:00:00,UFU PENNA,93,70,89,63,11,163,155,8,159,4,0,3,34,45,49,25,4,3,0,7,106,42,155
20210720,20JUL2021:00:00:00,UFU PIROVANO,153,109,176,35,51,262,248,14,254,8,0,7,69,86,44,27,18,11,0,28,118,102,248
20210720,20JUL2021:00:00:00,UFU PIÑERO,101,63,137,22,5,164,156,8,156,8,0,2,40,48,32,23,14,5,0,13,108,33,156
20210720,20JUL2021:00:00:00,UFU RAMOS MEJIA,125,168,181,79,33,293,241,52,253,40,12,12,58,70,65,44,24,8,0,20,148,72,241
20210720,20JUL2021:00:00:00,UFU RIVADAVIA,173,98,181,43,47,271,230,41,232,39,2,6,95,64,41,30,20,13,0,18,118,94,230
20210720,20JUL2021:00:00:00,UFU SANTOJANNI,169,125,121,155,18,294,278,16,290,4,4,15,57,58,60,63,25,12,0,16,190,72,278
20210720,20JUL2021:00:00:00,UFU TORNU,139,91,184,16,30,230,200,30,204,26,16,12,51,46,48,36,16,5,0,10,138,47,200
20210720,20JUL2021:00:00:00,UFU VELEZ SARSFIELD,148,96,178,39,27,244,240,4,242,2,0,7,61,62,40,37,29,8,0,14,161,65,240
20210720,20JUL2021:00:00:00,UFU ZUBIZARRETA,78,72,78,57,15,150,150,0,150,0,0,4,36,40,24,19,14,13,0,8,105,36,150
20210721,21JUL2021:00:00:00,UFU ALVAREZ,170,136,220,76,10,306,282,24,282,24,11,22,76,81,46,38,23,9,0,29,170,83,282
20210721,21JUL2021:00:00:00,UFU ARGERICH,66,50,75,40,1,116,104,12,108,8,17,0,32,27,17,10,11,2,0,5,54,44,104
20210721,21JUL2021:00:00:00,UFU BORDA-MOYANO,69,43,61,49,2,112,102,10,102,10,0,4,30,13,26,22,15,2,0,4,67,31,102
20210721,21JUL2021:00:00:00,UFU DURAND,129,113,204,27,11,242,228,14,228,14,10,13,52,73,37,37,12,8,0,26,121,81,228
20210721,21JUL2021:00:00:00,UFU ELIZALDE,119,107,62,150,14,226,204,22,222,4,102,72,8,16,19,4,4,1,0,9,145,50,204
20210721,21JUL2021:00:00:00,UFU FERNANDEZ,127,109,170,34,32,236,200,36,224,12,0,7,70,67,44,27,17,4,0,21,99,80,200
20210721,21JUL2021:00:00:00,UFU FERRER,127,71,108,82,8,198,194,4,194,4,0,0,52,56,61,19,10,0,0,17,127,50,194
20210721,21JUL2021:00:00:00,UFU GRIERSON,53,72,64,48,13,125,121,4,125,0,0,10,39,24,20,23,7,2,0,6,79,35,121
20210721,21JUL2021:00:00:00,UFU GUTIERREZ,144,160,156,137,11,304,281,23,302,2,142,70,14,51,11,9,7,0,0,9,189,81,281
20210721,21JUL2021:00:00:00,UFU MUÑIZ,146,147,126,154,13,293,237,56,251,42,0,3,58,94,63,43,22,10,0,14,158,65,237
20210721,21JUL2021:00:00:00,UFU PENNA,83,69,94,55,3,152,148,4,148,4,0,6,37,42,26,21,16,4,0,18,86,44,148
20210721,21JUL2021:00:00:00,UFU PIROVANO,154,109,207,36,20,263,244,19,259,4,0,2,64,97,44,26,23,7,0,33,123,88,244
20210721,21JUL2021:00:00:00,UFU PIÑERO,110,112,151,62,9,222,211,11,215,7,12,7,61,41,37,38,8,18,0,13,141,57,211
20210721,21JUL2021:00:00:00,UFU RAMOS MEJIA,178,167,241,81,23,345,305,40,321,24,8,24,109,72,68,33,23,8,0,22,173,109,305
20210721,21JUL2021:00:00:00,UFU RIVADAVIA,164,98,194,40,28,262,212,50,218,44,0,13,94,58,46,22,22,7,0,17,122,73,212
20210721,21JUL2021:00:00:00,UFU SANTOJANNI,204,163,234,120,13,367,355,12,357,10,15,17,78,74,96,44,30,13,0,16,253,86,355
20210721,21JUL2021:00:00:00,UFU TORNU,127,113,185,51,4,240,210,30,214,26,3,10,44,50,54,48,19,12,0,13,139,53,210
20210721,21JUL2021:00:00:00,UFU VELEZ SARSFIELD,118,162,190,69,21,280,264,16,276,4,0,16,63,71,69,21,23,17,0,20,176,68,264
20210721,21JUL2021:00:00:00,UFU ZUBIZARRETA,139,108,154,83,10,247,245,2,245,2,0,12,55,47,56,44,20,13,0,9,174,62,245
20210722,22JUL2021:00:00:00,UFU ALVAREZ,187,102,200,62,27,289,209,80,211,78,16,25,83,61,49,31,17,7,0,17,113,79,209
20210722,22JUL2021:00:00:00,UFU ARGERICH,75,59,90,41,3,134,120,14,122,12,8,2,37,21,33,13,9,11,0,9,59,52,120
20210722,22JUL2021:00:00:00,UFU BORDA-MOYANO,70,18,58,19,11,88,76,12,76,12,2,4,6,13,16,22,16,9,0,1,49,26,76
20210911,11SEP2021:00:00:00,UFU ARGERICH,7,8,12,3,0,15,15,0,15,0,0,2,2,2,2,0,4,3,0,2,7,6,15
20210911,11SEP2021:00:00:00,UFU BORDA-MOYANO,20,9,20,9,0,29,27,2,27,2,0,6,9,6,1,5,2,0,0,0,18,9,27
20210911,11SEP2021:00:00:00,UFU DURAND,117,68,160,10,15,185,177,8,177,8,9,19,25,36,36,28,19,13,0,3,100,74,177
20210911,11SEP2021:00:00:00,UFU ELIZALDE,92,90,61,120,1,182,180,2,180,2,113,40,8,15,2,2,2,0,0,0,102,78,180
20210911,11SEP2021:00:00:00,UFU FERNANDEZ,69,32,83,11,7,101,85,16,99,2,1,8,18,26,13,22,5,8,0,1,59,25,85
20210911,11SEP2021:00:00:00,UFU FERRER,45,22,47,20,0,67,65,2,65,2,0,0,10,15,16,20,4,2,0,3,49,13,65
20210911,11SEP2021:00:00:00,UFU GRIERSON,87,62,76,63,10,149,143,6,143,6,0,9,34,37,29,20,13,7,0,2,103,37,143
20210911,11SEP2021:00:00:00,UFU GUTIERREZ,100,117,139,75,3,217,211,6,217,0,158,40,3,4,7,2,3,0,0,2,152,57,211
20210911,11SEP2021:00:00:00,UFU MUÑIZ,74,95,84,82,3,169,153,16,153,16,2,0,21,37,35,52,14,8,0,0,118,35,153
20210911,11SEP2021:00:00:00,UFU PENNA,55,44,58,37,4,99,95,4,97,2,11,5,23,36,4,11,9,0,0,4,60,31,95
20210911,11SEP2021:00:00:00,UFU PIROVANO,144,112,218,18,20,256,248,8,252,4,0,8,38,68,57,30,36,19,0,9,130,108,248
20210911,11SEP2021:00:00:00,UFU PIÑERO,50,49,69,26,4,99,99,0,99,0,0,11,21,9,25,16,12,5,0,0,69,25,99
20210911,11SEP2021:00:00:00,UFU RAMOS MEJIA,113,64,130,34,13,177,161,16,163,14,4,20,43,42,27,23,11,7,0,4,99,58,161
20210911,11SEP2021:00:00:00,UFU RIVADAVIA,105,39,107,33,4,144,114,30,114,30,0,2,27,47,43,13,11,1,0,1,66,47,114
20210911,11SEP2021:00:00:00,UFU SANTOJANNI,203,113,186,122,8,316,306,10,310,6,0,23,30,62,79,44,41,37,0,4,222,80,306
20210911,11SEP2021:00:00:00,UFU TORNU,84,89,151,19,3,173,161,12,161,12,23,20,40,42,23,12,13,0,0,3,113,45,161
20210911,11SEP2021:00:00:00,UFU VELEZ SARSFIELD,145,114,204,43,12,259,257,2,259,0,0,11,39,60,72,36,19,22,0,4,175,78,257
20210911,11SEP2021:00:00:00,UFU ZUBIZARRETA,128,85,152,56,5,213,207,6,213,0,0,14,26,63,43,33,29,5,0,1,150,56,207
20210912,12SEP2021:00:00:00,UFU ALVAREZ,191,103,241,37,16,294,278,16,278,16,43,11,55,78,37,33,27,10,0,1,199,78,278
20210912,12SEP2021:00:00:00,UFU ARGERICH,33,25,29,27,2,58,58,0,58,0,4,2,0,15,13,6,13,5,0,0,19,37,58
20210912,12SEP2021:00:00:00,UFU BORDA-MOYANO,29,16,25,15,5,45,41,4,41,4,0,2,11,13,4,10,3,2,0,0,25,16,41
20210912,12SEP2021:00:00:00,UFU DURAND,105,77,152,11,19,182,174,8,174,8,19,9,28,44,31,22,9,20,0,5,91,78,174
20210912,12SEP2021:00:00:00,UFU ELIZALDE,73,85,54,104,0,158,122,36,154,4,101,24,10,11,12,0,0,0,0,0,72,50,122
20210912,12SEP2021:00:00:00,UFU FERNANDEZ,56,43,83,12,4,99,93,6,99,0,0,4,17,28,16,13,8,13,0,2,66,25,93
20210912,12SEP2021:00:00:00,UFU FERRER,29,39,48,20,0,68,68,0,68,0,0,0,11,28,12,17,0,0,0,2,49,17,68
20210912,12SEP2021:00:00:00,UFU GRIERSON,71,68,85,35,19,139,137,2,139,0,4,10,23,32,29,25,12,4,0,2,94,40,137
20210912,12SEP2021:00:00:00,UFU GUTIERREZ,114,103,152,61,4,217,211,6,211,6,148,40,5,12,10,2,0,0,0,0,146,65,211
20210912,12SEP2021:00:00:00,UFU MUÑIZ,74,57,64,52,15,131,117,14,119,12,0,20,23,21,25,27,14,1,0,6,79,32,117
20210912,12SEP2021:00:00:00,UFU PENNA,46,41,56,29,2,87,83,4,85,2,2,13,8,18,17,17,12,0,0,0,56,27,83
20210912,12SEP2021:00:00:00,UFU PIROVANO,134,121,225,28,2,255,237,18,251,4,20,26,40,49,50,43,13,14,0,12,128,97,237
20210912,12SEP2021:00:00:00,UFU PIÑERO,36,68,78,17,9,104,104,0,104,0,0,6,28,25,10,20,14,1,0,2,68,29,104
20210912,12SEP2021:00:00:00,UFU RAMOS MEJIA,137,86,162,24,37,223,211,12,211,12,17,9,35,67,51,31,13,0,0,2,148,61,211
20210912,12SEP2021:00:00:00,UFU RIVADAVIA,86,64,114,22,14,150,142,8,144,6,0,7,49,33,20,22,16,3,0,1,81,59,142
20210912,12SEP2021:00:00:00,UFU SANTOJANNI,145,129,180,77,17,274,264,10,268,6,3,15,52,66,49,31,25,33,0,6,185,73,264
20210912,12SEP2021:00:00:00,UFU TORNU,83,60,111,14,18,143,139,4,139,4,25,8,16,28,43,8,8,7,0,1,98,40,139
20210912,12SEP2021:00:00:00,UFU VELEZ SARSFIELD,128,97,183,28,14,225,221,4,223,2,0,6,41,48,57,55,18,0,0,3,151,67,221
20210912,12SEP2021:00:00:00,UFU ZUBIZARRETA,57,41,77,18,3,98,98,0,98,0,0,3,22,25,17,17,11,3,0,6,67,25,98
20210913,13SEP2021:00:00:00,UFU ALVAREZ,229,164,283,63,47,393,355,38,363,30,47,20,58,110,67,39,25,27,0,2,264,89,355
20210913,13SEP2021:00:00:00,UFU ARGERICH,82,65,93,50,4,147,139,8,139,8,18,15,19,35,19,17,14,10,0,2,80,57,139
20210913,13SEP2021:00:00:00,UFU BORDA-MOYANO,36,30,44,18,4,66,58,8,58,8,3,2,9,16,14,7,15,0,0,2,35,20,58
20210913,13SEP2021:00:00:00,UFU DURAND,130,69,178,17,4,199,195,4,195,4,0,23,36,53,31,23,20,13,0,4,112,79,195
20210913,13SEP2021:00:00:00,UFU ELIZALDE,178,140,99,217,2,318,282,36,300,18,196,66,12,19,16,7,2,0,0,2,165,115,282
20210913,13SEP2021:00:00:00,UFU FERNANDEZ,76,62,108,23,7,138,114,24,124,14,0,4,35,28,38,16,14,3,0,2,71,41,114
20210913,13SEP2021:00:00:00,UFU FERRER,82,40,86,33,3,122,109,13,113,9,0,0,15,30,36,26,3,12,0,2,82,25,109
20210913,13SEP2021:00:00:00,UFU GRIERSON,131,74,137,59,9,205,201,4,201,4,0,19,36,51,51,34,9,5,0,4,141,55,201
20210913,13SEP2021:00:00:00,UFU GUTIERREZ,190,156,215,117,14,346,320,26,338,8,206,73,17,16,12,20,0,2,0,0,222,97,320
20210913,13SEP2021:00:00:00,UFU MUÑIZ,134,110,159,80,5,244,214,30,226,18,7,45,41,52,31,49,13,6,0,5,151,58,214
20210913,13SEP2021:00:00:00,UFU PENNA,105,94,107,87,5,199,185,14,187,12,60,28,22,31,19,26,13,0,0,3,117,65,185
20210913,13SEP2021:00:00:00,UFU PIROVANO,161,117,211,49,18,278,266,12,270,8,0,15,86,70,48,35,13,11,0,9,157,100,266
20210913,13SEP2021:00:00:00,UFU PIÑERO,206,140,280,47,19,346,332,14,334,12,95,58,33,45,50,37,14,14,0,2,239,91,332
20210913,13SEP2021:00:00:00,UFU RAMOS MEJIA,197,116,216,64,33,313,288,25,302,11,22,16,61,100,39,24,37,14,0,3,194,91,288
20210913,13SEP2021:00:00:00,UFU RIVADAVIA,157,111,190,45,33,268,266,2,266,2,0,14,68,62,55,26,35,8,0,6,154,105,266
20210913,13SEP2021:00:00:00,UFU SANTOJANNI,172,151,183,132,8,323,313,10,321,2,39,18,40,71,75,39,16,25,0,3,213,97,313
20210913,13SEP2021:00:00:00,UFU TORNU,189,164,298,39,16,353,309,44,309,44,45,37,47,79,85,36,19,5,0,3,210,96,309
20210913,13SEP2021:00:00:00,UFU VELEZ SARSFIELD,179,130,223,81,5,309,273,36,309,0,4,22,58,79,76,41,14,15,0,3,193,77,273
20210913,13SEP2021:00:00:00,UFU ZUBIZARRETA,184,130,186,101,27,314,308,6,314,0,0,40,42,83,59,37,30,23,0,6,217,85,308
20210914,14SEP2021:00:00:00,UFU ALVAREZ,191,154,263,66,16,345,297,48,305,40,54,40,43,78,39,48,23,20,0,5,206,86,297
20210914,14SEP2021:00:00:00,UFU ARGERICH,57,57,72,42,0,114,102,12,106,8,12,11,27,23,12,9,13,7,0,1,62,39,102
20210914,14SEP2021:00:00:00,UFU BORDA-MOYANO,35,23,40,16,2,58,58,0,58,0,2,2,23,4,15,5,1,6,0,0,40,18,58
20210914,14SEP2021:00:00:00,UFU DURAND,108,70,165,5,8,178,168,10,168,10,0,13,33,65,29,21,14,3,0,1,92,75,168
20210914,14SEP2021:00:00:00,UFU ELIZALDE,152,139,96,193,2,291,237,54,287,4,180,64,11,22,7,6,1,0,0,0,139,98,237
20210914,14SEP2021:00:00:00,UFU FERNANDEZ,88,84,136,23,13,172,158,14,162,10,0,14,37,41,32,28,14,6,0,4,98,56,158
20210914,14SEP2021:00:00:00,UFU FERRER,93,64,80,69,8,157,145,12,147,10,0,0,52,40,31,16,17,1,0,4,101,40,145
20210914,14SEP2021:00:00:00,UFU GRIERSON,88,90,94,61,23,178,168,10,170,8,0,27,37,42,31,19,15,7,0,5,121,40,168
20210914,14SEP2021:00:00:00,UFU GUTIERREZ,171,186,232,125,0,357,349,8,355,2,248,80,6,15,3,2,0,3,0,3,244,99,349
20211105,05NOV2021:00:00:00,UFU DURAND,100,63,146,12,5,163,155,8,155,8,0,16,31,53,16,20,18,9,0,4,91,60,155
20211105,05NOV2021:00:00:00,UFU ELIZALDE,75,93,56,110,2,168,156,12,164,4,116,30,8,3,5,2,4,0,0,1,88,67,156
20211105,05NOV2021:00:00:00,UFU FERNANDEZ,74,61,107,20,8,135,111,24,123,12,0,3,39,38,23,12,18,2,0,4,67,39,111
20211105,05NOV2021:00:00:00,UFU FERRER,67,51,70,45,3,118,110,8,114,4,0,2,18,33,29,17,14,5,0,2,78,30,110
20211105,05NOV2021:00:00:00,UFU GRIERSON,76,37,71,23,19,113,93,20,111,2,0,13,22,40,17,13,7,1,0,3,66,24,93
20211105,05NOV2021:00:00:00,UFU GUTIERREZ,86,88,75,98,1,174,162,12,166,8,123,39,3,0,4,5,0,0,0,2,111,49,162
20211105,05NOV2021:00:00:00,UFU MUÑIZ,84,85,78,77,14,169,139,30,149,20,5,18,29,21,33,29,23,11,0,7,98,34,139
20211105,05NOV2021:00:00:00,UFU PENNA,61,47,67,39,2,108,106,2,106,2,18,11,26,29,8,9,3,4,0,4,73,29,106
20211105,05NOV2021:00:00:00,UFU PIROVANO,168,121,223,38,28,289,271,18,281,8,0,20,63,88,45,32,28,13,0,8,150,113,271
20211105,05NOV2021:00:00:00,UFU PIÑERO,93,70,128,30,5,163,157,6,159,4,62,17,17,14,29,7,11,6,0,2,118,35,157
20211105,05NOV2021:00:00:00,UFU RAMOS MEJIA,106,65,134,19,18,171,145,26,147,24,7,17,38,27,24,23,26,9,0,3,84,58,145
20211105,05NOV2021:00:00:00,UFU RIVADAVIA,188,133,228,32,61,321,305,16,305,16,0,142,68,46,25,21,11,8,0,2,174,129,305
20211105,05NOV2021:00:00:00,UFU SANTOJANNI,96,68,114,41,9,164,152,12,160,4,3,23,28,27,39,21,7,16,0,1,90,61,152
20211105,05NOV2021:00:00:00,UFU TORNU,145,122,206,44,17,267,227,40,231,36,28,21,28,58,67,22,27,16,0,6,142,72,227
20211105,05NOV2021:00:00:00,UFU VELEZ SARSFIELD,83,66,107,33,9,149,142,7,144,5,0,12,18,30,35,19,21,14,0,2,98,42,142
20211105,05NOV2021:00:00:00,UFU ZUBIZARRETA,121,69,104,68,18,190,178,12,188,2,8,30,33,33,44,20,13,9,0,4,128,46,178
20211106,06NOV2021:00:00:00,UFU ALVAREZ,101,68,130,31,10,171,159,12,159,12,2,13,23,38,31,26,18,20,0,5,104,50,159
20211106,06NOV2021:00:00:00,UFU BORDA-MOYANO,8,11,10,9,0,19,19,0,19,0,0,0,2,7,2,2,4,2,0,1,11,7,19
20211106,06NOV2021:00:00:00,UFU DURAND,72,71,120,6,17,143,135,8,137,6,9,11,27,28,25,19,15,9,0,13,68,54,135
20211106,06NOV2021:00:00:00,UFU ELIZALDE,45,49,29,60,5,94,74,20,82,12,68,21,0,3,0,0,1,1,0,3,37,34,74
20211106,06NOV2021:00:00:00,UFU FERNANDEZ,28,24,42,10,0,52,50,2,52,0,0,1,14,17,8,3,5,4,0,3,30,17,50
20211106,06NOV2021:00:00:00,UFU FERRER,80,52,77,49,6,132,130,2,130,2,0,0,20,31,17,35,25,4,0,0,96,34,130
20211106,06NOV2021:00:00:00,UFU GRIERSON,80,70,105,26,19,150,146,4,146,4,2,22,46,21,18,15,12,14,0,4,100,42,146
20211106,06NOV2021:00:00:00,UFU GUTIERREZ,108,93,94,103,4,201,179,22,179,22,117,44,13,17,7,3,0,0,0,2,121,53,179
20211106,06NOV2021:00:00:00,UFU MUÑIZ,105,98,106,88,11,205,161,44,167,38,2,21,38,60,18,46,14,6,0,2,108,51,161
20211106,06NOV2021:00:00:00,UFU PENNA,55,32,43,44,0,87,85,2,87,0,31,7,13,14,13,7,0,2,0,2,58,25,85
20211106,06NOV2021:00:00:00,UFU PIROVANO,126,68,156,18,22,196,178,18,184,12,2,3,31,71,22,36,12,19,0,5,100,73,178
20211106,06NOV2021:00:00:00,UFU PIÑERO,54,43,64,27,6,97,95,2,95,2,0,12,18,28,12,13,3,11,0,4,68,23,95
20211106,06NOV2021:00:00:00,UFU RAMOS MEJIA,31,39,53,5,12,70,54,16,54,16,4,4,6,14,8,8,6,20,0,2,22,30,54
20211106,06NOV2021:00:00:00,UFU RIVADAVIA,86,48,100,23,13,136,116,20,120,16,2,2,45,18,23,27,13,6,0,8,55,52,116
20211106,06NOV2021:00:00:00,UFU SANTOJANNI,121,86,137,56,14,207,201,6,203,4,0,26,25,46,49,22,27,12,0,26,95,80,201
20211106,06NOV2021:00:00:00,UFU TORNU,74,79,129,20,6,155,147,8,147,8,14,22,18,22,25,32,10,12,0,8,85,54,147
20211106,06NOV2021:00:00:00,UFU VELEZ SARSFIELD,74,35,72,24,13,109,105,4,107,2,0,7,12,23,31,25,5,6,0,4,56,45,105
20211106,06NOV2021:00:00:00,UFU ZUBIZARRETA,153,92,173,59,15,247,239,8,247,0,2,26,35,33,63,33,28,27,0,8,168,63,239
20211107,07NOV2021:00:00:00,UFU ALVAREZ,115,77,144,39,9,192,180,12,182,10,16,16,38,29,21,25,34,13,0,3,135,42,180
20211107,07NOV2021:00:00:00,UFU ARGERICH,34,22,40,16,0,56,56,0,56,0,0,2,16,15,9,7,5,2,0,2,29,25,56
20211107,07NOV2021:00:00:00,UFU BORDA-MOYANO,13,12,11,14,0,25,25,0,25,0,0,4,3,5,9,0,4,0,0,0,15,10,25
20211107,07NOV2021:00:00:00,UFU DURAND,68,50,102,7,9,118,114,4,114,4,0,8,17,32,15,26,17,3,0,11,58,45,114
20211107,07NOV2021:00:00:00,UFU ELIZALDE,66,50,29,79,8,116,90,26,108,8,94,18,2,2,0,0,0,0,0,0,60,30,90
20211107,07NOV2021:00:00:00,UFU FERNANDEZ,30,23,46,7,0,53,53,0,53,0,0,0,16,16,4,8,5,4,0,4,29,20,53
20211107,07NOV2021:00:00:00,UFU FERRER,40,39,32,44,3,79,75,4,75,4,0,0,16,7,32,11,11,2,0,2,52,21,75
20211107,07NOV2021:00:00:00,UFU GRIERSON,91,65,105,43,8,156,152,4,152,4,0,19,44,22,30,26,12,3,0,1,108,43,152
20211107,07NOV2021:00:00:00,UFU GUTIERREZ,102,87,102,87,0,189,169,20,173,16,128,44,9,6,2,0,0,0,0,4,114,51,169
20211107,07NOV2021:00:00:00,UFU MUÑIZ,70,72,49,78,15,142,124,18,128,14,17,9,26,26,8,31,14,11,0,1,91,32,124
20211107,07NOV2021:00:00:00,UFU PENNA,49,34,50,33,0,83,75,8,75,8,24,18,4,11,5,6,8,7,0,1,59,15,75
20211107,07NOV2021:00:00:00,UFU PIROVANO,120,66,152,20,14,186,168,18,178,8,5,6,27,39,38,34,20,17,0,9,89,70,168
20211107,07NOV2021:00:00:00,UFU PIÑERO,34,23,39,9,9,57,57,0,57,0,0,5,20,5,18,2,3,4,0,0,46,11,57
20211107,07NOV2021:00:00:00,UFU RAMOS MEJIA,63,43,81,12,13,106,96,10,100,6,0,6,12,25,20,16,15,12,0,4,49,43,96
20211107,07NOV2021:00:00:00,UFU RIVADAVIA,71,48,90,21,8,119,113,6,115,4,0,3,33,28,26,7,13,9,0,2,67,44,113
20211107,07NOV2021:00:00:00,UFU SANTOJANNI,93,73,104,47,15,166,160,6,162,4,0,21,29,29,28,27,16,16,0,2,85,73,160
20211107,07NOV2021:00:00:00,UFU TORNU,50,44,79,13,2,94,84,10,84,10,5,7,16,29,13,9,9,6,0,2,55,27,84
20211107,07NOV2021:00:00:00,UFU VELEZ SARSFIELD,83,62,104,30,11,145,141,4,143,2,0,0,32,29,36,21,22,5,0,1,97,43,141
20211107,07NOV2021:00:00:00,UFU ZUBIZARRETA,89,73,122,40,0,162,162,0,162,0,0,15,19,25,41,25,23,14,0,2,120,40,162
20211108,08NOV2021:00:00:00,UFU ALVAREZ,226,182,287,61,60,408,384,24,384,24,61,35,56,99,63,47,32,15,0,5,263,116,384
20211108,08NOV2021:00:00:00,UFU ARGERICH,81,52,74,47,12,133,115,18,117,16,22,11,12,32,19,10,18,9,0,1,60,54,115
20211108,08NOV2021:00:00:00,UFU BORDA-MOYANO,52,43,59,27,9,95,79,16,79,16,2,9,33,21,19,8,3,0,0,2,44,33,79
20211108,08NOV2021:00:00:00,UFU DURAND,131,92,191,12,20,223,219,4,219,4,2,27,41,70,32,27,16,8,0,13,122,84,219
20211108,08NOV2021:00:00:00,UFU ELIZALDE,107,91,55,118,25,198,180,18,190,8,153,36,6,0,0,3,0,0,0,1,96,83,180
20211108,08NOV2021:00:00:00,UFU FERNANDEZ,76,80,121,20,15,156,136,20,148,8,0,1,35,52,29,24,11,4,0,3,78,55,136
20211108,08NOV2021:00:00:00,UFU FERRER,105,72,72,62,43,177,165,12,167,10,0,3,48,55,30,13,19,9,0,3,121,41,165
20211108,08NOV2021:00:00:00,UFU GRIERSON,141,102,132,64,47,243,239,4,239,4,3,30,38,61,52,25,21,13,0,7,169,62,239
20211108,08NOV2021:00:00:00,UFU GUTIERREZ,122,109,84,125,22,231,219,12,225,6,140,63,6,6,16,0,0,0,0,2,148,69,219
20211108,08NOV2021:00:00:00,UFU MUÑIZ,92,91,85,67,31,183,165,18,169,14,2,7,44,48,37,19,13,13,0,2,101,62,165
20211108,08NOV2021:00:00:00,UFU PENNA,96,84,75,86,19,180,160,20,164,16,53,26,12,24,30,25,7,3,0,7,110,43,160
20211108,08NOV2021:00:00:00,UFU PIROVANO,178,125,232,40,31,303,289,14,297,6,0,28,74,66,54,36,29,16,0,4,168,117,289
20211108,08NOV2021:00:00:00,UFU PIÑERO,149,138,218,36,33,287,271,16,271,16,88,40,35,34,41,12,22,15,0,2,193,75,271
20211213,13DEC2021:00:00:00,UFU BORDA-MOYANO,32,60,50,38,4,92,92,0,92,0,1,6,16,17,14,20,16,2,0,4,58,30,92
20211213,13DEC2021:00:00:00,UFU DURAND,118,86,180,12,12,204,198,6,200,4,0,10,44,60,40,31,8,11,0,26,87,85,198
20211213,13DEC2021:00:00:00,UFU ELIZALDE,41,64,15,90,0,105,93,12,97,8,67,27,0,3,3,2,2,1,0,1,48,44,93
20211213,13DEC2021:00:00:00,UFU FERNANDEZ,177,132,257,39,13,309,283,26,285,24,0,11,111,74,43,32,16,22,0,23,141,119,283
20211213,13DEC2021:00:00:00,UFU FERRER,84,47,72,52,7,131,123,8,129,2,0,0,46,32,26,12,6,9,0,9,80,34,123
20211213,13DEC2021:00:00:00,UFU GRIERSON,114,81,124,48,23,195,185,10,185,10,2,21,46,35,49,17,10,15,0,14,102,47,185
20211213,13DEC2021:00:00:00,UFU GUTIERREZ,102,85,116,61,10,187,173,14,175,12,123,33,9,12,4,4,2,0,0,5,91,76,173
20211213,13DEC2021:00:00:00,UFU MUÑIZ,174,149,171,110,42,323,283,40,287,36,4,25,53,78,70,49,31,13,0,12,166,104,283
20211213,13DEC2021:00:00:00,UFU PENNA,57,52,77,25,7,109,105,4,105,4,18,10,13,27,19,9,11,2,0,7,67,31,105
20211213,13DEC2021:00:00:00,UFU PIROVANO,294,183,364,39,74,477,451,26,463,14,0,44,113,130,76,50,42,22,0,44,227,178,451
20211213,13DEC2021:00:00:00,UFU PIÑERO,143,143,222,58,6,286,274,12,276,10,33,37,61,74,38,15,19,9,0,12,191,71,274
20211213,13DEC2021:00:00:00,UFU RAMOS MEJIA,164,119,202,58,23,283,231,52,245,38,14,20,47,89,58,27,11,17,0,18,123,90,231
20211213,13DEC2021:00:00:00,UFU RIVADAVIA,321,190,350,96,65,511,470,41,476,35,0,15,140,133,78,78,40,27,0,36,234,200,470
20211213,13DEC2021:00:00:00,UFU SANTOJANNI,153,116,179,85,5,269,257,12,261,8,2,21,68,59,40,22,31,26,0,20,135,102,257
20211213,13DEC2021:00:00:00,UFU TORNU,168,148,279,16,21,316,222,94,222,94,9,76,50,66,57,31,15,12,0,26,106,87,222
20211213,13DEC2021:00:00:00,UFU VELEZ SARSFIELD,148,136,221,53,10,284,280,4,280,4,0,24,69,57,63,20,29,22,0,32,159,89,280
20211213,13DEC2021:00:00:00,UFU ZUBIZARRETA,333,213,364,112,70,546,510,36,546,0,0,56,114,124,85,67,61,39,0,23,350,137,510
20211214,14DEC2021:00:00:00,UFU ALVAREZ,222,195,342,58,17,417,389,28,393,24,16,31,112,117,44,51,31,15,0,27,254,106,389
20211214,14DEC2021:00:00:00,UFU ARGERICH,53,47,66,28,6,100,95,5,95,5,5,3,18,23,13,13,5,20,0,12,49,34,95
20211214,14DEC2021:00:00:00,UFU BORDA-MOYANO,58,46,67,22,15,104,98,6,98,6,0,13,16,14,22,23,14,2,0,4,62,32,98
20211214,14DEC2021:00:00:00,UFU DURAND,110,84,158,21,15,194,166,28,188,6,0,10,46,55,28,14,23,18,0,21,77,68,166
20211214,14DEC2021:00:00:00,UFU ELIZALDE,63,55,45,71,2,118,108,10,118,0,81,22,7,6,0,2,0,0,0,1,49,58,108
20211214,14DEC2021:00:00:00,UFU FERNANDEZ,197,180,315,35,27,377,295,82,349,28,0,18,133,119,54,32,11,10,0,28,157,110,295
20211214,14DEC2021:00:00:00,UFU FERRER,112,85,119,57,21,197,177,20,183,14,0,9,39,58,46,25,17,3,0,13,118,46,177
20211214,14DEC2021:00:00:00,UFU GRIERSON,111,86,136,43,18,197,185,12,189,8,0,15,40,52,43,19,17,11,0,9,114,52,185
20211214,14DEC2021:00:00:00,UFU GUTIERREZ,78,98,139,28,9,176,164,12,166,10,117,30,5,5,8,5,3,3,0,3,88,73,164
20211214,14DEC2021:00:00:00,UFU MUÑIZ,194,175,209,107,53,369,315,54,319,50,6,22,91,76,56,64,43,11,0,10,215,90,315
20211214,14DEC2021:00:00:00,UFU PENNA,55,33,61,23,4,88,84,4,84,4,6,0,22,34,10,8,6,2,0,6,51,27,84
20211214,14DEC2021:00:00:00,UFU PIROVANO,294,237,377,59,95,531,505,26,517,14,0,15,132,207,76,53,24,24,0,59,226,219,505
20211214,14DEC2021:00:00:00,UFU PIÑERO,162,128,237,40,13,290,274,16,276,14,63,18,52,61,47,21,11,17,0,10,192,71,274
20211214,14DEC2021:00:00:00,UFU RAMOS MEJIA,174,121,229,26,40,295,273,22,277,18,16,10,75,101,47,27,11,8,0,28,143,102,273
20211214,14DEC2021:00:00:00,UFU RIVADAVIA,233,185,289,83,46,418,398,20,400,18,2,33,141,112,42,36,22,30,0,40,195,163,398
20211214,14DEC2021:00:00:00,UFU SANTOJANNI,137,123,149,102,9,260,256,4,258,2,0,13,71,73,34,31,27,11,0,13,126,117,256
20211214,14DEC2021:00:00:00,UFU TORNU,173,169,292,36,14,342,308,34,308,34,10,37,62,89,66,35,27,16,0,33,176,97,308
20211214,14DEC2021:00:00:00,UFU VELEZ SARSFIELD,153,144,230,57,10,297,295,2,297,0,0,18,110,44,61,41,10,13,0,17,204,74,295
20211214,14DEC2021:00:00:00,UFU ZUBIZARRETA,49,56,75,18,12,105,103,2,105,0,0,5,13,26,14,26,11,10,0,12,59,32,103
20211215,15DEC2021:00:00:00,UFU ALVAREZ,363,252,505,65,45,615,576,39,576,39,28,43,183,131,93,65,34,38,0,67,387,122,576
20211215,15DEC2021:00:00:00,UFU ARGERICH,82,77,114,39,6,159,142,17,145,14,6,17,39,31,27,24,14,1,0,18,86,36,142
20211215,15DEC2021:00:00:00,UFU BORDA-MOYANO,66,65,82,34,15,131,69,62,69,62,3,22,29,26,42,8,1,0,0,0,52,17,69
20211215,15DEC2021:00:00:00,UFU DURAND,165,139,262,27,15,304,298,6,298,6,0,0,84,87,66,43,18,6,0,57,160,81,298
20211215,15DEC2021:00:00:00,UFU ELIZALDE,92,100,61,128,3,192,175,17,190,2,134,41,4,10,0,3,0,0,0,2,125,48,175
20211215,15DEC2021:00:00:00,UFU FERNANDEZ,357,289,568,32,46,646,609,37,620,26,0,31,190,212,90,63,38,22,0,82,361,164,609
20211215,15DEC2021:00:00:00,UFU FERRER,169,135,183,121,0,304,296,8,296,8,0,22,67,97,66,24,24,4,0,30,212,54,296
20211215,15DEC2021:00:00:00,UFU GRIERSON,193,168,218,93,50,361,332,29,349,12,0,31,82,99,73,48,15,13,0,41,210,81,332
20211215,15DEC2021:00:00:00,UFU GUTIERREZ,173,118,204,71,16,291,280,11,289,2,163,56,11,28,7,12,14,0,0,4,201,75,280
20211215,15DEC2021:00:00:00,UFU MUÑIZ,258,269,291,188,48,527,461,66,481,46,12,34,141,124,73,94,33,16,0,35,316,110,461
20211215,15DEC2021:00:00:00,UFU PENNA,74,92,106,60,0,166,156,10,156,10,4,10,39,62,11,22,18,0,0,20,106,30,156
20211215,15DEC2021:00:00:00,UFU PIROVANO,416,365,623,69,89,781,757,24,769,12,0,31,195,293,112,60,65,25,0,116,438,201,757
20211215,15DEC2021:00:00:00,UFU PIÑERO,211,175,275,73,38,386,367,19,370,16,64,59,61,70,49,42,36,5,0,20,268,79,367
20211215,15DEC2021:00:00:00,UFU RAMOS MEJIA,302,256,437,59,62,558,497,61,530,28,4,22,158,165,112,41,40,16,0,61,288,146,497
20211215,15DEC2021:00:00:00,UFU RIVADAVIA,425,331,538,105,113,756,710,46,712,44,0,20,276,211,110,83,40,16,0,73,412,225,710
20211215,15DEC2021:00:00:00,UFU SANTOJANNI,269,205,297,159,18,474,450,24,462,12,0,28,108,92,112,66,42,26,0,44,287,119,450
20211215,15DEC2021:00:00:00,UFU TORNU,404,332,639,55,42,736,680,56,680,56,17,61,150,191,129,105,51,32,0,88,408,170,680
20211215,15DEC2021:00:00:00,UFU VELEZ SARSFIELD,245,198,369,59,15,443,415,28,441,2,0,17,95,142,71,51,48,19,0,61,260,94,415
20211215,15DEC2021:00:00:00,UFU ZUBIZARRETA,85,71,86,46,24,156,142,14,156,0,0,16,39,34,29,17,18,3,0,15,91,36,142
20211216,16DEC2021:00:00:00,UFU ALVAREZ,385,298,539,102,42,683,648,35,663,20,53,56,190,127,93,82,66,16,0,71,459,118,648
20211216,16DEC2021:00:00:00,UFU ARGERICH,108,95,121,76,6,203,188,15,191,12,11,7,70,50,32,10,9,14,0,28,110,50,188
20211216,16DEC2021:00:00:00,UFU BORDA-MOYANO,60,82,71,65,6,142,140,2,140,2,0,5,45,23,20,33,11,5,0,6,100,34,140
20211216,16DEC2021:00:00:00,UFU DURAND,157,146,272,25,6,303,291,12,297,6,2,12,98,87,43,19,19,23,0,65,143,83,291
20211216,16DEC2021:00:00:00,UFU ELIZALDE,76,110,60,122,4,186,158,28,174,12,123,52,4,2,5,0,0,0,0,0,113,45,158
20211216,16DEC2021:00:00:00,UFU FERNANDEZ,354,294,552,57,39,648,612,36,616,32,0,25,211,209,93,47,35,28,0,73,371,168,612
20211216,16DEC2021:00:00:00,UFU FERRER,116,110,138,67,21,226,226,0,226,0,0,6,80,52,28,23,29,8,0,20,168,38,226
20211216,16DEC2021:00:00:00,UFU GRIERSON,240,111,237,97,17,351,325,26,337,14,0,36,96,77,65,39,22,16,0,31,212,82,325
20211216,16DEC2021:00:00:00,UFU GUTIERREZ,129,115,171,47,26,244,218,26,234,10,133,60,8,17,16,7,0,3,0,0,151,67,218
20210722,22JUL2021:00:00:00,UFU DURAND,84,88,129,18,25,172,168,4,168,4,9,1,38,72,27,15,8,2,0,15,81,72,168
20210722,22JUL2021:00:00:00,UFU ELIZALDE,164,197,123,228,10,361,327,34,341,20,196,81,18,32,13,11,10,0,0,15,224,88,327
20210722,22JUL2021:00:00:00,UFU FERNANDEZ,64,65,104,16,9,129,113,16,125,4,0,3,36,35,15,15,9,16,0,14,54,45,113
20210722,22JUL2021:00:00:00,UFU FERRER,74,85,80,62,17,159,157,2,157,2,0,1,26,71,22,27,10,2,0,10,107,40,157
20210722,22JUL2021:00:00:00,UFU GRIERSON,103,88,94,56,41,191,185,6,187,4,0,4,43,47,44,39,11,3,0,7,131,47,185
20210722,22JUL2021:00:00:00,UFU GUTIERREZ,110,89,144,49,6,199,189,10,199,0,112,36,13,14,13,2,6,3,0,8,121,58,189
20210722,22JUL2021:00:00:00,UFU MUÑIZ,144,172,130,146,40,316,262,54,280,36,0,6,86,69,62,41,30,22,0,13,167,82,262
20210722,22JUL2021:00:00:00,UFU PENNA,91,64,87,65,3,155,125,30,129,26,0,7,38,34,32,21,13,10,0,11,77,37,125
20210722,22JUL2021:00:00:00,UFU PIROVANO,119,133,199,26,27,252,230,22,246,6,0,8,71,70,34,21,27,21,0,32,103,95,230
20210722,22JUL2021:00:00:00,UFU PIÑERO,127,79,131,56,19,206,206,0,206,0,0,6,50,38,57,30,11,14,0,12,142,50,206
20210722,22JUL2021:00:00:00,UFU RAMOS MEJIA,148,144,201,49,42,292,262,30,268,24,11,19,42,72,65,51,28,4,0,19,154,89,262
20210722,22JUL2021:00:00:00,UFU RIVADAVIA,174,123,204,63,30,297,285,12,285,12,0,10,82,92,55,19,26,13,0,28,132,125,285
20210722,22JUL2021:00:00:00,UFU SANTOJANNI,210,157,205,139,23,367,355,12,359,8,14,13,62,103,91,44,34,6,0,20,231,104,355
20210722,22JUL2021:00:00:00,UFU TORNU,164,164,244,52,32,328,284,44,284,44,16,22,82,64,47,35,33,29,0,9,189,82,284
20210722,22JUL2021:00:00:00,UFU VELEZ SARSFIELD,167,138,215,66,24,305,289,16,297,8,0,16,66,68,78,45,26,6,0,33,169,87,289
20210722,22JUL2021:00:00:00,UFU ZUBIZARRETA,80,100,114,49,17,180,178,2,180,0,0,17,33,49,29,24,15,13,0,8,126,44,178
20210723,23JUL2021:00:00:00,UFU ALVAREZ,208,160,296,51,21,368,320,48,320,48,23,14,109,89,53,43,20,17,0,13,216,91,320
20210723,23JUL2021:00:00:00,UFU ARGERICH,52,51,54,45,4,103,85,18,85,18,3,8,20,26,17,15,7,7,0,10,41,34,85
20210723,23JUL2021:00:00:00,UFU BORDA-MOYANO,33,17,22,24,4,50,50,0,50,0,0,5,10,17,13,2,1,2,0,2,33,15,50
20210723,23JUL2021:00:00:00,UFU DURAND,129,113,201,35,6,242,236,6,238,4,5,16,63,59,55,26,13,5,0,34,107,95,236
20210723,23JUL2021:00:00:00,UFU ELIZALDE,98,187,63,222,0,285,237,48,269,16,173,56,12,13,3,22,6,0,0,9,169,59,237
20210723,23JUL2021:00:00:00,UFU FERNANDEZ,118,122,200,34,6,240,206,34,228,12,0,15,78,66,19,36,14,12,0,18,116,72,206
20210723,23JUL2021:00:00:00,UFU FERRER,97,70,85,82,0,167,163,4,165,2,0,0,40,52,35,30,8,2,0,13,106,44,163
20210723,23JUL2021:00:00:00,UFU GRIERSON,139,95,106,93,35,234,224,10,228,6,0,5,63,63,45,25,21,12,0,6,158,59,224
20210723,23JUL2021:00:00:00,UFU GUTIERREZ,149,96,171,72,2,245,229,16,243,2,127,20,26,42,19,9,0,2,0,6,162,61,229
20210723,23JUL2021:00:00:00,UFU MUÑIZ,137,159,101,166,29,296,246,50,256,40,4,15,73,79,50,47,23,5,0,13,165,68,246
20210723,23JUL2021:00:00:00,UFU PENNA,90,87,93,82,2,177,165,12,169,8,0,2,53,49,33,19,19,2,0,12,104,49,165
20210723,23JUL2021:00:00:00,UFU PIROVANO,161,117,234,29,15,278,222,56,270,8,0,17,81,46,46,50,23,15,0,17,115,90,222
20210723,23JUL2021:00:00:00,UFU PIÑERO,107,69,129,43,4,176,172,4,174,2,0,16,36,51,30,29,12,2,0,9,119,44,172
20210723,23JUL2021:00:00:00,UFU RAMOS MEJIA,217,155,237,88,47,372,322,50,338,34,18,19,70,99,75,36,27,28,0,23,179,119,322
20210723,23JUL2021:00:00:00,UFU RIVADAVIA,143,118,187,54,20,261,249,12,251,10,0,5,77,85,46,28,9,11,0,23,126,98,249
20210723,23JUL2021:00:00:00,UFU SANTOJANNI,222,170,202,172,18,392,372,20,382,10,5,26,80,108,58,62,32,21,0,18,261,93,372
20210723,23JUL2021:00:00:00,UFU TORNU,184,153,276,41,20,337,313,24,315,22,18,17,60,89,91,35,11,16,0,13,211,85,313
20210723,23JUL2021:00:00:00,UFU VELEZ SARSFIELD,142,132,223,45,6,274,266,8,270,4,0,7,60,60,60,72,10,5,0,16,176,74,266
20210723,23JUL2021:00:00:00,UFU ZUBIZARRETA,149,104,154,87,12,253,247,6,253,0,0,23,68,41,55,29,26,11,0,12,172,63,247
20210724,24JUL2021:00:00:00,UFU ALVAREZ,140,98,172,47,19,238,222,16,222,16,7,11,54,44,55,26,35,6,0,18,132,72,222
20210724,24JUL2021:00:00:00,UFU ARGERICH,18,10,15,13,0,28,26,2,26,2,0,2,7,3,9,4,3,0,0,2,13,11,26
20210724,24JUL2021:00:00:00,UFU BORDA-MOYANO,18,27,32,13,0,45,45,0,45,0,0,2,12,12,7,10,2,0,0,0,30,15,45
20210724,24JUL2021:00:00:00,UFU DURAND,76,59,117,18,0,135,131,4,131,4,3,6,23,37,26,19,17,4,0,15,65,51,131
20210724,24JUL2021:00:00:00,UFU ELIZALDE,131,95,65,160,1,226,188,38,212,14,133,42,16,15,14,4,2,0,0,5,135,48,188
20210724,24JUL2021:00:00:00,UFU FERNANDEZ,94,71,133,29,3,165,143,22,157,8,0,4,50,38,26,20,20,7,0,9,89,44,143
20210724,24JUL2021:00:00:00,UFU FERRER,91,59,75,69,6,150,140,10,144,6,0,0,45,49,25,17,4,10,0,10,94,36,140
20210724,24JUL2021:00:00:00,UFU GRIERSON,129,79,93,75,40,208,206,2,206,2,0,8,58,40,52,24,20,6,0,22,133,49,206
20210724,24JUL2021:00:00:00,UFU GUTIERREZ,129,118,119,108,20,247,237,10,237,10,144,23,13,25,30,10,2,0,0,5,166,65,237
20210724,24JUL2021:00:00:00,UFU MUÑIZ,113,123,93,129,14,236,198,38,206,30,2,3,61,39,56,57,8,10,0,11,134,53,198
20210724,24JUL2021:00:00:00,UFU PENNA,42,25,40,25,2,67,63,4,63,4,2,0,22,8,5,4,19,7,0,9,40,14,63
20210724,24JUL2021:00:00:00,UFU PIROVANO,135,125,205,34,21,260,228,32,248,12,2,5,62,84,54,25,14,14,0,30,108,90,228
20210724,24JUL2021:00:00:00,UFU PIÑERO,94,70,119,42,3,164,160,4,160,4,0,13,53,27,25,17,18,11,0,8,113,37,160
20210724,24JUL2021:00:00:00,UFU RAMOS MEJIA,97,116,138,61,14,213,191,22,195,18,4,8,44,59,50,22,12,14,0,12,105,74,191
20210724,24JUL2021:00:00:00,UFU RIVADAVIA,155,81,191,40,5,236,155,81,155,81,0,6,75,76,27,29,11,12,0,8,82,63,155
20210724,24JUL2021:00:00:00,UFU SANTOJANNI,252,198,225,202,23,450,422,28,442,8,0,20,116,127,78,60,36,13,0,30,279,113,422
20210724,24JUL2021:00:00:00,UFU TORNU,96,84,123,36,21,180,178,2,178,2,3,15,35,55,41,17,11,3,0,24,110,44,178
20210724,24JUL2021:00:00:00,UFU VELEZ SARSFIELD,173,152,225,82,18,325,319,6,323,2,2,16,84,77,81,26,27,12,0,27,210,82,319
20210724,24JUL2021:00:00:00,UFU ZUBIZARRETA,156,107,149,109,5,263,261,2,263,0,0,10,58,65,38,40,38,14,0,12,174,74,261
20210725,25JUL2021:00:00:00,UFU ALVAREZ,129,140,217,35,17,269,247,22,247,22,13,22,41,67,49,49,14,14,0,8,168,71,247
20210725,25JUL2021:00:00:00,UFU ARGERICH,17,11,21,7,0,28,28,0,28,0,2,0,7,2,6,6,4,1,0,8,10,10,28
20210725,25JUL2021:00:00:00,UFU BORDA-MOYANO,13,13,17,5,4,26,24,2,24,2,0,2,10,4,3,7,0,0,0,0,15,9,24
20210725,25JUL2021:00:00:00,UFU DURAND,86,101,159,15,13,187,179,8,179,8,5,4,34,71,25,27,16,5,0,28,84,67,179
20210725,25JUL2021:00:00:00,UFU ELIZALDE,92,95,58,121,8,187,153,34,183,4,105,44,11,7,14,5,1,0,0,0,109,44,153
20210725,25JUL2021:00:00:00,UFU FERNANDEZ,94,82,122,27,27,176,152,24,172,4,0,7,53,51,23,29,8,5,0,22,82,48,152
20210725,25JUL2021:00:00:00,UFU FERRER,51,37,54,34,0,88,88,0,88,0,0,0,27,24,17,12,5,3,0,8,56,24,88
20210725,25JUL2021:00:00:00,UFU GRIERSON,83,83,92,51,23,166,166,0,166,0,0,20,42,30,41,20,12,1,0,20,94,52,166
20210725,25JUL2021:00:00:00,UFU GUTIERREZ,123,109,133,85,14,232,214,18,228,4,105,49,13,33,26,6,0,0,0,4,149,57,214
20210725,25JUL2021:00:00:00,UFU MUÑIZ,126,124,124,100,26,250,208,42,234,16,0,6,124,46,40,24,5,5,0,16,138,54,208
20210725,25JUL2021:00:00:00,UFU PENNA,35,30,47,18,0,65,61,4,61,4,0,3,11,20,16,2,8,5,0,2,38,21,61
20210914,14SEP2021:00:00:00,UFU MUÑIZ,134,140,152,105,17,274,206,68,224,50,9,28,56,53,67,39,17,5,0,0,154,52,206
20210914,14SEP2021:00:00:00,UFU PENNA,59,71,86,44,0,130,122,8,122,8,26,14,19,32,11,20,5,3,0,3,84,35,122
20210914,14SEP2021:00:00:00,UFU PIROVANO,155,119,219,34,21,274,258,16,264,10,0,17,48,79,47,33,35,15,0,3,145,110,258
20210914,14SEP2021:00:00:00,UFU PIÑERO,138,128,215,34,17,266,246,20,246,20,87,53,29,41,29,19,8,0,0,0,185,59,246
20210914,14SEP2021:00:00:00,UFU RAMOS MEJIA,125,84,148,37,24,209,203,6,203,6,16,19,50,49,18,35,14,8,0,1,131,71,203
20210914,14SEP2021:00:00:00,UFU RIVADAVIA,127,56,123,27,33,183,155,28,161,22,0,5,56,63,17,24,10,8,0,3,82,70,155
20210914,14SEP2021:00:00:00,UFU SANTOJANNI,124,113,157,76,4,237,229,8,237,0,2,31,45,57,35,31,23,13,0,1,132,96,229
20210914,14SEP2021:00:00:00,UFU TORNU,184,112,237,39,20,296,170,126,174,122,35,58,35,44,63,35,18,8,0,5,108,57,170
20210914,14SEP2021:00:00:00,UFU VELEZ SARSFIELD,140,86,190,30,6,226,222,4,224,2,0,24,42,57,45,25,19,14,0,2,149,71,222
20210914,14SEP2021:00:00:00,UFU ZUBIZARRETA,174,111,180,71,34,285,281,4,285,0,0,30,52,71,50,33,31,18,0,5,208,68,281
20210915,15SEP2021:00:00:00,UFU ALVAREZ,235,136,293,54,24,371,337,34,339,32,59,47,44,72,83,33,22,11,0,3,242,92,337
20210915,15SEP2021:00:00:00,UFU ARGERICH,86,55,102,36,3,141,129,12,129,12,28,7,29,22,22,11,14,8,0,2,68,59,129
20210915,15SEP2021:00:00:00,UFU BORDA-MOYANO,26,42,45,22,1,68,62,6,62,6,1,5,12,17,17,12,4,0,0,2,40,20,62
20210915,15SEP2021:00:00:00,UFU DURAND,141,85,209,11,6,226,218,8,218,8,7,22,32,63,45,28,19,10,0,2,126,90,218
20210915,15SEP2021:00:00:00,UFU ELIZALDE,140,143,87,192,4,283,241,42,259,24,166,69,13,25,7,1,0,2,0,2,138,101,241
20210915,15SEP2021:00:00:00,UFU FERNANDEZ,109,40,132,15,2,149,139,10,149,0,0,2,18,44,35,17,21,12,0,2,86,51,139
20210915,15SEP2021:00:00:00,UFU FERRER,87,85,108,53,11,172,158,14,164,8,0,9,28,68,43,17,2,5,0,2,116,40,158
20210915,15SEP2021:00:00:00,UFU GRIERSON,116,83,94,102,3,199,187,12,187,12,0,29,32,39,42,39,11,7,0,3,133,51,187
20210915,15SEP2021:00:00:00,UFU GUTIERREZ,158,162,210,106,4,320,286,34,312,8,232,63,2,12,7,4,0,0,0,0,194,92,286
20210915,15SEP2021:00:00:00,UFU MUÑIZ,129,157,136,124,26,286,254,32,256,30,9,43,63,42,55,62,10,2,0,4,182,68,254
20210915,15SEP2021:00:00:00,UFU PENNA,87,78,107,55,3,165,153,12,159,6,21,19,50,21,22,19,10,3,0,0,109,44,153
20210915,15SEP2021:00:00:00,UFU PIROVANO,166,125,211,51,29,291,271,20,283,8,2,25,53,73,76,40,17,5,0,25,146,100,271
20210915,15SEP2021:00:00:00,UFU PIÑERO,159,129,235,46,7,288,262,26,274,14,81,56,23,63,27,17,16,5,0,1,190,67,262
20210915,15SEP2021:00:00:00,UFU RAMOS MEJIA,123,87,158,36,16,210,176,34,178,32,18,12,43,45,43,22,15,12,0,1,113,62,176
20210915,15SEP2021:00:00:00,UFU RIVADAVIA,121,70,135,40,16,191,181,10,185,6,0,8,56,58,35,18,13,3,0,1,106,73,181
20210915,15SEP2021:00:00:00,UFU SANTOJANNI,143,91,131,99,4,234,196,38,232,2,23,33,43,51,25,25,22,12,0,3,114,79,196
20210915,15SEP2021:00:00:00,UFU TORNU,149,159,246,46,16,308,270,38,270,38,34,32,39,71,62,41,13,16,0,1,193,75,270
20210915,15SEP2021:00:00:00,UFU VELEZ SARSFIELD,116,111,179,34,14,227,191,36,221,6,2,21,33,53,39,44,18,17,0,3,135,53,191
20210915,15SEP2021:00:00:00,UFU ZUBIZARRETA,140,94,136,73,25,234,234,0,234,0,0,15,29,58,56,37,28,11,0,4,175,55,234
20210916,16SEP2021:00:00:00,UFU ALVAREZ,145,126,213,40,18,271,253,18,253,18,68,22,42,39,53,22,13,12,0,12,170,71,253
20210916,16SEP2021:00:00:00,UFU ARGERICH,50,42,61,28,3,92,86,6,86,6,11,14,14,19,11,13,7,3,0,0,46,40,86
20210916,16SEP2021:00:00:00,UFU BORDA-MOYANO,59,28,48,26,13,87,77,10,77,10,2,11,15,16,18,12,13,0,0,0,49,28,77
20210916,16SEP2021:00:00:00,UFU DURAND,137,65,169,21,12,202,192,10,192,10,0,20,30,73,35,23,12,9,0,4,116,72,192
20210916,16SEP2021:00:00:00,UFU ELIZALDE,171,123,117,175,2,294,266,28,278,16,160,83,21,15,13,2,0,0,0,1,164,101,266
20210916,16SEP2021:00:00:00,UFU FERNANDEZ,76,74,119,27,4,150,142,8,148,2,0,6,28,50,22,13,10,21,0,3,82,56,142
20210916,16SEP2021:00:00:00,UFU FERRER,130,89,110,101,8,219,211,8,211,8,0,5,48,90,37,13,13,13,0,4,155,52,211
20210916,16SEP2021:00:00:00,UFU GRIERSON,98,92,139,33,18,190,180,10,182,8,0,42,43,28,41,24,11,1,0,3,128,48,180
20210916,16SEP2021:00:00:00,UFU GUTIERREZ,158,145,206,89,8,303,289,14,299,4,217,62,5,5,4,6,2,2,0,2,213,74,289
20210916,16SEP2021:00:00:00,UFU MUÑIZ,147,142,156,112,21,289,244,45,254,35,15,32,55,45,63,44,28,7,0,1,177,66,244
20210916,16SEP2021:00:00:00,UFU PENNA,77,75,105,41,6,152,144,8,146,6,34,18,22,36,15,14,6,7,0,0,107,37,144
20210916,16SEP2021:00:00:00,UFU PIROVANO,177,139,252,31,33,316,278,38,306,10,0,23,79,75,62,28,30,19,0,4,160,114,278
20210916,16SEP2021:00:00:00,UFU PIÑERO,179,122,239,47,15,301,291,10,293,8,107,55,50,33,15,24,8,9,0,0,214,75,291
20210916,16SEP2021:00:00:00,UFU RAMOS MEJIA,111,98,163,34,12,209,187,22,191,18,32,20,40,38,35,15,18,11,0,2,114,71,187
20210916,16SEP2021:00:00:00,UFU RIVADAVIA,114,72,128,43,15,186,162,24,162,24,0,8,50,60,30,20,12,6,0,2,90,70,162
20210916,16SEP2021:00:00:00,UFU SANTOJANNI,140,76,138,74,4,216,206,10,208,8,1,42,54,35,51,18,11,4,0,5,118,83,206
20210916,16SEP2021:00:00:00,UFU TORNU,210,139,292,42,15,349,261,88,261,88,42,55,40,85,80,26,13,8,0,3,190,66,261
20210916,16SEP2021:00:00:00,UFU VELEZ SARSFIELD,104,99,170,20,13,203,193,10,197,6,0,18,37,63,49,19,17,0,0,0,136,57,193
20210916,16SEP2021:00:00:00,UFU ZUBIZARRETA,73,63,102,22,12,136,136,0,136,0,0,18,25,35,17,11,13,17,0,1,100,35,136
20210917,17SEP2021:00:00:00,UFU ALVAREZ,174,139,251,29,33,313,293,20,295,18,51,21,68,70,28,33,26,16,0,4,215,74,293
20210917,17SEP2021:00:00:00,UFU ARGERICH,58,52,57,45,8,110,98,12,98,12,20,11,19,20,12,12,11,5,0,0,57,41,98
20210917,17SEP2021:00:00:00,UFU BORDA-MOYANO,50,19,50,15,4,69,59,10,59,10,0,8,6,13,11,11,9,11,0,0,34,25,59
20210917,17SEP2021:00:00:00,UFU DURAND,106,68,161,12,1,174,168,6,168,6,0,13,35,33,39,22,23,9,0,5,97,66,168
20210917,17SEP2021:00:00:00,UFU ELIZALDE,118,155,106,163,4,273,193,80,211,62,172,53,15,10,11,8,4,0,0,1,110,82,193
20210917,17SEP2021:00:00:00,UFU FERNANDEZ,80,54,103,19,12,134,126,8,128,6,0,9,24,31,28,25,11,6,0,5,71,49,126
20210917,17SEP2021:00:00:00,UFU FERRER,98,41,66,59,14,139,121,18,129,10,0,10,35,34,26,22,8,4,0,1,90,30,121
20210917,17SEP2021:00:00:00,UFU GRIERSON,133,81,154,42,18,214,162,52,204,10,2,33,18,35,49,40,29,8,0,3,123,36,162
20210917,17SEP2021:00:00:00,UFU GUTIERREZ,159,157,222,84,10,316,308,8,312,4,183,79,5,28,15,3,3,0,0,0,220,88,308
20210917,17SEP2021:00:00:00,UFU MUÑIZ,123,102,101,110,14,225,193,32,197,28,0,28,38,53,52,25,18,11,0,1,142,49,193
20210917,17SEP2021:00:00:00,UFU PENNA,78,66,65,76,3,144,136,8,138,6,11,26,35,32,15,15,5,5,0,0,100,36,136
20210917,17SEP2021:00:00:00,UFU PIROVANO,137,100,187,17,33,237,215,22,235,2,0,23,39,70,50,20,22,13,0,1,131,83,215
20210917,17SEP2021:00:00:00,UFU PIÑERO,146,113,210,36,13,259,249,10,249,10,93,38,15,35,30,19,9,20,0,1,196,52,249
20210917,17SEP2021:00:00:00,UFU RAMOS MEJIA,159,140,232,40,27,299,253,46,269,30,38,39,34,60,42,44,24,18,0,2,148,103,253
20210917,17SEP2021:00:00:00,UFU RIVADAVIA,126,78,140,39,25,204,180,24,194,10,0,12,52,53,21,34,19,13,0,1,103,76,180
20210917,17SEP2021:00:00:00,UFU SANTOJANNI,120,99,114,98,7,219,201,18,211,8,28,21,36,39,31,29,18,17,0,4,117,80,201
20211108,08NOV2021:00:00:00,UFU RAMOS MEJIA,157,99,166,47,43,256,214,42,238,18,19,18,52,56,42,24,35,10,0,4,115,95,214
20211108,08NOV2021:00:00:00,UFU RIVADAVIA,138,80,157,39,22,218,204,14,208,10,0,6,53,50,41,29,20,19,0,5,117,82,204
20211108,08NOV2021:00:00:00,UFU SANTOJANNI,149,97,144,75,27,246,228,18,246,0,10,26,38,33,57,37,25,20,0,7,133,88,228
20211108,08NOV2021:00:00:00,UFU TORNU,127,99,177,27,22,226,200,26,200,26,18,22,19,42,57,22,28,18,0,10,121,68,200
20211108,08NOV2021:00:00:00,UFU VELEZ SARSFIELD,174,121,229,45,21,295,289,6,295,0,0,12,64,70,78,22,32,17,0,2,205,82,289
20211108,08NOV2021:00:00:00,UFU ZUBIZARRETA,208,146,215,93,46,354,354,0,354,0,0,40,47,78,70,49,35,35,0,7,249,98,354
20211109,09NOV2021:00:00:00,UFU ALVAREZ,189,123,254,29,29,312,294,18,294,18,28,29,43,79,58,29,30,16,0,5,202,87,294
20211109,09NOV2021:00:00:00,UFU ARGERICH,46,68,77,33,4,114,92,22,100,14,14,6,17,17,29,6,13,12,0,0,55,37,92
20211109,09NOV2021:00:00:00,UFU BORDA-MOYANO,27,13,31,6,3,40,38,2,38,2,3,2,13,4,5,5,8,0,0,0,24,14,38
20211109,09NOV2021:00:00:00,UFU DURAND,116,101,189,23,5,217,205,12,213,4,2,21,46,49,49,22,18,10,0,11,107,87,205
20211109,09NOV2021:00:00:00,UFU ELIZALDE,75,82,44,111,2,157,135,22,143,14,109,38,0,9,0,1,0,0,0,0,85,50,135
20211109,09NOV2021:00:00:00,UFU FERNANDEZ,89,50,113,19,7,139,123,16,135,4,0,3,38,31,23,18,12,14,0,2,74,46,123
20211109,09NOV2021:00:00:00,UFU FERRER,95,91,94,74,18,186,170,16,172,14,0,13,38,49,34,31,16,5,0,2,126,42,170
20211109,09NOV2021:00:00:00,UFU GRIERSON,93,63,99,50,7,156,154,2,154,2,0,15,29,36,34,17,15,10,0,5,112,37,154
20211109,09NOV2021:00:00:00,UFU GUTIERREZ,147,132,154,124,1,279,259,20,275,4,180,55,17,7,12,6,2,0,0,1,156,102,259
20211109,09NOV2021:00:00:00,UFU MUÑIZ,109,98,106,85,16,207,165,42,175,32,1,13,34,52,52,24,21,10,0,5,114,46,165
20211109,09NOV2021:00:00:00,UFU PENNA,73,72,121,19,5,145,131,14,137,8,35,14,21,20,15,20,5,15,0,3,93,35,131
20211109,09NOV2021:00:00:00,UFU PIROVANO,163,120,221,44,18,283,247,36,271,12,0,15,43,83,44,46,33,19,0,22,128,96,247
20211109,09NOV2021:00:00:00,UFU PIÑERO,133,111,185,49,10,244,240,4,242,2,92,38,22,21,22,20,20,9,0,4,173,61,240
20211109,09NOV2021:00:00:00,UFU RAMOS MEJIA,104,84,127,39,22,188,166,22,174,14,25,19,30,41,27,23,13,10,0,9,91,66,166
20211109,09NOV2021:00:00:00,UFU RIVADAVIA,101,56,105,33,19,157,151,6,155,2,0,8,41,33,21,24,23,7,0,5,93,53,151
20211109,09NOV2021:00:00:00,UFU SANTOJANNI,92,86,106,65,7,178,176,2,178,0,0,14,31,30,39,27,21,16,0,4,99,73,176
20211109,09NOV2021:00:00:00,UFU TORNU,192,117,258,45,6,309,251,58,251,58,37,32,49,67,60,28,21,15,0,5,164,80,251
20211109,09NOV2021:00:00:00,UFU VELEZ SARSFIELD,114,127,195,42,4,241,241,0,241,0,0,16,56,55,45,47,17,5,0,8,162,71,241
20211109,09NOV2021:00:00:00,UFU ZUBIZARRETA,188,123,185,97,29,311,311,0,311,0,0,46,87,54,62,41,13,8,0,3,219,89,311
20211110,10NOV2021:00:00:00,UFU ALVAREZ,219,185,335,43,26,404,363,41,380,24,43,28,73,86,68,53,36,17,0,6,259,98,363
20211110,10NOV2021:00:00:00,UFU ARGERICH,57,41,56,34,8,98,68,30,80,18,16,10,20,7,17,12,8,8,0,0,40,28,68
20211110,10NOV2021:00:00:00,UFU BORDA-MOYANO,30,33,38,18,7,63,57,6,57,6,0,9,17,13,13,7,4,0,0,0,36,21,57
20211110,10NOV2021:00:00:00,UFU DURAND,89,91,161,13,6,180,162,18,170,10,0,16,47,67,16,18,11,5,0,6,95,61,162
20211110,10NOV2021:00:00:00,UFU ELIZALDE,99,90,57,124,8,189,157,32,179,10,119,41,6,17,6,0,0,0,0,4,93,60,157
20211110,10NOV2021:00:00:00,UFU FERNANDEZ,80,47,106,18,3,127,119,8,121,6,0,1,38,38,15,14,18,3,0,7,72,40,119
20211110,10NOV2021:00:00:00,UFU FERRER,106,80,112,64,10,186,164,22,182,4,0,2,55,41,43,27,13,5,0,1,132,31,164
20211110,10NOV2021:00:00:00,UFU GRIERSON,119,88,110,70,27,207,179,28,201,6,0,32,46,50,37,20,16,6,0,3,125,51,179
20211110,10NOV2021:00:00:00,UFU GUTIERREZ,158,124,150,121,11,282,212,70,276,6,191,50,3,25,3,3,7,0,0,0,123,89,212
20211110,10NOV2021:00:00:00,UFU MUÑIZ,136,116,111,128,13,252,217,35,234,18,6,23,42,53,56,38,26,8,0,4,157,56,217
20211110,10NOV2021:00:00:00,UFU PENNA,67,59,84,42,0,126,114,12,126,0,18,21,29,12,16,25,4,1,0,3,78,33,114
20211110,10NOV2021:00:00:00,UFU PIROVANO,219,158,294,55,28,377,307,70,367,10,0,18,91,94,58,40,46,30,0,10,171,123,307
20211110,10NOV2021:00:00:00,UFU PIÑERO,138,105,203,30,10,243,217,26,235,8,78,26,34,29,37,25,3,11,0,2,162,52,217
20211110,10NOV2021:00:00:00,UFU RAMOS MEJIA,117,107,168,30,26,224,186,38,192,32,22,14,46,70,45,19,3,5,0,9,100,77,186
20211110,10NOV2021:00:00:00,UFU RIVADAVIA,168,72,161,55,24,240,215,25,218,22,0,7,68,76,30,31,20,8,0,8,123,84,215
20211110,10NOV2021:00:00:00,UFU SANTOJANNI,166,98,143,112,9,264,227,37,262,2,23,41,26,45,62,39,14,14,0,3,131,93,227
20211110,10NOV2021:00:00:00,UFU TORNU,147,156,236,48,19,303,244,59,259,44,26,31,49,83,62,22,19,11,0,6,158,77,244
20211110,10NOV2021:00:00:00,UFU VELEZ SARSFIELD,146,136,243,20,19,282,226,56,276,6,0,23,73,61,43,49,18,15,0,6,156,64,226
20211110,10NOV2021:00:00:00,UFU ZUBIZARRETA,117,99,148,47,21,216,208,8,210,6,0,22,55,36,46,32,15,10,0,6,146,56,208
20211111,11NOV2021:00:00:00,UFU ALVAREZ,132,136,201,46,21,268,252,16,254,14,48,17,44,67,39,23,27,3,0,3,182,67,252
20211111,11NOV2021:00:00:00,UFU ARGERICH,64,40,64,37,3,104,80,24,80,24,12,9,20,23,21,11,5,3,0,0,49,31,80
20211111,11NOV2021:00:00:00,UFU BORDA-MOYANO,21,11,21,7,4,32,30,2,30,2,0,3,4,6,7,8,2,2,0,0,19,11,30
20211111,11NOV2021:00:00:00,UFU DURAND,148,108,220,22,14,256,246,10,248,8,21,17,35,70,59,26,20,8,0,7,139,100,246
20211111,11NOV2021:00:00:00,UFU ELIZALDE,100,80,40,132,8,180,170,10,180,0,130,41,2,5,0,2,0,0,0,1,97,72,170
20211111,11NOV2021:00:00:00,UFU FERNANDEZ,123,56,134,31,14,179,157,22,169,10,0,3,33,51,39,23,22,8,0,2,92,63,157
20211111,11NOV2021:00:00:00,UFU FERRER,91,100,99,77,15,191,185,6,185,6,0,5,52,66,45,15,7,1,0,2,132,51,185
20211111,11NOV2021:00:00:00,UFU GRIERSON,144,82,156,59,11,226,212,14,226,0,0,18,67,60,29,30,9,13,0,4,153,54,212
20211111,11NOV2021:00:00:00,UFU GUTIERREZ,113,120,148,83,2,233,217,16,233,0,145,52,12,16,3,3,2,0,0,1,139,77,217
20211111,11NOV2021:00:00:00,UFU MUÑIZ,127,127,122,111,21,254,204,50,208,46,20,48,34,36,55,39,22,0,0,0,140,64,204
20211111,11NOV2021:00:00:00,UFU PENNA,50,42,53,35,4,92,76,16,76,16,11,8,10,17,19,13,6,8,0,2,57,17,76
20211111,11NOV2021:00:00:00,UFU PIROVANO,204,117,261,28,32,321,297,24,315,6,0,22,79,78,58,38,27,19,0,14,158,125,297
20211111,11NOV2021:00:00:00,UFU PIÑERO,123,108,189,34,8,231,219,12,219,12,59,21,45,21,32,34,14,5,0,0,159,59,219
20211111,11NOV2021:00:00:00,UFU RAMOS MEJIA,92,91,139,27,17,183,175,8,179,4,12,8,31,62,37,13,13,7,0,5,100,69,175
20211111,11NOV2021:00:00:00,UFU RIVADAVIA,139,79,133,48,37,218,198,20,200,18,0,9,56,65,36,25,19,8,0,5,110,83,198
20211111,11NOV2021:00:00:00,UFU SANTOJANNI,187,100,176,88,23,287,263,24,271,16,2,32,49,64,39,45,26,30,0,6,144,113,263
20211111,11NOV2021:00:00:00,UFU TORNU,171,115,217,49,20,286,230,56,232,54,24,42,36,57,62,31,26,8,0,7,139,69,230
20211111,11NOV2021:00:00:00,UFU VELEZ SARSFIELD,136,114,194,49,7,250,248,2,248,2,0,21,44,72,58,20,28,7,0,3,171,74,248
20211111,11NOV2021:00:00:00,UFU ZUBIZARRETA,136,107,158,67,18,243,243,0,243,0,0,21,23,58,55,31,27,28,0,3,177,63,243
20211112,12NOV2021:00:00:00,UFU ALVAREZ,185,139,263,41,20,324,306,18,306,18,29,27,69,84,32,30,29,24,0,12,190,104,306
20211112,12NOV2021:00:00:00,UFU ARGERICH,67,27,55,31,8,94,84,10,86,8,0,5,16,19,15,16,9,14,0,2,45,37,84
